ASOFDATE,PORTFOLIOID,LOANSTATUS,PROD_EMAIL,DEV_EMAIL,DIFF
2025-10-01,102,Current,0,0,0
2025-10-01,104,Current,0,0,0
2025-10-01,20,Current,29,5,24
2025-10-01,20,DPD15-29,132,85,47
2025-10-01,20,DPD3-14,110,82,28
2025-10-01,20,DPD30-59,66,52,14
2025-10-01,20,DPD60-89,0,0,0
2025-10-01,20,DPD90+,0,0,0
2025-10-01,22,Current,0,0,0
2025-10-01,24,Current,4788,2266,2522
2025-10-01,24,DPD15-29,79,57,22
2025-10-01,24,DPD3-14,86,62,24
2025-10-01,24,DPD30-59,38,26,12
2025-10-01,24,DPD60-89,1,0,1
2025-10-01,24,DPD90+,1,0,1
2025-10-01,26,Current,2,0,2
2025-10-01,26,DPD15-29,5,2,3
2025-10-01,26,DPD3-14,5,4,1
2025-10-01,26,DPD30-59,4,4,0
2025-10-01,26,DPD60-89,0,0,0
2025-10-01,26,DPD90+,0,0,0
2025-10-01,32,Current,7,2,5
2025-10-01,32,DPD15-29,65,45,20
2025-10-01,32,DPD3-14,68,50,18
2025-10-01,32,DPD30-59,33,23,10
2025-10-01,32,DPD60-89,0,0,0
2025-10-01,32,DPD90+,0,0,0
2025-10-01,34,Current,1,1,0
2025-10-01,34,DPD15-29,17,13,4
2025-10-01,34,DPD3-14,10,8,2
2025-10-01,34,DPD30-59,7,7,0
2025-10-01,34,DPD60-89,0,0,0
2025-10-01,34,DPD90+,0,0,0
2025-10-01,36,Current,1,0,1
2025-10-01,36,DPD15-29,14,11,3
2025-10-01,36,DPD3-14,14,9,5
2025-10-01,36,DPD30-59,10,8,2
2025-10-01,36,DPD60-89,0,0,0
2025-10-01,36,DPD90+,0,0,0
2025-10-01,38,Current,543,293,250
2025-10-01,38,DPD15-29,20,12,8
2025-10-01,38,DPD3-14,12,5,7
2025-10-01,38,DPD30-59,8,6,2
2025-10-01,38,DPD60-89,0,0,0
2025-10-01,38,DPD90+,0,0,0
2025-10-01,40,Current,1,0,1
2025-10-01,40,DPD15-29,13,9,4
2025-10-01,40,DPD3-14,17,12,5
2025-10-01,40,DPD30-59,7,5,2
2025-10-01,40,DPD60-89,0,0,0
2025-10-01,40,DPD90+,0,0,0
2025-10-01,42,Current,0,0,0
2025-10-01,42,DPD15-29,4,4,0
2025-10-01,42,DPD3-14,5,3,2
2025-10-01,42,DPD30-59,3,2,1
2025-10-01,42,DPD60-89,0,0,0
2025-10-01,42,DPD90+,0,0,0
2025-10-01,44,Current,1415,687,728
2025-10-01,44,DPD15-29,18,10,8
2025-10-01,44,DPD3-14,12,9,3
2025-10-01,44,DPD30-59,8,7,1
2025-10-01,44,DPD60-89,0,0,0
2025-10-01,44,DPD90+,0,0,0
2025-10-01,46,Current,0,0,0
2025-10-01,46,DPD15-29,1,1,0
2025-10-01,46,DPD30-59,1,0,1
2025-10-01,46,DPD60-89,0,0,0
2025-10-01,48,Current,1096,716,380
2025-10-01,48,DPD15-29,27,18,9
2025-10-01,48,DPD3-14,31,20,11
2025-10-01,48,DPD30-59,11,6,5
2025-10-01,48,DPD60-89,1,1,0
2025-10-01,48,DPD90+,0,0,0
2025-10-01,54,Current,219,4,215
2025-10-01,56,Current,1385,298,1087
2025-10-01,56,DPD15-29,2,0,2
2025-10-01,56,DPD3-14,3,0,3
2025-10-01,56,DPD30-59,1,0,1
2025-10-01,56,DPD60-89,0,0,0
2025-10-01,58,Current,1135,38,1097
2025-10-01,6,Current,0,0,0
2025-09-30,102,Current,0,0,0
2025-09-30,104,Current,0,0,0
2025-09-30,20,Current,8,2,6
2025-09-30,20,DPD15-29,84,62,22
2025-09-30,20,DPD3-14,61,41,20
2025-09-30,20,DPD30-59,54,38,16
2025-09-30,20,DPD60-89,0,0,0
2025-09-30,20,DPD90+,0,0,0
2025-09-30,22,Current,0,0,0
2025-09-30,24,Current,84,21,63
2025-09-30,24,DPD15-29,60,38,22
2025-09-30,24,DPD3-14,51,26,25
2025-09-30,24,DPD30-59,39,24,15
2025-09-30,24,DPD60-89,0,0,0
2025-09-30,24,DPD90+,0,0,0
2025-09-30,26,Current,2,1,1
2025-09-30,26,DPD15-29,5,5,0
2025-09-30,26,DPD3-14,4,2,2
2025-09-30,26,DPD30-59,2,2,0
2025-09-30,26,DPD60-89,0,0,0
2025-09-30,26,DPD90+,0,0,0
2025-09-30,32,Current,9,3,6
2025-09-30,32,DPD15-29,32,26,6
2025-09-30,32,DPD3-14,32,20,12
2025-09-30,32,DPD30-59,29,16,13
2025-09-30,32,DPD60-89,0,0,0
2025-09-30,32,DPD90+,1,0,1
2025-09-30,34,Current,1,1,0
2025-09-30,34,DPD15-29,10,6,4
2025-09-30,34,DPD3-14,15,11,4
2025-09-30,34,DPD30-59,10,8,2
2025-09-30,34,DPD60-89,0,0,0
2025-09-30,34,DPD90+,0,0,0
2025-09-30,36,Current,0,0,0
2025-09-30,36,DPD15-29,8,5,3
2025-09-30,36,DPD3-14,5,3,2
2025-09-30,36,DPD30-59,5,2,3
2025-09-30,36,DPD60-89,0,0,0
2025-09-30,36,DPD90+,0,0,0
2025-09-30,38,Current,7,3,4
2025-09-30,38,DPD15-29,21,18,3
2025-09-30,38,DPD3-14,15,9,6
2025-09-30,38,DPD30-59,3,0,3
2025-09-30,38,DPD60-89,0,0,0
2025-09-30,38,DPD90+,0,0,0
2025-09-30,40,Current,1,0,1
2025-09-30,40,DPD15-29,7,6,1
2025-09-30,40,DPD3-14,6,3,3
2025-09-30,40,DPD30-59,6,5,1
2025-09-30,40,DPD60-89,0,0,0
2025-09-30,40,DPD90+,0,0,0
2025-09-30,42,Current,0,0,0
2025-09-30,42,DPD15-29,0,0,0
2025-09-30,42,DPD3-14,4,3,1
2025-09-30,42,DPD30-59,4,4,0
2025-09-30,42,DPD60-89,0,0,0
2025-09-30,42,DPD90+,0,0,0
2025-09-30,44,Current,4,2,2
2025-09-30,44,DPD15-29,13,5,8
2025-09-30,44,DPD3-14,18,11,7
2025-09-30,44,DPD30-59,6,4,2
2025-09-30,44,DPD60-89,0,0,0
2025-09-30,44,DPD90+,0,0,0
2025-09-30,46,Current,0,0,0
2025-09-30,46,DPD15-29,0,0,0
2025-09-30,46,DPD30-59,0,0,0
2025-09-30,46,DPD60-89,0,0,0
2025-09-30,48,Current,18,7,11
2025-09-30,48,DPD15-29,19,15,4
2025-09-30,48,DPD3-14,14,10,4
2025-09-30,48,DPD30-59,17,13,4
2025-09-30,48,DPD60-89,0,0,0
2025-09-30,48,DPD90+,0,0,0
2025-09-30,54,Current,41,1,40
2025-09-30,56,Current,29,4,25
2025-09-30,56,DPD15-29,2,0,2
2025-09-30,56,DPD3-14,7,2,5
2025-09-30,56,DPD30-59,3,3,0
2025-09-30,56,DPD60-89,0,0,0
2025-09-30,58,Current,146,4,142
2025-09-30,58,DPD3-14,0,0,0
2025-09-30,6,Current,0,0,0
2025-09-29,102,Current,0,0,0
2025-09-29,104,Current,0,0,0
2025-09-29,20,Current,0,0,0
2025-09-29,20,DPD15-29,85,53,32
2025-09-29,20,DPD3-14,84,61,23
2025-09-29,20,DPD30-59,68,51,17
2025-09-29,20,DPD60-89,0,0,0
2025-09-29,20,DPD90+,0,0,0
2025-09-29,22,Current,0,0,0
2025-09-29,24,Current,41,1,40
2025-09-29,24,DPD15-29,53,32,21
2025-09-29,24,DPD3-14,77,46,31
2025-09-29,24,DPD30-59,40,27,13
2025-09-29,24,DPD60-89,0,0,0
2025-09-29,24,DPD90+,0,0,0
2025-09-29,26,Current,0,0,0
2025-09-29,26,DPD15-29,3,1,2
2025-09-29,26,DPD3-14,7,5,2
2025-09-29,26,DPD30-59,6,4,2
2025-09-29,26,DPD60-89,0,0,0
2025-09-29,26,DPD90+,0,0,0
2025-09-29,32,Current,0,0,0
2025-09-29,32,DPD15-29,45,28,17
2025-09-29,32,DPD3-14,54,36,18
2025-09-29,32,DPD30-59,33,24,9
2025-09-29,32,DPD60-89,0,0,0
2025-09-29,32,DPD90+,0,0,0
2025-09-29,34,Current,0,0,0
2025-09-29,34,DPD15-29,11,6,5
2025-09-29,34,DPD3-14,12,8,4
2025-09-29,34,DPD30-59,8,8,0
2025-09-29,34,DPD60-89,0,0,0
2025-09-29,34,DPD90+,0,0,0
2025-09-29,36,Current,0,0,0
2025-09-29,36,DPD15-29,8,6,2
2025-09-29,36,DPD3-14,8,4,4
2025-09-29,36,DPD30-59,8,6,2
2025-09-29,36,DPD60-89,0,0,0
2025-09-29,36,DPD90+,0,0,0
2025-09-29,38,Current,2,0,2
2025-09-29,38,DPD15-29,18,11,7
2025-09-29,38,DPD3-14,14,11,3
2025-09-29,38,DPD30-59,6,4,2
2025-09-29,38,DPD60-89,0,0,0
2025-09-29,38,DPD90+,0,0,0
2025-09-29,40,Current,0,0,0
2025-09-29,40,DPD15-29,4,3,1
2025-09-29,40,DPD3-14,15,10,5
2025-09-29,40,DPD30-59,5,3,2
2025-09-29,40,DPD60-89,0,0,0
2025-09-29,40,DPD90+,0,0,0
2025-09-29,42,Current,0,0,0
2025-09-29,42,DPD15-29,2,2,0
2025-09-29,42,DPD3-14,3,2,1
2025-09-29,42,DPD30-59,5,3,2
2025-09-29,42,DPD60-89,0,0,0
2025-09-29,42,DPD90+,0,0,0
2025-09-29,44,Current,0,0,0
2025-09-29,44,DPD15-29,12,6,6
2025-09-29,44,DPD3-14,20,10,10
2025-09-29,44,DPD30-59,10,9,1
2025-09-29,44,DPD60-89,0,0,0
2025-09-29,44,DPD90+,0,0,0
2025-09-29,46,Current,0,0,0
2025-09-29,46,DPD15-29,1,1,0
2025-09-29,46,DPD30-59,1,0,1
2025-09-29,46,DPD60-89,0,0,0
2025-09-29,48,Current,0,0,0
2025-09-29,48,DPD15-29,22,14,8
2025-09-29,48,DPD3-14,28,19,9
2025-09-29,48,DPD30-59,13,6,7
2025-09-29,48,DPD60-89,0,0,0
2025-09-29,48,DPD90+,0,0,0
2025-09-29,54,Current,70,0,70
2025-09-29,56,Current,20,3,17
2025-09-29,56,DPD15-29,4,1,3
2025-09-29,56,DPD3-14,6,2,4
2025-09-29,56,DPD30-59,1,0,1
2025-09-29,56,DPD60-89,0,0,0
2025-09-29,58,Current,212,8,204
2025-09-29,6,Current,0,0,0
2025-09-28,102,Current,0,0,0
2025-09-28,104,Current,0,0,0
2025-09-28,20,Current,0,0,0
2025-09-28,20,DPD15-29,68,51,17
2025-09-28,20,DPD3-14,71,49,22
2025-09-28,20,DPD30-59,38,26,12
2025-09-28,20,DPD60-89,0,0,0
2025-09-28,20,DPD90+,0,0,0
2025-09-28,22,Current,0,0,0
2025-09-28,24,Current,54,0,54
2025-09-28,24,DPD15-29,53,30,23
2025-09-28,24,DPD3-14,55,29,26
2025-09-28,24,DPD30-59,28,15,13
2025-09-28,24,DPD60-89,0,0,0
2025-09-28,24,DPD90+,0,0,0
2025-09-28,26,Current,0,0,0
2025-09-28,26,DPD15-29,6,6,0
2025-09-28,26,DPD3-14,5,4,1
2025-09-28,26,DPD30-59,0,0,0
2025-09-28,26,DPD60-89,0,0,0
2025-09-28,26,DPD90+,0,0,0
2025-09-28,32,Current,0,0,0
2025-09-28,32,DPD15-29,29,20,9
2025-09-28,32,DPD3-14,27,21,6
2025-09-28,32,DPD30-59,17,12,5
2025-09-28,32,DPD60-89,0,0,0
2025-09-28,32,DPD90+,0,0,0
2025-09-28,34,Current,0,0,0
2025-09-28,34,DPD15-29,10,5,5
2025-09-28,34,DPD3-14,12,9,3
2025-09-28,34,DPD30-59,8,7,1
2025-09-28,34,DPD60-89,0,0,0
2025-09-28,34,DPD90+,0,0,0
2025-09-28,36,Current,0,0,0
2025-09-28,36,DPD15-29,6,4,2
2025-09-28,36,DPD3-14,6,3,3
2025-09-28,36,DPD30-59,3,1,2
2025-09-28,36,DPD60-89,0,0,0
2025-09-28,36,DPD90+,0,0,0
2025-09-28,38,Current,8,2,6
2025-09-28,38,DPD15-29,16,14,2
2025-09-28,38,DPD3-14,15,8,7
2025-09-28,38,DPD30-59,0,0,0
2025-09-28,38,DPD60-89,0,0,0
2025-09-28,38,DPD90+,0,0,0
2025-09-28,40,Current,0,0,0
2025-09-28,40,DPD15-29,7,6,1
2025-09-28,40,DPD3-14,8,3,5
2025-09-28,40,DPD30-59,5,4,1
2025-09-28,40,DPD60-89,0,0,0
2025-09-28,40,DPD90+,0,0,0
2025-09-28,42,Current,0,0,0
2025-09-28,42,DPD15-29,0,0,0
2025-09-28,42,DPD3-14,3,2,1
2025-09-28,42,DPD30-59,2,2,0
2025-09-28,42,DPD60-89,0,0,0
2025-09-28,42,DPD90+,0,0,0
2025-09-28,44,Current,0,0,0
2025-09-28,44,DPD15-29,9,3,6
2025-09-28,44,DPD3-14,10,6,4
2025-09-28,44,DPD30-59,5,3,2
2025-09-28,44,DPD60-89,0,0,0
2025-09-28,44,DPD90+,0,0,0
2025-09-28,46,Current,0,0,0
2025-09-28,46,DPD15-29,0,0,0
2025-09-28,46,DPD30-59,0,0,0
2025-09-28,46,DPD60-89,0,0,0
2025-09-28,48,Current,0,0,0
2025-09-28,48,DPD15-29,16,12,4
2025-09-28,48,DPD3-14,23,17,6
2025-09-28,48,DPD30-59,12,8,4
2025-09-28,48,DPD60-89,0,0,0
2025-09-28,48,DPD90+,0,0,0
2025-09-28,54,Current,10,0,10
2025-09-28,56,Current,14,0,14
2025-09-28,56,DPD15-29,2,0,2
2025-09-28,56,DPD3-14,5,1,4
2025-09-28,56,DPD30-59,3,3,0
2025-09-28,56,DPD60-89,0,0,0
2025-09-28,58,Current,42,3,39
2025-09-28,6,Current,0,0,0
2025-09-27,102,Current,0,0,0
2025-09-27,104,Current,0,0,0
2025-09-27,20,Current,0,0,0
2025-09-27,20,DPD15-29,95,64,31
2025-09-27,20,DPD3-14,83,57,26
2025-09-27,20,DPD30-59,62,48,14
2025-09-27,20,DPD60-89,0,0,0
2025-09-27,20,DPD90+,0,0,0
2025-09-27,22,Current,0,0,0
2025-09-27,24,Current,63,1,62
2025-09-27,24,DPD15-29,60,37,23
2025-09-27,24,DPD3-14,73,46,27
2025-09-27,24,DPD30-59,37,24,13
2025-09-27,24,DPD60-89,0,0,0
2025-09-27,24,DPD90+,0,0,0
2025-09-27,26,Current,0,0,0
2025-09-27,26,DPD15-29,6,4,2
2025-09-27,26,DPD3-14,6,2,4
2025-09-27,26,DPD30-59,5,4,1
2025-09-27,26,DPD60-89,0,0,0
2025-09-27,26,DPD90+,0,0,0
2025-09-27,32,Current,0,0,0
2025-09-27,32,DPD15-29,51,30,21
2025-09-27,32,DPD3-14,55,44,11
2025-09-27,32,DPD30-59,30,22,8
2025-09-27,32,DPD60-89,0,0,0
2025-09-27,32,DPD90+,0,0,0
2025-09-27,34,Current,0,0,0
2025-09-27,34,DPD15-29,14,9,5
2025-09-27,34,DPD3-14,23,16,7
2025-09-27,34,DPD30-59,7,7,0
2025-09-27,34,DPD60-89,0,0,0
2025-09-27,34,DPD90+,0,0,0
2025-09-27,36,Current,0,0,0
2025-09-27,36,DPD15-29,9,7,2
2025-09-27,36,DPD3-14,12,10,2
2025-09-27,36,DPD30-59,7,5,2
2025-09-27,36,DPD60-89,0,0,0
2025-09-27,36,DPD90+,0,0,0
2025-09-27,38,Current,7,1,6
2025-09-27,38,DPD15-29,17,10,7
2025-09-27,38,DPD3-14,17,15,2
2025-09-27,38,DPD30-59,4,3,1
2025-09-27,38,DPD60-89,0,0,0
2025-09-27,38,DPD90+,0,0,0
2025-09-27,40,Current,0,0,0
2025-09-27,40,DPD15-29,5,4,1
2025-09-27,40,DPD3-14,10,7,3
2025-09-27,40,DPD30-59,5,3,2
2025-09-27,40,DPD60-89,0,0,0
2025-09-27,40,DPD90+,0,0,0
2025-09-27,42,Current,0,0,0
2025-09-27,42,DPD15-29,5,4,1
2025-09-27,42,DPD3-14,1,1,0
2025-09-27,42,DPD30-59,4,2,2
2025-09-27,42,DPD60-89,0,0,0
2025-09-27,42,DPD90+,0,0,0
2025-09-27,44,Current,0,0,0
2025-09-27,44,DPD15-29,14,8,6
2025-09-27,44,DPD3-14,19,12,7
2025-09-27,44,DPD30-59,10,9,1
2025-09-27,44,DPD60-89,0,0,0
2025-09-27,44,DPD90+,0,0,0
2025-09-27,46,Current,0,0,0
2025-09-27,46,DPD15-29,1,1,0
2025-09-27,46,DPD30-59,1,0,1
2025-09-27,46,DPD60-89,0,0,0
2025-09-27,48,Current,0,0,0
2025-09-27,48,DPD15-29,22,13,9
2025-09-27,48,DPD3-14,28,19,9
2025-09-27,48,DPD30-59,11,5,6
2025-09-27,48,DPD60-89,0,0,0
2025-09-27,48,DPD90+,0,0,0
2025-09-27,54,Current,6,0,6
2025-09-27,56,Current,23,0,23
2025-09-27,56,DPD15-29,3,1,2
2025-09-27,56,DPD3-14,5,1,4
2025-09-27,56,DPD30-59,1,0,1
2025-09-27,56,DPD60-89,0,0,0
2025-09-27,58,Current,47,1,46
2025-09-27,6,Current,0,0,0
2025-09-26,102,Current,0,0,0
2025-09-26,104,Current,0,0,0
2025-09-26,20,Current,0,0,0
2025-09-26,20,DPD15-29,67,48,19
2025-09-26,20,DPD3-14,145,103,42
2025-09-26,20,DPD30-59,39,26,13
2025-09-26,20,DPD60-89,0,0,0
2025-09-26,20,DPD90+,0,0,0
2025-09-26,22,Current,0,0,0
2025-09-26,24,Current,96,11,85
2025-09-26,24,DPD15-29,59,35,24
2025-09-26,24,DPD3-14,107,81,26
2025-09-26,24,DPD30-59,27,13,14
2025-09-26,24,DPD60-89,0,0,0
2025-09-26,24,DPD90+,0,0,0
2025-09-26,26,Current,0,0,0
2025-09-26,26,DPD15-29,6,5,1
2025-09-26,26,DPD3-14,8,5,3
2025-09-26,26,DPD30-59,1,0,1
2025-09-26,26,DPD60-89,0,0,0
2025-09-26,26,DPD90+,0,0,0
2025-09-26,32,Current,0,0,0
2025-09-26,32,DPD15-29,32,24,8
2025-09-26,32,DPD3-14,73,60,13
2025-09-26,32,DPD30-59,14,10,4
2025-09-26,32,DPD60-89,0,0,0
2025-09-26,32,DPD90+,0,0,0
2025-09-26,34,Current,0,0,0
2025-09-26,34,DPD15-29,9,5,4
2025-09-26,34,DPD3-14,16,14,2
2025-09-26,34,DPD30-59,6,5,1
2025-09-26,34,DPD60-89,0,0,0
2025-09-26,34,DPD90+,0,0,0
2025-09-26,36,Current,0,0,0
2025-09-26,36,DPD15-29,8,5,3
2025-09-26,36,DPD3-14,16,13,3
2025-09-26,36,DPD30-59,3,2,1
2025-09-26,36,DPD60-89,0,0,0
2025-09-26,36,DPD90+,0,0,0
2025-09-26,38,Current,4,0,4
2025-09-26,38,DPD15-29,14,13,1
2025-09-26,38,DPD3-14,15,9,6
2025-09-26,38,DPD30-59,1,1,0
2025-09-26,38,DPD60-89,0,0,0
2025-09-26,38,DPD90+,0,0,0
2025-09-26,40,Current,0,0,0
2025-09-26,40,DPD15-29,7,5,2
2025-09-26,40,DPD3-14,23,16,7
2025-09-26,40,DPD30-59,4,3,1
2025-09-26,40,DPD60-89,0,0,0
2025-09-26,40,DPD90+,0,0,0
2025-09-26,42,Current,0,0,0
2025-09-26,42,DPD15-29,0,0,0
2025-09-26,42,DPD3-14,7,5,2
2025-09-26,42,DPD30-59,2,2,0
2025-09-26,42,DPD60-89,0,0,0
2025-09-26,42,DPD90+,0,0,0
2025-09-26,44,Current,0,0,0
2025-09-26,44,DPD15-29,9,5,4
2025-09-26,44,DPD3-14,16,11,5
2025-09-26,44,DPD30-59,5,3,2
2025-09-26,44,DPD60-89,0,0,0
2025-09-26,44,DPD90+,0,0,0
2025-09-26,46,Current,0,0,0
2025-09-26,46,DPD15-29,0,0,0
2025-09-26,46,DPD30-59,0,0,0
2025-09-26,46,DPD60-89,0,0,0
2025-09-26,48,Current,0,0,0
2025-09-26,48,DPD15-29,14,10,4
2025-09-26,48,DPD3-14,34,21,13
2025-09-26,48,DPD30-59,9,6,3
2025-09-26,48,DPD60-89,0,0,0
2025-09-26,48,DPD90+,0,0,0
2025-09-26,54,Current,29,0,29
2025-09-26,56,Current,15,0,15
2025-09-26,56,DPD15-29,3,0,3
2025-09-26,56,DPD3-14,3,2,1
2025-09-26,56,DPD30-59,3,3,0
2025-09-26,56,DPD60-89,0,0,0
2025-09-26,58,Current,75,7,68
2025-09-26,6,Current,0,0,0
2025-09-25,102,Current,0,0,0
2025-09-25,104,Current,0,0,0
2025-09-25,20,Current,0,0,0
2025-09-25,20,DPD15-29,104,68,36
2025-09-25,20,DPD3-14,71,50,21
2025-09-25,20,DPD30-59,70,55,15
2025-09-25,20,DPD60-89,0,0,0
2025-09-25,20,DPD90+,0,0,0
2025-09-25,22,Current,0,0,0
2025-09-25,24,Current,115,5,110
2025-09-25,24,DPD15-29,74,50,24
2025-09-25,24,DPD3-14,75,53,22
2025-09-25,24,DPD30-59,41,25,16
2025-09-25,24,DPD60-89,0,0,0
2025-09-25,24,DPD90+,0,0,0
2025-09-25,26,Current,0,0,0
2025-09-25,26,DPD15-29,6,4,2
2025-09-25,26,DPD3-14,4,2,2
2025-09-25,26,DPD30-59,6,4,2
2025-09-25,26,DPD60-89,0,0,0
2025-09-25,26,DPD90+,0,0,0
2025-09-25,32,Current,0,0,0
2025-09-25,32,DPD15-29,65,41,24
2025-09-25,32,DPD3-14,45,34,11
2025-09-25,32,DPD30-59,30,22,8
2025-09-25,32,DPD60-89,0,0,0
2025-09-25,32,DPD90+,0,0,0
2025-09-25,34,Current,0,0,0
2025-09-25,34,DPD15-29,11,8,3
2025-09-25,34,DPD3-14,19,12,7
2025-09-25,34,DPD30-59,10,9,1
2025-09-25,34,DPD60-89,0,0,0
2025-09-25,34,DPD90+,0,0,0
2025-09-25,36,Current,0,0,0
2025-09-25,36,DPD15-29,10,9,1
2025-09-25,36,DPD3-14,7,3,4
2025-09-25,36,DPD30-59,8,6,2
2025-09-25,36,DPD60-89,0,0,0
2025-09-25,36,DPD90+,0,0,0
2025-09-25,38,Current,14,0,14
2025-09-25,38,DPD15-29,21,14,7
2025-09-25,38,DPD3-14,18,17,1
2025-09-25,38,DPD30-59,8,7,1
2025-09-25,38,DPD60-89,0,0,0
2025-09-25,38,DPD90+,0,0,0
2025-09-25,40,Current,0,0,0
2025-09-25,40,DPD15-29,8,5,3
2025-09-25,40,DPD3-14,4,3,1
2025-09-25,40,DPD30-59,8,6,2
2025-09-25,40,DPD60-89,0,0,0
2025-09-25,40,DPD90+,0,0,0
2025-09-25,42,Current,0,0,0
2025-09-25,42,DPD15-29,6,5,1
2025-09-25,42,DPD3-14,4,2,2
2025-09-25,42,DPD30-59,5,3,2
2025-09-25,42,DPD60-89,0,0,0
2025-09-25,42,DPD90+,0,0,0
2025-09-25,44,Current,0,0,0
2025-09-25,44,DPD15-29,15,10,5
2025-09-25,44,DPD3-14,15,10,5
2025-09-25,44,DPD30-59,9,8,1
2025-09-25,44,DPD60-89,0,0,0
2025-09-25,44,DPD90+,0,0,0
2025-09-25,46,Current,0,0,0
2025-09-25,46,DPD15-29,1,1,0
2025-09-25,46,DPD3-14,0,0,0
2025-09-25,46,DPD30-59,1,0,1
2025-09-25,46,DPD60-89,0,0,0
2025-09-25,48,Current,0,0,0
2025-09-25,48,DPD15-29,23,14,9
2025-09-25,48,DPD3-14,16,10,6
2025-09-25,48,DPD30-59,13,6,7
2025-09-25,48,DPD60-89,0,0,0
2025-09-25,48,DPD90+,0,0,0
2025-09-25,54,Current,16,1,15
2025-09-25,56,Current,38,1,37
2025-09-25,56,DPD15-29,2,1,1
2025-09-25,56,DPD3-14,4,2,2
2025-09-25,56,DPD30-59,1,0,1
2025-09-25,56,DPD60-89,0,0,0
2025-09-25,58,Current,84,2,82
2025-09-25,6,Current,0,0,0
2025-09-24,102,Current,0,0,0
2025-09-24,104,Current,0,0,0
2025-09-24,20,Current,0,0,0
2025-09-24,20,DPD15-29,68,50,18
2025-09-24,20,DPD3-14,92,68,24
2025-09-24,20,DPD30-59,41,26,15
2025-09-24,20,DPD60-89,0,0,0
2025-09-24,20,DPD90+,0,0,0
2025-09-24,22,Current,0,0,0
2025-09-24,24,Current,22,0,22
2025-09-24,24,DPD15-29,61,39,22
2025-09-24,24,DPD3-14,82,64,18
2025-09-24,24,DPD30-59,38,23,15
2025-09-24,24,DPD60-89,0,0,0
2025-09-24,24,DPD90+,0,0,0
2025-09-24,26,Current,0,0,0
2025-09-24,26,DPD15-29,5,4,1
2025-09-24,26,DPD3-14,9,5,4
2025-09-24,26,DPD30-59,1,0,1
2025-09-24,26,DPD60-89,0,0,0
2025-09-24,26,DPD90+,0,0,0
2025-09-24,32,Current,0,0,0
2025-09-24,32,DPD15-29,40,30,10
2025-09-24,32,DPD3-14,51,34,17
2025-09-24,32,DPD30-59,12,9,3
2025-09-24,32,DPD60-89,0,0,0
2025-09-24,32,DPD90+,0,0,0
2025-09-24,34,Current,0,0,0
2025-09-24,34,DPD15-29,11,6,5
2025-09-24,34,DPD3-14,6,6,0
2025-09-24,34,DPD30-59,11,10,1
2025-09-24,34,DPD60-89,0,0,0
2025-09-24,34,DPD90+,0,0,0
2025-09-24,36,Current,0,0,0
2025-09-24,36,DPD15-29,11,5,6
2025-09-24,36,DPD3-14,9,7,2
2025-09-24,36,DPD30-59,3,3,0
2025-09-24,36,DPD60-89,0,0,0
2025-09-24,36,DPD90+,0,0,0
2025-09-24,38,Current,0,0,0
2025-09-24,38,DPD15-29,16,15,1
2025-09-24,38,DPD3-14,8,4,4
2025-09-24,38,DPD30-59,2,2,0
2025-09-24,38,DPD60-89,0,0,0
2025-09-24,38,DPD90+,0,0,0
2025-09-24,40,Current,0,0,0
2025-09-24,40,DPD15-29,5,3,2
2025-09-24,40,DPD3-14,12,9,3
2025-09-24,40,DPD30-59,4,3,1
2025-09-24,40,DPD60-89,0,0,0
2025-09-24,40,DPD90+,0,0,0
2025-09-24,42,Current,0,0,0
2025-09-24,42,DPD15-29,1,0,1
2025-09-24,42,DPD3-14,4,2,2
2025-09-24,42,DPD30-59,3,3,0
2025-09-24,42,DPD60-89,0,0,0
2025-09-24,42,DPD90+,0,0,0
2025-09-24,44,Current,0,0,0
2025-09-24,44,DPD15-29,11,7,4
2025-09-24,44,DPD3-14,20,13,7
2025-09-24,44,DPD30-59,3,1,2
2025-09-24,44,DPD60-89,0,0,0
2025-09-24,44,DPD90+,0,0,0
2025-09-24,46,Current,0,0,0
2025-09-24,46,DPD15-29,0,0,0
2025-09-24,46,DPD3-14,0,0,0
2025-09-24,46,DPD30-59,0,0,0
2025-09-24,46,DPD60-89,0,0,0
2025-09-24,48,Current,3,3,0
2025-09-24,48,DPD15-29,13,9,4
2025-09-24,48,DPD3-14,32,22,10
2025-09-24,48,DPD30-59,9,7,2
2025-09-24,48,DPD60-89,0,0,0
2025-09-24,48,DPD90+,0,0,0
2025-09-24,54,Current,7,0,7
2025-09-24,56,Current,0,0,0
2025-09-24,56,DPD15-29,3,0,3
2025-09-24,56,DPD3-14,6,2,4
2025-09-24,56,DPD30-59,5,5,0
2025-09-24,56,DPD60-89,0,0,0
2025-09-24,58,Current,18,1,17
2025-09-23,102,Current,0,0,0
2025-09-23,104,Current,0,0,0
2025-09-23,20,Current,6,2,4
2025-09-23,20,DPD15-29,113,75,38
2025-09-23,20,DPD3-14,73,51,22
2025-09-23,20,DPD30-59,59,46,13
2025-09-23,20,DPD60-89,1,1,0
2025-09-23,20,DPD90+,0,0,0
2025-09-23,22,Current,0,0,0
2025-09-23,24,Current,76,7,69
2025-09-23,24,DPD15-29,77,51,26
2025-09-23,24,DPD3-14,58,36,22
2025-09-23,24,DPD30-59,43,28,15
2025-09-23,24,DPD60-89,0,0,0
2025-09-23,24,DPD90+,0,0,0
2025-09-23,26,Current,0,0,0
2025-09-23,26,DPD15-29,6,4,2
2025-09-23,26,DPD3-14,6,5,1
2025-09-23,26,DPD30-59,4,2,2
2025-09-23,26,DPD60-89,0,0,0
2025-09-23,26,DPD90+,0,0,0
2025-09-23,32,Current,3,1,2
2025-09-23,32,DPD15-29,64,39,25
2025-09-23,32,DPD3-14,28,19,9
2025-09-23,32,DPD30-59,25,19,6
2025-09-23,32,DPD60-89,1,0,1
2025-09-23,32,DPD90+,0,0,0
2025-09-23,34,Current,0,0,0
2025-09-23,34,DPD15-29,15,11,4
2025-09-23,34,DPD3-14,16,15,1
2025-09-23,34,DPD30-59,13,12,1
2025-09-23,34,DPD60-89,0,0,0
2025-09-23,34,DPD90+,0,0,0
2025-09-23,36,Current,0,0,0
2025-09-23,36,DPD15-29,10,8,2
2025-09-23,36,DPD3-14,5,1,4
2025-09-23,36,DPD30-59,7,5,2
2025-09-23,36,DPD60-89,0,0,0
2025-09-23,36,DPD90+,0,0,0
2025-09-23,38,Current,1,1,0
2025-09-23,38,DPD15-29,25,16,9
2025-09-23,38,DPD3-14,11,9,2
2025-09-23,38,DPD30-59,6,5,1
2025-09-23,38,DPD60-89,0,0,0
2025-09-23,38,DPD90+,0,0,0
2025-09-23,40,Current,0,0,0
2025-09-23,40,DPD15-29,8,6,2
2025-09-23,40,DPD3-14,3,2,1
2025-09-23,40,DPD30-59,9,7,2
2025-09-23,40,DPD60-89,0,0,0
2025-09-23,40,DPD90+,0,0,0
2025-09-23,42,Current,0,0,0
2025-09-23,42,DPD15-29,8,6,2
2025-09-23,42,DPD3-14,3,1,2
2025-09-23,42,DPD30-59,4,2,2
2025-09-23,42,DPD60-89,0,0,0
2025-09-23,42,DPD90+,0,0,0
2025-09-23,44,Current,3,2,1
2025-09-23,44,DPD15-29,17,11,6
2025-09-23,44,DPD3-14,13,4,9
2025-09-23,44,DPD30-59,6,5,1
2025-09-23,44,DPD60-89,0,0,0
2025-09-23,44,DPD90+,0,0,0
2025-09-23,46,Current,0,0,0
2025-09-23,46,DPD15-29,1,1,0
2025-09-23,46,DPD3-14,0,0,0
2025-09-23,46,DPD30-59,0,0,0
2025-09-23,46,DPD60-89,0,0,0
2025-09-23,48,Current,9,5,4
2025-09-23,48,DPD15-29,21,12,9
2025-09-23,48,DPD3-14,27,21,6
2025-09-23,48,DPD30-59,11,6,5
2025-09-23,48,DPD60-89,0,0,0
2025-09-23,48,DPD90+,0,0,0
2025-09-23,54,Current,27,2,25
2025-09-23,56,Current,0,0,0
2025-09-23,56,DPD15-29,0,0,0
2025-09-23,56,DPD3-14,2,0,2
2025-09-23,56,DPD30-59,0,0,0
2025-09-23,56,DPD60-89,0,0,0
2025-09-23,58,Current,57,0,57
2025-09-22,102,Current,0,0,0
2025-09-22,104,Current,0,0,0
2025-09-22,20,Current,0,0,0
2025-09-22,20,DPD15-29,67,51,16
2025-09-22,20,DPD3-14,89,65,24
2025-09-22,20,DPD30-59,42,28,14
2025-09-22,20,DPD60-89,0,0,0
2025-09-22,20,DPD90+,0,0,0
2025-09-22,22,DPD3-14,0,0,0
2025-09-22,24,Current,89,0,89
2025-09-22,24,DPD15-29,51,32,19
2025-09-22,24,DPD3-14,75,49,26
2025-09-22,24,DPD30-59,38,24,14
2025-09-22,24,DPD60-89,0,0,0
2025-09-22,24,DPD90+,0,0,0
2025-09-22,26,Current,0,0,0
2025-09-22,26,DPD15-29,4,3,1
2025-09-22,26,DPD3-14,7,4,3
2025-09-22,26,DPD30-59,3,1,2
2025-09-22,26,DPD60-89,0,0,0
2025-09-22,26,DPD90+,0,0,0
2025-09-22,32,Current,0,0,0
2025-09-22,32,DPD15-29,48,32,16
2025-09-22,32,DPD3-14,41,28,13
2025-09-22,32,DPD30-59,16,12,4
2025-09-22,32,DPD60-89,0,0,0
2025-09-22,32,DPD90+,0,0,0
2025-09-22,34,Current,0,0,0
2025-09-22,34,DPD15-29,14,9,5
2025-09-22,34,DPD3-14,16,12,4
2025-09-22,34,DPD30-59,11,10,1
2025-09-22,34,DPD60-89,0,0,0
2025-09-22,34,DPD90+,0,0,0
2025-09-22,36,Current,0,0,0
2025-09-22,36,DPD15-29,11,7,4
2025-09-22,36,DPD3-14,10,8,2
2025-09-22,36,DPD30-59,3,3,0
2025-09-22,36,DPD60-89,0,0,0
2025-09-22,36,DPD90+,0,0,0
2025-09-22,38,Current,8,1,7
2025-09-22,38,DPD15-29,11,10,1
2025-09-22,38,DPD3-14,12,7,5
2025-09-22,38,DPD30-59,2,2,0
2025-09-22,38,DPD60-89,0,0,0
2025-09-22,38,DPD90+,0,0,0
2025-09-22,40,Current,0,0,0
2025-09-22,40,DPD15-29,4,3,1
2025-09-22,40,DPD3-14,6,5,1
2025-09-22,40,DPD30-59,4,3,1
2025-09-22,40,DPD60-89,0,0,0
2025-09-22,40,DPD90+,0,0,0
2025-09-22,42,Current,0,0,0
2025-09-22,42,DPD15-29,2,0,2
2025-09-22,42,DPD3-14,3,1,2
2025-09-22,42,DPD30-59,3,3,0
2025-09-22,42,DPD60-89,0,0,0
2025-09-22,42,DPD90+,0,0,0
2025-09-22,44,Current,0,0,0
2025-09-22,44,DPD15-29,10,7,3
2025-09-22,44,DPD3-14,25,15,10
2025-09-22,44,DPD30-59,3,1,2
2025-09-22,44,DPD60-89,0,0,0
2025-09-22,44,DPD90+,0,0,0
2025-09-22,46,Current,0,0,0
2025-09-22,46,DPD15-29,0,0,0
2025-09-22,46,DPD3-14,0,0,0
2025-09-22,46,DPD30-59,0,0,0
2025-09-22,46,DPD60-89,0,0,0
2025-09-22,48,Current,0,0,0
2025-09-22,48,DPD15-29,15,9,6
2025-09-22,48,DPD3-14,30,20,10
2025-09-22,48,DPD30-59,8,6,2
2025-09-22,48,DPD60-89,0,0,0
2025-09-22,48,DPD90+,0,0,0
2025-09-22,54,Current,96,1,95
2025-09-22,56,Current,0,0,0
2025-09-22,56,DPD15-29,3,0,3
2025-09-22,56,DPD3-14,6,2,4
2025-09-22,56,DPD30-59,2,2,0
2025-09-22,56,DPD60-89,0,0,0
2025-09-22,58,Current,139,8,131
2025-09-21,102,Current,0,0,0
2025-09-21,104,Current,0,0,0
2025-09-21,20,Current,0,0,0
2025-09-21,20,DPD15-29,121,81,40
2025-09-21,20,DPD3-14,146,102,44
2025-09-21,20,DPD30-59,52,39,13
2025-09-21,20,DPD60-89,0,0,0
2025-09-21,20,DPD90+,0,0,0
2025-09-21,22,Current,0,0,0
2025-09-21,24,Current,50,5,45
2025-09-21,24,DPD15-29,75,50,25
2025-09-21,24,DPD3-14,101,73,28
2025-09-21,24,DPD30-59,47,33,14
2025-09-21,24,DPD60-89,0,0,0
2025-09-21,24,DPD90+,0,0,0
2025-09-21,26,Current,0,0,0
2025-09-21,26,DPD15-29,8,6,2
2025-09-21,26,DPD3-14,9,8,1
2025-09-21,26,DPD30-59,4,2,2
2025-09-21,26,DPD60-89,0,0,0
2025-09-21,26,DPD90+,0,0,0
2025-09-21,32,Current,0,0,0
2025-09-21,32,DPD15-29,71,42,29
2025-09-21,32,DPD3-14,58,47,11
2025-09-21,32,DPD30-59,25,19,6
2025-09-21,32,DPD60-89,0,0,0
2025-09-21,32,DPD90+,0,0,0
2025-09-21,34,Current,0,0,0
2025-09-21,34,DPD15-29,15,11,4
2025-09-21,34,DPD3-14,18,15,3
2025-09-21,34,DPD30-59,10,9,1
2025-09-21,34,DPD60-89,0,0,0
2025-09-21,34,DPD90+,0,0,0
2025-09-21,36,Current,0,0,0
2025-09-21,36,DPD15-29,12,8,4
2025-09-21,36,DPD3-14,10,6,4
2025-09-21,36,DPD30-59,7,4,3
2025-09-21,36,DPD60-89,0,0,0
2025-09-21,36,DPD90+,0,0,0
2025-09-21,38,Current,6,0,6
2025-09-21,38,DPD15-29,21,13,8
2025-09-21,38,DPD3-14,17,11,6
2025-09-21,38,DPD30-59,8,7,1
2025-09-21,38,DPD60-89,0,0,0
2025-09-21,38,DPD90+,0,0,0
2025-09-21,40,Current,0,0,0
2025-09-21,40,DPD15-29,7,5,2
2025-09-21,40,DPD3-14,17,12,5
2025-09-21,40,DPD30-59,10,8,2
2025-09-21,40,DPD60-89,0,0,0
2025-09-21,40,DPD90+,0,0,0
2025-09-21,42,Current,0,0,0
2025-09-21,42,DPD15-29,6,4,2
2025-09-21,42,DPD3-14,6,5,1
2025-09-21,42,DPD30-59,4,2,2
2025-09-21,42,DPD60-89,0,0,0
2025-09-21,42,DPD90+,0,0,0
2025-09-21,44,Current,0,0,0
2025-09-21,44,DPD15-29,13,10,3
2025-09-21,44,DPD3-14,17,10,7
2025-09-21,44,DPD30-59,6,5,1
2025-09-21,44,DPD60-89,0,0,0
2025-09-21,44,DPD90+,0,0,0
2025-09-21,46,Current,0,0,0
2025-09-21,46,DPD3-14,1,1,0
2025-09-21,46,DPD30-59,0,0,0
2025-09-21,46,DPD60-89,0,0,0
2025-09-21,48,Current,1,0,1
2025-09-21,48,DPD15-29,24,13,11
2025-09-21,48,DPD3-14,32,24,8
2025-09-21,48,DPD30-59,13,6,7
2025-09-21,48,DPD60-89,0,0,0
2025-09-21,48,DPD90+,0,0,0
2025-09-21,54,Current,25,2,23
2025-09-21,56,Current,0,0,0
2025-09-21,56,DPD15-29,0,0,0
2025-09-21,56,DPD3-14,2,0,2
2025-09-21,56,DPD30-59,0,0,0
2025-09-21,56,DPD60-89,0,0,0
2025-09-21,58,Current,49,1,48
2025-09-20,102,Current,0,0,0
2025-09-20,104,Current,0,0,0
2025-09-20,20,Current,0,0,0
2025-09-20,20,DPD15-29,65,48,17
2025-09-20,20,DPD3-14,84,59,25
2025-09-20,20,DPD30-59,42,29,13
2025-09-20,20,DPD60-89,0,0,0
2025-09-20,20,DPD90+,0,0,0
2025-09-20,22,Current,0,0,0
2025-09-20,24,Current,45,2,43
2025-09-20,24,DPD15-29,45,31,14
2025-09-20,24,DPD3-14,67,45,22
2025-09-20,24,DPD30-59,37,22,15
2025-09-20,24,DPD60-89,0,0,0
2025-09-20,24,DPD90+,0,0,0
2025-09-20,26,Current,0,0,0
2025-09-20,26,DPD15-29,3,2,1
2025-09-20,26,DPD3-14,5,4,1
2025-09-20,26,DPD30-59,2,1,1
2025-09-20,26,DPD60-89,0,0,0
2025-09-20,26,DPD90+,0,0,0
2025-09-20,32,Current,0,0,0
2025-09-20,32,DPD15-29,51,33,18
2025-09-20,32,DPD3-14,48,38,10
2025-09-20,32,DPD30-59,18,13,5
2025-09-20,32,DPD60-89,0,0,0
2025-09-20,32,DPD90+,0,0,0
2025-09-20,34,Current,0,0,0
2025-09-20,34,DPD15-29,14,8,6
2025-09-20,34,DPD3-14,11,9,2
2025-09-20,34,DPD30-59,12,11,1
2025-09-20,34,DPD60-89,0,0,0
2025-09-20,34,DPD90+,0,0,0
2025-09-20,36,Current,0,0,0
2025-09-20,36,DPD15-29,11,7,4
2025-09-20,36,DPD3-14,12,9,3
2025-09-20,36,DPD30-59,2,2,0
2025-09-20,36,DPD60-89,0,0,0
2025-09-20,36,DPD90+,0,0,0
2025-09-20,38,Current,6,0,6
2025-09-20,38,DPD15-29,11,10,1
2025-09-20,38,DPD3-14,13,8,5
2025-09-20,38,DPD30-59,2,2,0
2025-09-20,38,DPD60-89,0,0,0
2025-09-20,38,DPD90+,0,0,0
2025-09-20,40,Current,0,0,0
2025-09-20,40,DPD15-29,5,4,1
2025-09-20,40,DPD3-14,6,3,3
2025-09-20,40,DPD30-59,4,4,0
2025-09-20,40,DPD60-89,0,0,0
2025-09-20,40,DPD90+,0,0,0
2025-09-20,42,Current,0,0,0
2025-09-20,42,DPD15-29,3,1,2
2025-09-20,42,DPD3-14,3,2,1
2025-09-20,42,DPD30-59,3,3,0
2025-09-20,42,DPD60-89,0,0,0
2025-09-20,42,DPD90+,0,0,0
2025-09-20,44,Current,0,0,0
2025-09-20,44,DPD15-29,13,8,5
2025-09-20,44,DPD3-14,20,11,9
2025-09-20,44,DPD30-59,6,3,3
2025-09-20,44,DPD60-89,0,0,0
2025-09-20,44,DPD90+,0,0,0
2025-09-20,46,Current,0,0,0
2025-09-20,46,DPD3-14,0,0,0
2025-09-20,46,DPD30-59,0,0,0
2025-09-20,46,DPD60-89,0,0,0
2025-09-20,48,Current,1,0,1
2025-09-20,48,DPD15-29,15,8,7
2025-09-20,48,DPD3-14,24,18,6
2025-09-20,48,DPD30-59,8,6,2
2025-09-20,48,DPD60-89,0,0,0
2025-09-20,48,DPD90+,0,0,0
2025-09-20,54,Current,21,1,20
2025-09-20,56,Current,0,0,0
2025-09-20,56,DPD15-29,2,0,2
2025-09-20,56,DPD3-14,3,1,2
2025-09-20,56,DPD30-59,2,2,0
2025-09-20,56,DPD60-89,0,0,0
2025-09-20,58,Current,31,1,30
2025-09-19,102,Current,0,0,0
2025-09-19,104,Current,0,0,0
2025-09-19,20,Current,0,0,0
2025-09-19,20,DPD15-29,153,110,43
2025-09-19,20,DPD3-14,151,101,50
2025-09-19,20,DPD30-59,53,39,14
2025-09-19,20,DPD60-89,0,0,0
2025-09-19,20,DPD90+,0,0,0
2025-09-19,22,Current,0,0,0
2025-09-19,24,Current,82,2,80
2025-09-19,24,DPD15-29,81,58,23
2025-09-19,24,DPD3-14,96,68,28
2025-09-19,24,DPD30-59,50,37,13
2025-09-19,24,DPD60-89,0,0,0
2025-09-19,24,DPD90+,0,0,0
2025-09-19,26,Current,0,0,0
2025-09-19,26,DPD15-29,10,8,2
2025-09-19,26,DPD3-14,7,5,2
2025-09-19,26,DPD30-59,4,2,2
2025-09-19,26,DPD60-89,0,0,0
2025-09-19,26,DPD90+,0,0,0
2025-09-19,32,Current,0,0,0
2025-09-19,32,DPD15-29,85,50,35
2025-09-19,32,DPD3-14,59,50,9
2025-09-19,32,DPD30-59,28,22,6
2025-09-19,32,DPD60-89,0,0,0
2025-09-19,32,DPD90+,0,0,0
2025-09-19,34,Current,0,0,0
2025-09-19,34,DPD15-29,19,14,5
2025-09-19,34,DPD3-14,16,11,5
2025-09-19,34,DPD30-59,10,9,1
2025-09-19,34,DPD60-89,0,0,0
2025-09-19,34,DPD90+,0,0,0
2025-09-19,36,Current,0,0,0
2025-09-19,36,DPD15-29,15,11,4
2025-09-19,36,DPD3-14,12,6,6
2025-09-19,36,DPD30-59,7,4,3
2025-09-19,36,DPD60-89,0,0,0
2025-09-19,36,DPD90+,0,0,0
2025-09-19,38,Current,7,0,7
2025-09-19,38,DPD15-29,26,13,13
2025-09-19,38,DPD3-14,21,19,2
2025-09-19,38,DPD30-59,7,7,0
2025-09-19,38,DPD60-89,0,0,0
2025-09-19,38,DPD90+,0,0,0
2025-09-19,40,Current,0,0,0
2025-09-19,40,DPD15-29,8,6,2
2025-09-19,40,DPD3-14,17,11,6
2025-09-19,40,DPD30-59,10,8,2
2025-09-19,40,DPD60-89,0,0,0
2025-09-19,40,DPD90+,0,0,0
2025-09-19,42,Current,0,0,0
2025-09-19,42,DPD15-29,10,8,2
2025-09-19,42,DPD3-14,6,6,0
2025-09-19,42,DPD30-59,3,1,2
2025-09-19,42,DPD60-89,0,0,0
2025-09-19,42,DPD90+,0,0,0
2025-09-19,44,Current,0,0,0
2025-09-19,44,DPD15-29,17,14,3
2025-09-19,44,DPD3-14,22,12,10
2025-09-19,44,DPD30-59,8,7,1
2025-09-19,44,DPD60-89,0,0,0
2025-09-19,44,DPD90+,0,0,0
2025-09-19,46,Current,0,0,0
2025-09-19,46,DPD3-14,1,1,0
2025-09-19,46,DPD30-59,0,0,0
2025-09-19,46,DPD60-89,0,0,0
2025-09-19,48,Current,0,0,0
2025-09-19,48,DPD15-29,28,19,9
2025-09-19,48,DPD3-14,29,21,8
2025-09-19,48,DPD30-59,14,6,8
2025-09-19,48,DPD60-89,0,0,0
2025-09-19,48,DPD90+,0,0,0
2025-09-19,54,Current,62,3,59
2025-09-19,56,Current,0,0,0
2025-09-19,56,DPD15-29,1,0,1
2025-09-19,56,DPD3-14,4,1,3
2025-09-19,56,DPD30-59,0,0,0
2025-09-19,56,DPD60-89,0,0,0
2025-09-19,58,Current,68,1,67
2025-09-18,102,Current,0,0,0
2025-09-18,104,Current,0,0,0
2025-09-18,20,Current,9,2,7
2025-09-18,20,DPD15-29,81,62,19
2025-09-18,20,DPD3-14,67,42,25
2025-09-18,20,DPD30-59,48,36,12
2025-09-18,20,DPD60-89,0,0,0
2025-09-18,20,DPD90+,1,1,0
2025-09-18,22,Current,0,0,0
2025-09-18,24,Current,74,15,59
2025-09-18,24,DPD15-29,50,36,14
2025-09-18,24,DPD3-14,54,33,21
2025-09-18,24,DPD30-59,41,24,17
2025-09-18,24,DPD60-89,0,0,0
2025-09-18,24,DPD90+,0,0,0
2025-09-18,26,Current,1,0,1
2025-09-18,26,DPD15-29,3,1,2
2025-09-18,26,DPD3-14,3,3,0
2025-09-18,26,DPD30-59,2,1,1
2025-09-18,26,DPD60-89,0,0,0
2025-09-18,26,DPD90+,0,0,0
2025-09-18,32,Current,8,2,6
2025-09-18,32,DPD15-29,54,35,19
2025-09-18,32,DPD3-14,23,16,7
2025-09-18,32,DPD30-59,20,15,5
2025-09-18,32,DPD60-89,1,0,1
2025-09-18,32,DPD90+,0,0,0
2025-09-18,34,Current,0,0,0
2025-09-18,34,DPD15-29,20,14,6
2025-09-18,34,DPD3-14,14,11,3
2025-09-18,34,DPD30-59,11,10,1
2025-09-18,34,DPD60-89,0,0,0
2025-09-18,34,DPD90+,0,0,0
2025-09-18,36,Current,1,1,0
2025-09-18,36,DPD15-29,13,8,5
2025-09-18,36,DPD3-14,6,3,3
2025-09-18,36,DPD30-59,5,4,1
2025-09-18,36,DPD60-89,0,0,0
2025-09-18,36,DPD90+,0,0,0
2025-09-18,38,Current,9,3,6
2025-09-18,38,DPD15-29,13,10,3
2025-09-18,38,DPD3-14,15,9,6
2025-09-18,38,DPD30-59,3,3,0
2025-09-18,38,DPD60-89,0,0,0
2025-09-18,38,DPD90+,0,0,0
2025-09-18,40,Current,1,0,1
2025-09-18,40,DPD15-29,7,6,1
2025-09-18,40,DPD3-14,4,3,1
2025-09-18,40,DPD30-59,4,4,0
2025-09-18,40,DPD60-89,0,0,0
2025-09-18,40,DPD90+,0,0,0
2025-09-18,42,Current,0,0,0
2025-09-18,42,DPD15-29,4,2,2
2025-09-18,42,DPD3-14,3,2,1
2025-09-18,42,DPD30-59,2,2,0
2025-09-18,42,DPD60-89,0,0,0
2025-09-18,42,DPD90+,0,0,0
2025-09-18,44,Current,4,2,2
2025-09-18,44,DPD15-29,15,11,4
2025-09-18,44,DPD3-14,19,6,13
2025-09-18,44,DPD30-59,5,2,3
2025-09-18,44,DPD60-89,0,0,0
2025-09-18,44,DPD90+,0,0,0
2025-09-18,46,Current,0,0,0
2025-09-18,46,DPD3-14,1,1,0
2025-09-18,46,DPD30-59,0,0,0
2025-09-18,46,DPD60-89,0,0,0
2025-09-18,48,Current,15,7,8
2025-09-18,48,DPD15-29,19,11,8
2025-09-18,48,DPD3-14,18,16,2
2025-09-18,48,DPD30-59,8,5,3
2025-09-18,48,DPD60-89,0,0,0
2025-09-18,48,DPD90+,0,0,0
2025-09-18,54,Current,16,0,16
2025-09-18,56,Current,0,0,0
2025-09-18,56,DPD15-29,2,0,2
2025-09-18,56,DPD3-14,1,0,1
2025-09-18,56,DPD30-59,2,2,0
2025-09-18,56,DPD60-89,0,0,0
2025-09-18,58,Current,24,2,22
2025-09-17,102,Current,0,0,0
2025-09-17,104,Current,0,0,0
2025-09-17,20,Current,0,0,0
2025-09-17,20,DPD15-29,165,124,41
2025-09-17,20,DPD3-14,62,48,14
2025-09-17,20,DPD30-59,66,47,19
2025-09-17,20,DPD60-89,0,0,0
2025-09-17,20,DPD90+,0,0,0
2025-09-17,22,Current,0,0,0
2025-09-17,24,Current,79,1,78
2025-09-17,24,DPD15-29,96,69,27
2025-09-17,24,DPD3-14,50,24,26
2025-09-17,24,DPD30-59,53,38,15
2025-09-17,24,DPD60-89,0,0,0
2025-09-17,24,DPD90+,0,0,0
2025-09-17,26,Current,0,0,0
2025-09-17,26,DPD15-29,12,9,3
2025-09-17,26,DPD3-14,3,3,0
2025-09-17,26,DPD30-59,5,3,2
2025-09-17,26,DPD60-89,0,0,0
2025-09-17,26,DPD90+,0,0,0
2025-09-17,32,Current,0,0,0
2025-09-17,32,DPD15-29,96,61,35
2025-09-17,32,DPD3-14,23,14,9
2025-09-17,32,DPD30-59,30,23,7
2025-09-17,32,DPD60-89,0,0,0
2025-09-17,32,DPD90+,0,0,0
2025-09-17,34,Current,0,0,0
2025-09-17,34,DPD15-29,25,20,5
2025-09-17,34,DPD3-14,9,6,3
2025-09-17,34,DPD30-59,11,10,1
2025-09-17,34,DPD60-89,0,0,0
2025-09-17,34,DPD90+,0,0,0
2025-09-17,36,Current,0,0,0
2025-09-17,36,DPD15-29,20,12,8
2025-09-17,36,DPD3-14,7,4,3
2025-09-17,36,DPD30-59,8,5,3
2025-09-17,36,DPD60-89,0,0,0
2025-09-17,36,DPD90+,0,0,0
2025-09-17,38,Current,6,1,5
2025-09-17,38,DPD15-29,28,16,12
2025-09-17,38,DPD3-14,10,8,2
2025-09-17,38,DPD30-59,9,9,0
2025-09-17,38,DPD60-89,0,0,0
2025-09-17,38,DPD90+,0,0,0
2025-09-17,40,Current,0,0,0
2025-09-17,40,DPD15-29,10,8,2
2025-09-17,40,DPD3-14,2,1,1
2025-09-17,40,DPD30-59,8,6,2
2025-09-17,40,DPD60-89,0,0,0
2025-09-17,40,DPD90+,0,0,0
2025-09-17,42,Current,0,0,0
2025-09-17,42,DPD15-29,10,8,2
2025-09-17,42,DPD3-14,2,1,1
2025-09-17,42,DPD30-59,5,3,2
2025-09-17,42,DPD60-89,0,0,0
2025-09-17,42,DPD90+,0,0,0
2025-09-17,44,Current,0,0,0
2025-09-17,44,DPD15-29,15,12,3
2025-09-17,44,DPD3-14,11,6,5
2025-09-17,44,DPD30-59,9,8,1
2025-09-17,44,DPD60-89,0,0,0
2025-09-17,44,DPD90+,0,0,0
2025-09-17,46,Current,0,0,0
2025-09-17,46,DPD3-14,0,0,0
2025-09-17,46,DPD30-59,0,0,0
2025-09-17,46,DPD60-89,0,0,0
2025-09-17,48,Current,0,0,0
2025-09-17,48,DPD15-29,31,20,11
2025-09-17,48,DPD3-14,19,12,7
2025-09-17,48,DPD30-59,17,8,9
2025-09-17,48,DPD60-89,0,0,0
2025-09-17,48,DPD90+,0,0,0
2025-09-17,54,Current,33,0,33
2025-09-17,56,Current,0,0,0
2025-09-17,56,DPD15-29,2,1,1
2025-09-17,56,DPD3-14,7,3,4
2025-09-17,56,DPD30-59,1,1,0
2025-09-17,56,DPD60-89,0,0,0
2025-09-17,58,Current,52,2,50
2025-09-16,102,Current,0,0,0
2025-09-16,104,Current,0,0,0
2025-09-16,20,Current,31,24,7
2025-09-16,20,DPD15-29,88,68,20
2025-09-16,20,DPD3-14,71,46,25
2025-09-16,20,DPD30-59,50,39,11
2025-09-16,20,DPD60-89,1,1,0
2025-09-16,20,DPD90+,1,1,0
2025-09-16,22,Current,0,0,0
2025-09-16,24,Current,179,76,103
2025-09-16,24,DPD15-29,56,41,15
2025-09-16,24,DPD3-14,60,33,27
2025-09-16,24,DPD30-59,43,26,17
2025-09-16,24,DPD60-89,1,1,0
2025-09-16,24,DPD90+,0,0,0
2025-09-16,26,Current,1,0,1
2025-09-16,26,DPD15-29,3,2,1
2025-09-16,26,DPD3-14,3,3,0
2025-09-16,26,DPD30-59,4,2,2
2025-09-16,26,DPD60-89,0,0,0
2025-09-16,26,DPD90+,0,0,0
2025-09-16,32,Current,12,6,6
2025-09-16,32,DPD15-29,57,37,20
2025-09-16,32,DPD3-14,25,14,11
2025-09-16,32,DPD30-59,24,19,5
2025-09-16,32,DPD60-89,1,0,1
2025-09-16,32,DPD90+,3,3,0
2025-09-16,34,Current,2,2,0
2025-09-16,34,DPD15-29,18,14,4
2025-09-16,34,DPD3-14,13,7,6
2025-09-16,34,DPD30-59,11,11,0
2025-09-16,34,DPD60-89,0,0,0
2025-09-16,34,DPD90+,0,0,0
2025-09-16,36,Current,1,1,0
2025-09-16,36,DPD15-29,13,7,6
2025-09-16,36,DPD3-14,4,4,0
2025-09-16,36,DPD30-59,6,5,1
2025-09-16,36,DPD60-89,0,0,0
2025-09-16,36,DPD90+,0,0,0
2025-09-16,38,Current,15,8,7
2025-09-16,38,DPD15-29,9,6,3
2025-09-16,38,DPD3-14,14,9,5
2025-09-16,38,DPD30-59,8,8,0
2025-09-16,38,DPD60-89,0,0,0
2025-09-16,38,DPD90+,0,0,0
2025-09-16,40,Current,3,2,1
2025-09-16,40,DPD15-29,8,7,1
2025-09-16,40,DPD3-14,7,6,1
2025-09-16,40,DPD30-59,3,3,0
2025-09-16,40,DPD60-89,0,0,0
2025-09-16,40,DPD90+,0,0,0
2025-09-16,42,Current,0,0,0
2025-09-16,42,DPD15-29,4,2,2
2025-09-16,42,DPD3-14,0,0,0
2025-09-16,42,DPD30-59,2,2,0
2025-09-16,42,DPD60-89,0,0,0
2025-09-16,42,DPD90+,0,0,0
2025-09-16,44,Current,19,17,2
2025-09-16,44,DPD15-29,18,13,5
2025-09-16,44,DPD3-14,6,1,5
2025-09-16,44,DPD30-59,3,1,2
2025-09-16,44,DPD60-89,0,0,0
2025-09-16,44,DPD90+,0,0,0
2025-09-16,46,Current,0,0,0
2025-09-16,46,DPD3-14,0,0,0
2025-09-16,46,DPD60-89,0,0,0
2025-09-16,48,Current,34,26,8
2025-09-16,48,DPD15-29,23,15,8
2025-09-16,48,DPD3-14,25,19,6
2025-09-16,48,DPD30-59,7,5,2
2025-09-16,48,DPD60-89,0,0,0
2025-09-16,48,DPD90+,0,0,0
2025-09-16,54,Current,22,0,22
2025-09-16,56,Current,7,7,0
2025-09-16,56,DPD15-29,2,0,2
2025-09-16,56,DPD3-14,2,0,2
2025-09-16,56,DPD30-59,2,2,0
2025-09-16,56,DPD60-89,0,0,0
2025-09-16,58,Current,43,3,40
2025-09-15,102,Current,0,0,0
2025-09-15,104,Current,0,0,0
2025-09-15,20,Current,0,0,0
2025-09-15,20,DPD15-29,150,120,30
2025-09-15,20,DPD3-14,47,32,15
2025-09-15,20,DPD30-59,74,53,21
2025-09-15,20,DPD60-89,0,0,0
2025-09-15,20,DPD90+,0,0,0
2025-09-15,22,Current,0,0,0
2025-09-15,24,Current,120,3,117
2025-09-15,24,DPD15-29,96,70,26
2025-09-15,24,DPD3-14,46,26,20
2025-09-15,24,DPD30-59,54,39,15
2025-09-15,24,DPD60-89,0,0,0
2025-09-15,24,DPD90+,0,0,0
2025-09-15,26,Current,0,0,0
2025-09-15,26,DPD15-29,12,10,2
2025-09-15,26,DPD3-14,2,2,0
2025-09-15,26,DPD30-59,5,3,2
2025-09-15,26,DPD60-89,0,0,0
2025-09-15,26,DPD90+,0,0,0
2025-09-15,32,Current,0,0,0
2025-09-15,32,DPD15-29,87,58,29
2025-09-15,32,DPD3-14,27,20,7
2025-09-15,32,DPD30-59,31,24,7
2025-09-15,32,DPD60-89,0,0,0
2025-09-15,32,DPD90+,0,0,0
2025-09-15,34,Current,0,0,0
2025-09-15,34,DPD15-29,24,20,4
2025-09-15,34,DPD3-14,11,7,4
2025-09-15,34,DPD30-59,11,10,1
2025-09-15,34,DPD60-89,0,0,0
2025-09-15,34,DPD90+,0,0,0
2025-09-15,36,Current,0,0,0
2025-09-15,36,DPD15-29,20,13,7
2025-09-15,36,DPD3-14,10,5,5
2025-09-15,36,DPD30-59,9,6,3
2025-09-15,36,DPD60-89,0,0,0
2025-09-15,36,DPD90+,0,0,0
2025-09-15,38,Current,15,0,15
2025-09-15,38,DPD15-29,25,17,8
2025-09-15,38,DPD3-14,10,3,7
2025-09-15,38,DPD30-59,11,11,0
2025-09-15,38,DPD60-89,0,0,0
2025-09-15,38,DPD90+,0,0,0
2025-09-15,40,Current,0,0,0
2025-09-15,40,DPD15-29,7,6,1
2025-09-15,40,DPD3-14,6,3,3
2025-09-15,40,DPD30-59,8,7,1
2025-09-15,40,DPD60-89,0,0,0
2025-09-15,40,DPD90+,0,0,0
2025-09-15,42,Current,0,0,0
2025-09-15,42,DPD15-29,8,6,2
2025-09-15,42,DPD3-14,1,1,0
2025-09-15,42,DPD30-59,3,2,1
2025-09-15,42,DPD60-89,0,0,0
2025-09-15,42,DPD90+,0,0,0
2025-09-15,44,Current,13,0,13
2025-09-15,44,DPD15-29,17,14,3
2025-09-15,44,DPD3-14,10,5,5
2025-09-15,44,DPD30-59,10,8,2
2025-09-15,44,DPD60-89,0,0,0
2025-09-15,44,DPD90+,0,0,0
2025-09-15,46,Current,0,0,0
2025-09-15,46,DPD3-14,0,0,0
2025-09-15,46,DPD60-89,0,0,0
2025-09-15,48,Current,0,0,0
2025-09-15,48,DPD15-29,34,21,13
2025-09-15,48,DPD3-14,13,8,5
2025-09-15,48,DPD30-59,18,9,9
2025-09-15,48,DPD60-89,0,0,0
2025-09-15,48,DPD90+,0,0,0
2025-09-15,54,Current,64,1,63
2025-09-15,56,Current,22,1,21
2025-09-15,56,DPD15-29,2,1,1
2025-09-15,56,DPD3-14,2,0,2
2025-09-15,56,DPD30-59,1,1,0
2025-09-15,56,DPD60-89,0,0,0
2025-09-15,58,Current,72,0,72
2025-09-14,102,Current,0,0,0
2025-09-14,104,Current,0,0,0
2025-09-14,20,Current,0,0,0
2025-09-14,20,DPD15-29,120,90,30
2025-09-14,20,DPD3-14,64,37,27
2025-09-14,20,DPD30-59,50,40,10
2025-09-14,20,DPD60-89,0,0,0
2025-09-14,20,DPD90+,0,0,0
2025-09-14,22,Current,0,0,0
2025-09-14,24,Current,32,2,30
2025-09-14,24,DPD15-29,66,48,18
2025-09-14,24,DPD3-14,57,40,17
2025-09-14,24,DPD30-59,37,23,14
2025-09-14,24,DPD60-89,0,0,0
2025-09-14,24,DPD90+,0,0,0
2025-09-14,26,Current,0,0,0
2025-09-14,26,DPD15-29,7,5,2
2025-09-14,26,DPD3-14,5,5,0
2025-09-14,26,DPD30-59,3,2,1
2025-09-14,26,DPD60-89,0,0,0
2025-09-14,26,DPD90+,0,0,0
2025-09-14,32,Current,0,0,0
2025-09-14,32,DPD15-29,77,54,23
2025-09-14,32,DPD3-14,27,17,10
2025-09-14,32,DPD30-59,24,18,6
2025-09-14,32,DPD60-89,0,0,0
2025-09-14,32,DPD90+,0,0,0
2025-09-14,34,Current,0,0,0
2025-09-14,34,DPD15-29,19,15,4
2025-09-14,34,DPD3-14,6,3,3
2025-09-14,34,DPD30-59,11,11,0
2025-09-14,34,DPD60-89,0,0,0
2025-09-14,34,DPD90+,0,0,0
2025-09-14,36,Current,0,0,0
2025-09-14,36,DPD15-29,20,13,7
2025-09-14,36,DPD3-14,6,3,3
2025-09-14,36,DPD30-59,4,3,1
2025-09-14,36,DPD60-89,0,0,0
2025-09-14,36,DPD90+,0,0,0
2025-09-14,38,Current,4,0,4
2025-09-14,38,DPD15-29,13,9,4
2025-09-14,38,DPD3-14,14,12,2
2025-09-14,38,DPD30-59,8,8,0
2025-09-14,38,DPD60-89,0,0,0
2025-09-14,38,DPD90+,0,0,0
2025-09-14,40,Current,0,0,0
2025-09-14,40,DPD15-29,12,9,3
2025-09-14,40,DPD3-14,7,5,2
2025-09-14,40,DPD30-59,5,5,0
2025-09-14,40,DPD60-89,0,0,0
2025-09-14,40,DPD90+,0,0,0
2025-09-14,42,Current,0,0,0
2025-09-14,42,DPD15-29,5,3,2
2025-09-14,42,DPD3-14,1,1,0
2025-09-14,42,DPD30-59,2,2,0
2025-09-14,42,DPD60-89,0,0,0
2025-09-14,42,DPD90+,0,0,0
2025-09-14,44,Current,0,0,0
2025-09-14,44,DPD15-29,20,15,5
2025-09-14,44,DPD3-14,13,5,8
2025-09-14,44,DPD30-59,4,2,2
2025-09-14,44,DPD60-89,0,0,0
2025-09-14,44,DPD90+,0,0,0
2025-09-14,46,Current,0,0,0
2025-09-14,46,DPD3-14,0,0,0
2025-09-14,46,DPD30-59,0,0,0
2025-09-14,46,DPD60-89,0,0,0
2025-09-14,48,Current,0,0,0
2025-09-14,48,DPD15-29,24,17,7
2025-09-14,48,DPD3-14,16,11,5
2025-09-14,48,DPD30-59,8,5,3
2025-09-14,48,DPD60-89,0,0,0
2025-09-14,48,DPD90+,0,0,0
2025-09-14,54,Current,7,0,7
2025-09-14,56,Current,15,0,15
2025-09-14,56,DPD15-29,2,0,2
2025-09-14,56,DPD3-14,3,0,3
2025-09-14,56,DPD30-59,3,2,1
2025-09-14,56,DPD60-89,0,0,0
2025-09-14,58,Current,24,0,24
2025-09-13,102,Current,0,0,0
2025-09-13,104,Current,0,0,0
2025-09-13,20,Current,0,0,0
2025-09-13,20,DPD15-29,160,126,34
2025-09-13,20,DPD3-14,47,32,15
2025-09-13,20,DPD30-59,78,54,24
2025-09-13,20,DPD60-89,0,0,0
2025-09-13,20,DPD90+,0,0,0
2025-09-13,22,Current,0,0,0
2025-09-13,24,Current,38,0,38
2025-09-13,24,DPD15-29,98,71,27
2025-09-13,24,DPD3-14,46,30,16
2025-09-13,24,DPD30-59,56,42,14
2025-09-13,24,DPD60-89,0,0,0
2025-09-13,24,DPD90+,0,0,0
2025-09-13,26,Current,0,0,0
2025-09-13,26,DPD15-29,12,10,2
2025-09-13,26,DPD3-14,3,1,2
2025-09-13,26,DPD30-59,5,3,2
2025-09-13,26,DPD60-89,0,0,0
2025-09-13,26,DPD90+,0,0,0
2025-09-13,32,Current,0,0,0
2025-09-13,32,DPD15-29,92,62,30
2025-09-13,32,DPD3-14,26,21,5
2025-09-13,32,DPD30-59,41,31,10
2025-09-13,32,DPD60-89,0,0,0
2025-09-13,32,DPD90+,0,0,0
2025-09-13,34,Current,0,0,0
2025-09-13,34,DPD15-29,25,22,3
2025-09-13,34,DPD3-14,10,7,3
2025-09-13,34,DPD30-59,14,13,1
2025-09-13,34,DPD60-89,0,0,0
2025-09-13,34,DPD90+,0,0,0
2025-09-13,36,Current,0,0,0
2025-09-13,36,DPD15-29,22,14,8
2025-09-13,36,DPD3-14,7,5,2
2025-09-13,36,DPD30-59,9,6,3
2025-09-13,36,DPD60-89,0,0,0
2025-09-13,36,DPD90+,0,0,0
2025-09-13,38,Current,6,0,6
2025-09-13,38,DPD15-29,26,19,7
2025-09-13,38,DPD3-14,14,8,6
2025-09-13,38,DPD30-59,10,10,0
2025-09-13,38,DPD60-89,0,0,0
2025-09-13,38,DPD90+,0,0,0
2025-09-13,40,Current,0,0,0
2025-09-13,40,DPD15-29,7,6,1
2025-09-13,40,DPD3-14,5,2,3
2025-09-13,40,DPD30-59,7,7,0
2025-09-13,40,DPD60-89,0,0,0
2025-09-13,40,DPD90+,0,0,0
2025-09-13,42,Current,0,0,0
2025-09-13,42,DPD15-29,8,6,2
2025-09-13,42,DPD3-14,3,3,0
2025-09-13,42,DPD30-59,3,2,1
2025-09-13,42,DPD60-89,0,0,0
2025-09-13,42,DPD90+,0,0,0
2025-09-13,44,Current,0,0,0
2025-09-13,44,DPD15-29,20,17,3
2025-09-13,44,DPD3-14,11,4,7
2025-09-13,44,DPD30-59,12,10,2
2025-09-13,44,DPD60-89,0,0,0
2025-09-13,44,DPD90+,0,0,0
2025-09-13,46,Current,0,0,0
2025-09-13,46,DPD15-29,0,0,0
2025-09-13,46,DPD3-14,1,1,0
2025-09-13,46,DPD60-89,0,0,0
2025-09-13,48,Current,1,0,1
2025-09-13,48,DPD15-29,37,23,14
2025-09-13,48,DPD3-14,11,10,1
2025-09-13,48,DPD30-59,18,10,8
2025-09-13,48,DPD60-89,0,0,0
2025-09-13,48,DPD90+,0,0,0
2025-09-13,54,Current,5,0,5
2025-09-13,56,Current,13,1,12
2025-09-13,56,DPD15-29,4,3,1
2025-09-13,56,DPD3-14,1,0,1
2025-09-13,56,DPD30-59,1,1,0
2025-09-13,56,DPD60-89,0,0,0
2025-09-13,58,Current,39,0,39
2025-09-12,102,Current,0,0,0
2025-09-12,104,Current,0,0,0
2025-09-12,20,Current,0,0,0
2025-09-12,20,DPD15-29,148,113,35
2025-09-12,20,DPD3-14,92,58,34
2025-09-12,20,DPD30-59,67,55,12
2025-09-12,20,DPD60-89,0,0,0
2025-09-12,20,DPD90+,0,0,0
2025-09-12,22,Current,0,0,0
2025-09-12,24,Current,33,0,33
2025-09-12,24,DPD15-29,84,64,20
2025-09-12,24,DPD3-14,71,39,32
2025-09-12,24,DPD30-59,40,27,13
2025-09-12,24,DPD60-89,0,0,0
2025-09-12,24,DPD90+,0,0,0
2025-09-12,26,Current,0,0,0
2025-09-12,26,DPD15-29,7,5,2
2025-09-12,26,DPD3-14,5,2,3
2025-09-12,26,DPD30-59,4,3,1
2025-09-12,26,DPD60-89,0,0,0
2025-09-12,26,DPD90+,0,0,0
2025-09-12,32,Current,0,0,0
2025-09-12,32,DPD15-29,86,61,25
2025-09-12,32,DPD3-14,49,31,18
2025-09-12,32,DPD30-59,28,22,6
2025-09-12,32,DPD60-89,0,0,0
2025-09-12,32,DPD90+,0,0,0
2025-09-12,34,Current,0,0,0
2025-09-12,34,DPD15-29,18,14,4
2025-09-12,34,DPD3-14,7,5,2
2025-09-12,34,DPD30-59,15,15,0
2025-09-12,34,DPD60-89,0,0,0
2025-09-12,34,DPD90+,0,0,0
2025-09-12,36,Current,0,0,0
2025-09-12,36,DPD15-29,23,16,7
2025-09-12,36,DPD3-14,12,8,4
2025-09-12,36,DPD30-59,4,2,2
2025-09-12,36,DPD60-89,0,0,0
2025-09-12,36,DPD90+,0,0,0
2025-09-12,38,Current,9,1,8
2025-09-12,38,DPD15-29,15,10,5
2025-09-12,38,DPD3-14,24,16,8
2025-09-12,38,DPD30-59,9,9,0
2025-09-12,38,DPD60-89,0,0,0
2025-09-12,38,DPD90+,0,0,0
2025-09-12,40,Current,0,0,0
2025-09-12,40,DPD15-29,14,10,4
2025-09-12,40,DPD3-14,9,7,2
2025-09-12,40,DPD30-59,5,5,0
2025-09-12,40,DPD60-89,0,0,0
2025-09-12,40,DPD90+,0,0,0
2025-09-12,42,Current,0,0,0
2025-09-12,42,DPD15-29,7,5,2
2025-09-12,42,DPD3-14,5,4,1
2025-09-12,42,DPD30-59,3,3,0
2025-09-12,42,DPD60-89,0,0,0
2025-09-12,42,DPD90+,0,0,0
2025-09-12,44,Current,0,0,0
2025-09-12,44,DPD15-29,25,19,6
2025-09-12,44,DPD3-14,18,10,8
2025-09-12,44,DPD30-59,10,7,3
2025-09-12,44,DPD60-89,0,0,0
2025-09-12,44,DPD90+,0,0,0
2025-09-12,46,Current,0,0,0
2025-09-12,46,DPD15-29,2,1,1
2025-09-12,46,DPD3-14,0,0,0
2025-09-12,46,DPD60-89,0,0,0
2025-09-12,48,Current,0,0,0
2025-09-12,48,DPD15-29,33,21,12
2025-09-12,48,DPD3-14,15,12,3
2025-09-12,48,DPD30-59,8,6,2
2025-09-12,48,DPD60-89,0,0,0
2025-09-12,48,DPD90+,0,0,0
2025-09-12,54,Current,18,0,18
2025-09-12,56,Current,17,1,16
2025-09-12,56,DPD15-29,4,0,4
2025-09-12,56,DPD3-14,6,1,5
2025-09-12,56,DPD30-59,4,3,1
2025-09-12,56,DPD60-89,0,0,0
2025-09-12,58,Current,42,2,40
2025-09-11,102,Current,0,0,0
2025-09-11,104,Current,0,0,0
2025-09-11,20,Current,40,40,0
2025-09-11,20,DPD15-29,137,100,37
2025-09-11,20,DPD3-14,52,29,23
2025-09-11,20,DPD30-59,83,60,23
2025-09-11,20,DPD60-89,0,0,0
2025-09-11,20,DPD90+,0,0,0
2025-09-11,22,Current,0,0,0
2025-09-11,24,Current,195,114,81
2025-09-11,24,DPD15-29,85,63,22
2025-09-11,24,DPD3-14,49,28,21
2025-09-11,24,DPD30-59,58,45,13
2025-09-11,24,DPD60-89,2,2,0
2025-09-11,24,DPD90+,0,0,0
2025-09-11,26,Current,0,0,0
2025-09-11,26,DPD15-29,12,9,3
2025-09-11,26,DPD3-14,1,0,1
2025-09-11,26,DPD30-59,5,3,2
2025-09-11,26,DPD60-89,0,0,0
2025-09-11,26,DPD90+,0,0,0
2025-09-11,32,Current,8,8,0
2025-09-11,32,DPD15-29,68,48,20
2025-09-11,32,DPD3-14,13,9,4
2025-09-11,32,DPD30-59,42,33,9
2025-09-11,32,DPD60-89,0,0,0
2025-09-11,32,DPD90+,2,2,0
2025-09-11,34,Current,8,8,0
2025-09-11,34,DPD15-29,19,16,3
2025-09-11,34,DPD3-14,6,3,3
2025-09-11,34,DPD30-59,15,13,2
2025-09-11,34,DPD60-89,0,0,0
2025-09-11,34,DPD90+,0,0,0
2025-09-11,36,Current,2,2,0
2025-09-11,36,DPD15-29,16,8,8
2025-09-11,36,DPD3-14,0,0,0
2025-09-11,36,DPD30-59,8,5,3
2025-09-11,36,DPD60-89,0,0,0
2025-09-11,36,DPD90+,0,0,0
2025-09-11,38,Current,22,12,10
2025-09-11,38,DPD15-29,18,11,7
2025-09-11,38,DPD3-14,16,8,8
2025-09-11,38,DPD30-59,11,11,0
2025-09-11,38,DPD60-89,0,0,0
2025-09-11,38,DPD90+,1,1,0
2025-09-11,40,Current,3,3,0
2025-09-11,40,DPD15-29,11,9,2
2025-09-11,40,DPD3-14,5,4,1
2025-09-11,40,DPD30-59,8,8,0
2025-09-11,40,DPD60-89,0,0,0
2025-09-11,40,DPD90+,0,0,0
2025-09-11,42,Current,0,0,0
2025-09-11,42,DPD15-29,7,6,1
2025-09-11,42,DPD3-14,1,1,0
2025-09-11,42,DPD30-59,4,3,1
2025-09-11,42,DPD60-89,0,0,0
2025-09-11,42,DPD90+,0,0,0
2025-09-11,44,Current,20,20,0
2025-09-11,44,DPD15-29,16,13,3
2025-09-11,44,DPD3-14,14,4,10
2025-09-11,44,DPD30-59,12,9,3
2025-09-11,44,DPD60-89,0,0,0
2025-09-11,44,DPD90+,1,1,0
2025-09-11,46,Current,0,0,0
2025-09-11,46,DPD15-29,0,0,0
2025-09-11,46,DPD3-14,1,1,0
2025-09-11,46,DPD60-89,0,0,0
2025-09-11,48,Current,49,46,3
2025-09-11,48,DPD15-29,31,23,8
2025-09-11,48,DPD3-14,18,11,7
2025-09-11,48,DPD30-59,18,10,8
2025-09-11,48,DPD60-89,2,2,0
2025-09-11,48,DPD90+,0,0,0
2025-09-11,54,Current,14,1,13
2025-09-11,56,Current,48,15,33
2025-09-11,56,DPD15-29,3,3,0
2025-09-11,56,DPD3-14,1,0,1
2025-09-11,56,DPD30-59,1,1,0
2025-09-11,56,DPD60-89,0,0,0
2025-09-11,58,Current,53,3,50
2025-09-10,102,Current,0,0,0
2025-09-10,104,Current,0,0,0
2025-09-10,20,Current,0,0,0
2025-09-10,20,DPD15-29,153,120,33
2025-09-10,20,DPD3-14,28,20,8
2025-09-10,20,DPD30-59,67,55,12
2025-09-10,20,DPD60-89,0,0,0
2025-09-10,20,DPD90+,0,0,0
2025-09-10,22,Current,0,0,0
2025-09-10,24,Current,38,3,35
2025-09-10,24,DPD15-29,85,64,21
2025-09-10,24,DPD3-14,37,17,20
2025-09-10,24,DPD30-59,41,28,13
2025-09-10,24,DPD60-89,0,0,0
2025-09-10,24,DPD90+,0,0,0
2025-09-10,26,Current,0,0,0
2025-09-10,26,DPD15-29,9,7,2
2025-09-10,26,DPD3-14,2,1,1
2025-09-10,26,DPD30-59,4,3,1
2025-09-10,26,DPD60-89,0,0,0
2025-09-10,26,DPD90+,0,0,0
2025-09-10,32,Current,0,0,0
2025-09-10,32,DPD15-29,89,63,26
2025-09-10,32,DPD3-14,12,6,6
2025-09-10,32,DPD30-59,29,24,5
2025-09-10,32,DPD60-89,0,0,0
2025-09-10,32,DPD90+,0,0,0
2025-09-10,34,Current,0,0,0
2025-09-10,34,DPD15-29,18,13,5
2025-09-10,34,DPD3-14,5,3,2
2025-09-10,34,DPD30-59,17,17,0
2025-09-10,34,DPD60-89,0,0,0
2025-09-10,34,DPD90+,0,0,0
2025-09-10,36,Current,0,0,0
2025-09-10,36,DPD15-29,20,15,5
2025-09-10,36,DPD3-14,6,4,2
2025-09-10,36,DPD30-59,4,2,2
2025-09-10,36,DPD60-89,0,0,0
2025-09-10,36,DPD90+,0,0,0
2025-09-10,38,Current,4,0,4
2025-09-10,38,DPD15-29,16,10,6
2025-09-10,38,DPD3-14,12,7,5
2025-09-10,38,DPD30-59,11,11,0
2025-09-10,38,DPD60-89,0,0,0
2025-09-10,38,DPD90+,0,0,0
2025-09-10,40,Current,0,0,0
2025-09-10,40,DPD15-29,16,12,4
2025-09-10,40,DPD3-14,4,4,0
2025-09-10,40,DPD30-59,5,5,0
2025-09-10,40,DPD60-89,0,0,0
2025-09-10,40,DPD90+,0,0,0
2025-09-10,42,Current,0,0,0
2025-09-10,42,DPD15-29,7,5,2
2025-09-10,42,DPD3-14,0,0,0
2025-09-10,42,DPD30-59,3,3,0
2025-09-10,42,DPD60-89,0,0,0
2025-09-10,42,DPD90+,0,0,0
2025-09-10,44,Current,0,0,0
2025-09-10,44,DPD15-29,22,15,7
2025-09-10,44,DPD3-14,6,4,2
2025-09-10,44,DPD30-59,10,8,2
2025-09-10,44,DPD60-89,0,0,0
2025-09-10,44,DPD90+,0,0,0
2025-09-10,46,Current,0,0,0
2025-09-10,46,DPD15-29,2,1,1
2025-09-10,46,DPD3-14,0,0,0
2025-09-10,46,DPD60-89,0,0,0
2025-09-10,48,Current,1,0,1
2025-09-10,48,DPD15-29,32,21,11
2025-09-10,48,DPD3-14,7,5,2
2025-09-10,48,DPD30-59,8,5,3
2025-09-10,48,DPD60-89,0,0,0
2025-09-10,48,DPD90+,0,0,0
2025-09-10,54,Current,16,1,15
2025-09-10,56,Current,0,0,0
2025-09-10,56,DPD15-29,5,1,4
2025-09-10,56,DPD3-14,4,2,2
2025-09-10,56,DPD30-59,4,3,1
2025-09-10,58,Current,33,0,33
2025-09-09,102,Current,0,0,0
2025-09-09,104,Current,0,0,0
2025-09-09,20,Current,11,2,9
2025-09-09,20,DPD15-29,132,96,36
2025-09-09,20,DPD3-14,39,22,17
2025-09-09,20,DPD30-59,70,51,19
2025-09-09,20,DPD60-89,1,1,0
2025-09-09,20,DPD90+,1,1,0
2025-09-09,22,Current,0,0,0
2025-09-09,24,Current,138,18,120
2025-09-09,24,DPD15-29,87,66,21
2025-09-09,24,DPD3-14,28,16,12
2025-09-09,24,DPD30-59,49,36,13
2025-09-09,24,DPD60-89,0,0,0
2025-09-09,24,DPD90+,0,0,0
2025-09-09,26,Current,2,1,1
2025-09-09,26,DPD15-29,13,10,3
2025-09-09,26,DPD3-14,4,2,2
2025-09-09,26,DPD30-59,6,5,1
2025-09-09,26,DPD60-89,0,0,0
2025-09-09,26,DPD90+,0,0,0
2025-09-09,32,Current,13,4,9
2025-09-09,32,DPD15-29,69,49,20
2025-09-09,32,DPD3-14,20,15,5
2025-09-09,32,DPD30-59,36,29,7
2025-09-09,32,DPD60-89,1,0,1
2025-09-09,32,DPD90+,1,1,0
2025-09-09,34,Current,2,2,0
2025-09-09,34,DPD15-29,18,15,3
2025-09-09,34,DPD3-14,1,1,0
2025-09-09,34,DPD30-59,13,11,2
2025-09-09,34,DPD60-89,0,0,0
2025-09-09,34,DPD90+,0,0,0
2025-09-09,36,Current,0,0,0
2025-09-09,36,DPD15-29,19,11,8
2025-09-09,36,DPD3-14,2,1,1
2025-09-09,36,DPD30-59,7,4,3
2025-09-09,36,DPD60-89,0,0,0
2025-09-09,36,DPD90+,0,0,0
2025-09-09,38,Current,11,3,8
2025-09-09,38,DPD15-29,17,11,6
2025-09-09,38,DPD3-14,10,6,4
2025-09-09,38,DPD30-59,11,10,1
2025-09-09,38,DPD60-89,0,0,0
2025-09-09,38,DPD90+,0,0,0
2025-09-09,40,Current,3,1,2
2025-09-09,40,DPD15-29,12,10,2
2025-09-09,40,DPD3-14,1,1,0
2025-09-09,40,DPD30-59,8,8,0
2025-09-09,40,DPD60-89,0,0,0
2025-09-09,40,DPD90+,0,0,0
2025-09-09,42,Current,0,0,0
2025-09-09,42,DPD15-29,7,6,1
2025-09-09,42,DPD3-14,0,0,0
2025-09-09,42,DPD30-59,1,1,0
2025-09-09,42,DPD60-89,0,0,0
2025-09-09,42,DPD90+,0,0,0
2025-09-09,44,Current,7,2,5
2025-09-09,44,DPD15-29,13,10,3
2025-09-09,44,DPD3-14,6,3,3
2025-09-09,44,DPD30-59,9,6,3
2025-09-09,44,DPD60-89,0,0,0
2025-09-09,44,DPD90+,0,0,0
2025-09-09,46,Current,0,0,0
2025-09-09,46,DPD15-29,0,0,0
2025-09-09,46,DPD60-89,0,0,0
2025-09-09,48,Current,19,7,12
2025-09-09,48,DPD15-29,30,23,7
2025-09-09,48,DPD3-14,14,10,4
2025-09-09,48,DPD30-59,16,11,5
2025-09-09,48,DPD60-89,0,0,0
2025-09-09,48,DPD90+,0,0,0
2025-09-09,54,Current,61,0,61
2025-09-09,56,Current,1,1,0
2025-09-09,56,DPD15-29,3,3,0
2025-09-09,56,DPD3-14,1,0,1
2025-09-09,56,DPD30-59,1,1,0
2025-09-09,58,Current,59,1,58
2025-09-09,6,Current,0,0,0
2025-09-08,102,Current,0,0,0
2025-09-08,104,Current,0,0,0
2025-09-08,20,Current,1,1,0
2025-09-08,20,DPD15-29,138,110,28
2025-09-08,20,DPD3-14,87,70,17
2025-09-08,20,DPD30-59,78,62,16
2025-09-08,20,DPD60-89,0,0,0
2025-09-08,20,DPD90+,0,0,0
2025-09-08,22,Current,0,0,0
2025-09-08,24,Current,40,3,37
2025-09-08,24,DPD15-29,82,62,20
2025-09-08,24,DPD3-14,84,57,27
2025-09-08,24,DPD30-59,43,31,12
2025-09-08,24,DPD60-89,0,0,0
2025-09-08,24,DPD90+,0,0,0
2025-09-08,26,Current,0,0,0
2025-09-08,26,DPD15-29,8,6,2
2025-09-08,26,DPD3-14,5,3,2
2025-09-08,26,DPD30-59,4,3,1
2025-09-08,26,DPD60-89,0,0,0
2025-09-08,26,DPD90+,0,0,0
2025-09-08,32,Current,0,0,0
2025-09-08,32,DPD15-29,76,57,19
2025-09-08,32,DPD3-14,58,36,22
2025-09-08,32,DPD30-59,34,27,7
2025-09-08,32,DPD60-89,0,0,0
2025-09-08,32,DPD90+,0,0,0
2025-09-08,34,Current,0,0,0
2025-09-08,34,DPD15-29,18,15,3
2025-09-08,34,DPD3-14,15,10,5
2025-09-08,34,DPD30-59,17,17,0
2025-09-08,34,DPD60-89,0,0,0
2025-09-08,34,DPD90+,0,0,0
2025-09-08,36,Current,0,0,0
2025-09-08,36,DPD15-29,17,14,3
2025-09-08,36,DPD3-14,19,18,1
2025-09-08,36,DPD30-59,4,2,2
2025-09-08,36,DPD60-89,0,0,0
2025-09-08,36,DPD90+,0,0,0
2025-09-08,38,Current,2,0,2
2025-09-08,38,DPD15-29,16,12,4
2025-09-08,38,DPD3-14,22,17,5
2025-09-08,38,DPD30-59,13,13,0
2025-09-08,38,DPD60-89,0,0,0
2025-09-08,38,DPD90+,0,0,0
2025-09-08,40,Current,0,0,0
2025-09-08,40,DPD15-29,14,9,5
2025-09-08,40,DPD3-14,7,5,2
2025-09-08,40,DPD30-59,7,7,0
2025-09-08,40,DPD60-89,0,0,0
2025-09-08,40,DPD90+,0,0,0
2025-09-08,42,Current,0,0,0
2025-09-08,42,DPD15-29,4,3,1
2025-09-08,42,DPD3-14,3,2,1
2025-09-08,42,DPD30-59,3,3,0
2025-09-08,42,DPD60-89,0,0,0
2025-09-08,42,DPD90+,0,0,0
2025-09-08,44,Current,0,0,0
2025-09-08,44,DPD15-29,19,12,7
2025-09-08,44,DPD3-14,16,9,7
2025-09-08,44,DPD30-59,11,8,3
2025-09-08,44,DPD60-89,0,0,0
2025-09-08,44,DPD90+,0,0,0
2025-09-08,46,Current,0,0,0
2025-09-08,46,DPD15-29,2,1,1
2025-09-08,46,DPD60-89,0,0,0
2025-09-08,48,Current,5,0,5
2025-09-08,48,DPD15-29,27,17,10
2025-09-08,48,DPD3-14,23,12,11
2025-09-08,48,DPD30-59,8,5,3
2025-09-08,48,DPD60-89,0,0,0
2025-09-08,48,DPD90+,0,0,0
2025-09-08,54,Current,20,2,18
2025-09-08,56,Current,0,0,0
2025-09-08,56,DPD15-29,4,1,3
2025-09-08,56,DPD3-14,2,0,2
2025-09-08,56,DPD30-59,4,3,1
2025-09-08,58,Current,22,0,22
2025-09-08,6,Current,0,0,0
2025-09-07,102,Current,0,0,0
2025-09-07,104,Current,0,0,0
2025-09-07,20,Current,0,0,0
2025-09-07,20,DPD15-29,128,94,34
2025-09-07,20,DPD3-14,108,63,45
2025-09-07,20,DPD30-59,74,55,19
2025-09-07,20,DPD60-89,0,0,0
2025-09-07,20,DPD90+,0,0,0
2025-09-07,22,Current,0,0,0
2025-09-07,24,Current,36,2,34
2025-09-07,24,DPD15-29,87,68,19
2025-09-07,24,DPD3-14,69,47,22
2025-09-07,24,DPD30-59,58,42,16
2025-09-07,24,DPD60-89,0,0,0
2025-09-07,24,DPD90+,0,0,0
2025-09-07,26,Current,0,0,0
2025-09-07,26,DPD15-29,11,8,3
2025-09-07,26,DPD3-14,8,4,4
2025-09-07,26,DPD30-59,7,5,2
2025-09-07,26,DPD60-89,0,0,0
2025-09-07,26,DPD90+,0,0,0
2025-09-07,32,Current,0,0,0
2025-09-07,32,DPD15-29,66,48,18
2025-09-07,32,DPD3-14,59,41,18
2025-09-07,32,DPD30-59,34,29,5
2025-09-07,32,DPD60-89,0,0,0
2025-09-07,32,DPD90+,0,0,0
2025-09-07,34,Current,0,0,0
2025-09-07,34,DPD15-29,16,13,3
2025-09-07,34,DPD3-14,11,8,3
2025-09-07,34,DPD30-59,14,11,3
2025-09-07,34,DPD60-89,0,0,0
2025-09-07,34,DPD90+,0,0,0
2025-09-07,36,Current,0,0,0
2025-09-07,36,DPD15-29,16,8,8
2025-09-07,36,DPD3-14,16,12,4
2025-09-07,36,DPD30-59,8,5,3
2025-09-07,36,DPD60-89,0,0,0
2025-09-07,36,DPD90+,0,0,0
2025-09-07,38,Current,2,0,2
2025-09-07,38,DPD15-29,19,14,5
2025-09-07,38,DPD3-14,11,5,6
2025-09-07,38,DPD30-59,12,11,1
2025-09-07,38,DPD60-89,0,0,0
2025-09-07,38,DPD90+,0,0,0
2025-09-07,40,Current,0,0,0
2025-09-07,40,DPD15-29,13,11,2
2025-09-07,40,DPD3-14,6,5,1
2025-09-07,40,DPD30-59,9,9,0
2025-09-07,40,DPD60-89,0,0,0
2025-09-07,40,DPD90+,0,0,0
2025-09-07,42,Current,0,0,0
2025-09-07,42,DPD15-29,5,5,0
2025-09-07,42,DPD3-14,6,5,1
2025-09-07,42,DPD30-59,1,1,0
2025-09-07,42,DPD60-89,0,0,0
2025-09-07,42,DPD90+,0,0,0
2025-09-07,44,Current,0,0,0
2025-09-07,44,DPD15-29,10,7,3
2025-09-07,44,DPD3-14,25,13,12
2025-09-07,44,DPD30-59,11,7,4
2025-09-07,44,DPD60-89,0,0,0
2025-09-07,44,DPD90+,0,0,0
2025-09-07,46,Current,0,0,0
2025-09-07,46,DPD15-29,0,0,0
2025-09-07,46,DPD60-89,0,0,0
2025-09-07,48,Current,16,1,15
2025-09-07,48,DPD15-29,32,24,8
2025-09-07,48,DPD3-14,15,9,6
2025-09-07,48,DPD30-59,17,12,5
2025-09-07,48,DPD60-89,0,0,0
2025-09-07,48,DPD90+,0,0,0
2025-09-07,54,Current,20,0,20
2025-09-07,56,Current,0,0,0
2025-09-07,56,DPD15-29,3,3,0
2025-09-07,56,DPD3-14,2,0,2
2025-09-07,56,DPD30-59,0,0,0
2025-09-07,58,Current,8,0,8
2025-09-07,6,Current,0,0,0
2025-09-06,102,Current,0,0,0
2025-09-06,104,Current,0,0,0
2025-09-06,20,Current,0,0,0
2025-09-06,20,DPD15-29,122,95,27
2025-09-06,20,DPD3-14,37,30,7
2025-09-06,20,DPD30-59,82,66,16
2025-09-06,20,DPD60-89,0,0,0
2025-09-06,20,DPD90+,0,0,0
2025-09-06,22,Current,0,0,0
2025-09-06,24,Current,31,1,30
2025-09-06,24,DPD15-29,81,62,19
2025-09-06,24,DPD3-14,34,17,17
2025-09-06,24,DPD30-59,44,32,12
2025-09-06,24,DPD60-89,0,0,0
2025-09-06,24,DPD90+,0,0,0
2025-09-06,26,Current,0,0,0
2025-09-06,26,DPD15-29,7,5,2
2025-09-06,26,DPD3-14,1,0,1
2025-09-06,26,DPD30-59,4,3,1
2025-09-06,26,DPD60-89,0,0,0
2025-09-06,26,DPD90+,0,0,0
2025-09-06,32,Current,0,0,0
2025-09-06,32,DPD15-29,64,47,17
2025-09-06,32,DPD3-14,23,11,12
2025-09-06,32,DPD30-59,37,29,8
2025-09-06,32,DPD60-89,0,0,0
2025-09-06,32,DPD90+,0,0,0
2025-09-06,34,Current,0,0,0
2025-09-06,34,DPD15-29,17,15,2
2025-09-06,34,DPD3-14,8,3,5
2025-09-06,34,DPD30-59,17,17,0
2025-09-06,34,DPD60-89,0,0,0
2025-09-06,34,DPD90+,0,0,0
2025-09-06,36,Current,0,0,0
2025-09-06,36,DPD15-29,16,13,3
2025-09-06,36,DPD3-14,4,4,0
2025-09-06,36,DPD30-59,5,3,2
2025-09-06,36,DPD60-89,0,0,0
2025-09-06,36,DPD90+,0,0,0
2025-09-06,38,Current,2,0,2
2025-09-06,38,DPD15-29,14,10,4
2025-09-06,38,DPD3-14,8,6,2
2025-09-06,38,DPD30-59,13,13,0
2025-09-06,38,DPD60-89,0,0,0
2025-09-06,38,DPD90+,0,0,0
2025-09-06,40,Current,0,0,0
2025-09-06,40,DPD15-29,14,8,6
2025-09-06,40,DPD3-14,2,2,0
2025-09-06,40,DPD30-59,7,7,0
2025-09-06,40,DPD60-89,0,0,0
2025-09-06,40,DPD90+,0,0,0
2025-09-06,42,Current,0,0,0
2025-09-06,42,DPD15-29,4,3,1
2025-09-06,42,DPD3-14,2,2,0
2025-09-06,42,DPD30-59,3,3,0
2025-09-06,42,DPD60-89,0,0,0
2025-09-06,42,DPD90+,0,0,0
2025-09-06,44,Current,0,0,0
2025-09-06,44,DPD15-29,16,12,4
2025-09-06,44,DPD3-14,9,4,5
2025-09-06,44,DPD30-59,12,9,3
2025-09-06,44,DPD60-89,0,0,0
2025-09-06,44,DPD90+,0,0,0
2025-09-06,46,Current,0,0,0
2025-09-06,46,DPD15-29,2,1,1
2025-09-06,46,DPD60-89,0,0,0
2025-09-06,48,Current,22,3,19
2025-09-06,48,DPD15-29,27,18,9
2025-09-06,48,DPD3-14,10,5,5
2025-09-06,48,DPD30-59,8,5,3
2025-09-06,48,DPD60-89,0,0,0
2025-09-06,48,DPD90+,0,0,0
2025-09-06,54,Current,23,0,23
2025-09-06,56,Current,0,0,0
2025-09-06,56,DPD15-29,3,1,2
2025-09-06,56,DPD3-14,1,0,1
2025-09-06,56,DPD30-59,4,3,1
2025-09-06,56,DPD90+,0,0,0
2025-09-06,58,Current,0,0,0
2025-09-06,6,Current,0,0,0
2025-09-05,102,Current,0,0,0
2025-09-05,104,Current,0,0,0
2025-09-05,20,Current,0,0,0
2025-09-05,20,DPD15-29,133,97,36
2025-09-05,20,DPD3-14,117,72,45
2025-09-05,20,DPD30-59,58,43,15
2025-09-05,20,DPD60-89,0,0,0
2025-09-05,20,DPD90+,0,0,0
2025-09-05,22,Current,0,0,0
2025-09-05,24,Current,62,0,62
2025-09-05,24,DPD15-29,94,72,22
2025-09-05,24,DPD3-14,62,37,25
2025-09-05,24,DPD30-59,47,35,12
2025-09-05,24,DPD60-89,0,0,0
2025-09-05,24,DPD90+,0,0,0
2025-09-05,26,Current,0,0,0
2025-09-05,26,DPD15-29,12,8,4
2025-09-05,26,DPD3-14,5,3,2
2025-09-05,26,DPD30-59,6,4,2
2025-09-05,26,DPD60-89,0,0,0
2025-09-05,26,DPD90+,0,0,0
2025-09-05,32,Current,0,0,0
2025-09-05,32,DPD15-29,58,43,15
2025-09-05,32,DPD3-14,60,36,24
2025-09-05,32,DPD30-59,34,28,6
2025-09-05,32,DPD60-89,0,0,0
2025-09-05,32,DPD90+,0,0,0
2025-09-05,34,Current,0,0,0
2025-09-05,34,DPD15-29,18,15,3
2025-09-05,34,DPD3-14,13,5,8
2025-09-05,34,DPD30-59,11,9,2
2025-09-05,34,DPD60-89,0,0,0
2025-09-05,34,DPD90+,0,0,0
2025-09-05,36,Current,0,0,0
2025-09-05,36,DPD15-29,17,10,7
2025-09-05,36,DPD3-14,15,11,4
2025-09-05,36,DPD30-59,7,5,2
2025-09-05,36,DPD60-89,0,0,0
2025-09-05,36,DPD90+,0,0,0
2025-09-05,38,Current,7,1,6
2025-09-05,38,DPD15-29,18,14,4
2025-09-05,38,DPD3-14,13,5,8
2025-09-05,38,DPD30-59,8,7,1
2025-09-05,38,DPD60-89,0,0,0
2025-09-05,38,DPD90+,0,0,0
2025-09-05,40,Current,0,0,0
2025-09-05,40,DPD15-29,15,13,2
2025-09-05,40,DPD3-14,10,7,3
2025-09-05,40,DPD30-59,7,7,0
2025-09-05,40,DPD60-89,0,0,0
2025-09-05,40,DPD90+,0,0,0
2025-09-05,42,Current,0,0,0
2025-09-05,42,DPD15-29,2,2,0
2025-09-05,42,DPD3-14,7,5,2
2025-09-05,42,DPD30-59,2,2,0
2025-09-05,42,DPD60-89,0,0,0
2025-09-05,42,DPD90+,0,0,0
2025-09-05,44,Current,0,0,0
2025-09-05,44,DPD15-29,12,6,6
2025-09-05,44,DPD3-14,25,9,16
2025-09-05,44,DPD30-59,12,7,5
2025-09-05,44,DPD60-89,0,0,0
2025-09-05,44,DPD90+,0,0,0
2025-09-05,46,Current,0,0,0
2025-09-05,46,DPD15-29,0,0,0
2025-09-05,46,DPD60-89,0,0,0
2025-09-05,48,Current,20,0,20
2025-09-05,48,DPD15-29,35,27,8
2025-09-05,48,DPD3-14,20,12,8
2025-09-05,48,DPD30-59,16,10,6
2025-09-05,48,DPD60-89,0,0,0
2025-09-05,48,DPD90+,0,0,0
2025-09-05,54,Current,25,1,24
2025-09-05,56,Current,0,0,0
2025-09-05,56,DPD15-29,3,3,0
2025-09-05,56,DPD3-14,4,1,3
2025-09-05,56,DPD30-59,0,0,0
2025-09-05,56,DPD90+,0,0,0
2025-09-05,58,Current,18,0,18
2025-09-05,6,Current,0,0,0
2025-09-04,102,Current,0,0,0
2025-09-04,104,Current,0,0,0
2025-09-04,20,Current,0,0,0
2025-09-04,20,DPD15-29,118,92,26
2025-09-04,20,DPD3-14,18,14,4
2025-09-04,20,DPD30-59,79,67,12
2025-09-04,20,DPD60-89,0,0,0
2025-09-04,20,DPD90+,0,0,0
2025-09-04,22,Current,0,0,0
2025-09-04,24,Current,81,6,75
2025-09-04,24,DPD15-29,82,64,18
2025-09-04,24,DPD3-14,11,5,6
2025-09-04,24,DPD30-59,37,27,10
2025-09-04,24,DPD60-89,0,0,0
2025-09-04,24,DPD90+,0,0,0
2025-09-04,26,Current,0,0,0
2025-09-04,26,DPD15-29,8,6,2
2025-09-04,26,DPD3-14,3,3,0
2025-09-04,26,DPD30-59,6,4,2
2025-09-04,26,DPD60-89,0,0,0
2025-09-04,26,DPD90+,0,0,0
2025-09-04,32,Current,0,0,0
2025-09-04,32,DPD15-29,61,46,15
2025-09-04,32,DPD3-14,10,7,3
2025-09-04,32,DPD30-59,37,30,7
2025-09-04,32,DPD60-89,0,0,0
2025-09-04,32,DPD90+,0,0,0
2025-09-04,34,Current,0,0,0
2025-09-04,34,DPD15-29,15,14,1
2025-09-04,34,DPD3-14,5,4,1
2025-09-04,34,DPD30-59,14,14,0
2025-09-04,34,DPD60-89,0,0,0
2025-09-04,34,DPD90+,0,0,0
2025-09-04,36,Current,0,0,0
2025-09-04,36,DPD15-29,12,10,2
2025-09-04,36,DPD3-14,2,1,1
2025-09-04,36,DPD30-59,4,2,2
2025-09-04,36,DPD60-89,0,0,0
2025-09-04,36,DPD90+,0,0,0
2025-09-04,38,Current,7,0,7
2025-09-04,38,DPD15-29,14,10,4
2025-09-04,38,DPD3-14,5,3,2
2025-09-04,38,DPD30-59,12,11,1
2025-09-04,38,DPD60-89,0,0,0
2025-09-04,38,DPD90+,0,0,0
2025-09-04,40,Current,0,0,0
2025-09-04,40,DPD15-29,14,8,6
2025-09-04,40,DPD3-14,2,2,0
2025-09-04,40,DPD30-59,6,6,0
2025-09-04,40,DPD60-89,0,0,0
2025-09-04,40,DPD90+,0,0,0
2025-09-04,42,Current,0,0,0
2025-09-04,42,DPD15-29,6,5,1
2025-09-04,42,DPD3-14,2,1,1
2025-09-04,42,DPD30-59,2,2,0
2025-09-04,42,DPD60-89,0,0,0
2025-09-04,42,DPD90+,0,0,0
2025-09-04,44,Current,22,0,22
2025-09-04,44,DPD15-29,16,11,5
2025-09-04,44,DPD3-14,3,3,0
2025-09-04,44,DPD30-59,11,8,3
2025-09-04,44,DPD60-89,0,0,0
2025-09-04,44,DPD90+,0,0,0
2025-09-04,46,Current,0,0,0
2025-09-04,46,DPD15-29,2,1,1
2025-09-04,46,DPD60-89,0,0,0
2025-09-04,48,Current,8,0,8
2025-09-04,48,DPD15-29,30,21,9
2025-09-04,48,DPD3-14,7,4,3
2025-09-04,48,DPD30-59,7,3,4
2025-09-04,48,DPD60-89,0,0,0
2025-09-04,48,DPD90+,0,0,0
2025-09-04,54,Current,16,0,16
2025-09-04,56,Current,20,1,19
2025-09-04,56,DPD15-29,1,0,1
2025-09-04,56,DPD3-14,2,0,2
2025-09-04,56,DPD30-59,3,2,1
2025-09-04,56,DPD90+,0,0,0
2025-09-04,58,Current,16,0,16
2025-09-04,6,Current,0,0,0
2025-09-03,102,Current,0,0,0
2025-09-03,104,Current,0,0,0
2025-09-03,20,Current,0,0,0
2025-09-03,20,DPD15-29,99,73,26
2025-09-03,20,DPD3-14,108,85,23
2025-09-03,20,DPD30-59,58,45,13
2025-09-03,20,DPD60-89,0,0,0
2025-09-03,20,DPD90+,0,0,0
2025-09-03,22,Current,0,0,0
2025-09-03,24,Current,39,0,39
2025-09-03,24,DPD15-29,84,60,24
2025-09-03,24,DPD3-14,79,55,24
2025-09-03,24,DPD30-59,37,28,9
2025-09-03,24,DPD60-89,0,0,0
2025-09-03,24,DPD90+,0,0,0
2025-09-03,26,Current,0,0,0
2025-09-03,26,DPD15-29,11,6,5
2025-09-03,26,DPD3-14,5,4,1
2025-09-03,26,DPD30-59,5,4,1
2025-09-03,26,DPD60-89,0,0,0
2025-09-03,26,DPD90+,0,0,0
2025-09-03,32,Current,0,0,0
2025-09-03,32,DPD15-29,48,35,13
2025-09-03,32,DPD3-14,70,44,26
2025-09-03,32,DPD30-59,29,24,5
2025-09-03,32,DPD60-89,0,0,0
2025-09-03,32,DPD90+,0,0,0
2025-09-03,34,Current,0,0,0
2025-09-03,34,DPD15-29,16,12,4
2025-09-03,34,DPD3-14,15,12,3
2025-09-03,34,DPD30-59,10,8,2
2025-09-03,34,DPD60-89,0,0,0
2025-09-03,34,DPD90+,0,0,0
2025-09-03,36,Current,0,0,0
2025-09-03,36,DPD15-29,13,8,5
2025-09-03,36,DPD3-14,14,13,1
2025-09-03,36,DPD30-59,5,4,1
2025-09-03,36,DPD60-89,0,0,0
2025-09-03,36,DPD90+,0,0,0
2025-09-03,38,Current,3,0,3
2025-09-03,38,DPD15-29,13,12,1
2025-09-03,38,DPD3-14,22,17,5
2025-09-03,38,DPD30-59,9,8,1
2025-09-03,38,DPD60-89,0,0,0
2025-09-03,38,DPD90+,0,0,0
2025-09-03,40,Current,0,0,0
2025-09-03,40,DPD15-29,12,10,2
2025-09-03,40,DPD3-14,11,7,4
2025-09-03,40,DPD30-59,8,8,0
2025-09-03,40,DPD60-89,0,0,0
2025-09-03,40,DPD90+,0,0,0
2025-09-03,42,Current,0,0,0
2025-09-03,42,DPD15-29,1,1,0
2025-09-03,42,DPD3-14,5,2,3
2025-09-03,42,DPD30-59,3,2,1
2025-09-03,42,DPD60-89,0,0,0
2025-09-03,42,DPD90+,0,0,0
2025-09-03,44,Current,0,0,0
2025-09-03,44,DPD15-29,13,9,4
2025-09-03,44,DPD3-14,18,12,6
2025-09-03,44,DPD30-59,13,9,4
2025-09-03,44,DPD60-89,0,0,0
2025-09-03,44,DPD90+,0,0,0
2025-09-03,46,Current,0,0,0
2025-09-03,46,DPD15-29,0,0,0
2025-09-03,46,DPD60-89,0,0,0
2025-09-03,48,Current,0,0,0
2025-09-03,48,DPD15-29,24,18,6
2025-09-03,48,DPD3-14,22,12,10
2025-09-03,48,DPD30-59,17,11,6
2025-09-03,48,DPD60-89,0,0,0
2025-09-03,48,DPD90+,0,0,0
2025-09-03,54,Current,20,1,19
2025-09-03,56,Current,0,0,0
2025-09-03,56,DPD15-29,3,3,0
2025-09-03,56,DPD3-14,4,1,3
2025-09-03,56,DPD30-59,0,0,0
2025-09-03,56,DPD90+,0,0,0
2025-09-03,58,Current,32,0,32
2025-09-03,6,Current,0,0,0
2025-09-02,102,Current,0,0,0
2025-09-02,104,Current,0,0,0
2025-09-02,20,Current,0,0,0
2025-09-02,20,DPD15-29,117,89,28
2025-09-02,20,DPD3-14,49,34,15
2025-09-02,20,DPD30-59,80,65,15
2025-09-02,20,DPD60-89,0,0,0
2025-09-02,20,DPD90+,0,0,0
2025-09-02,22,Current,0,0,0
2025-09-02,24,Current,43,1,42
2025-09-02,24,DPD15-29,82,62,20
2025-09-02,24,DPD3-14,47,34,13
2025-09-02,24,DPD30-59,47,34,13
2025-09-02,24,DPD60-89,0,0,0
2025-09-02,24,DPD90+,0,0,0
2025-09-02,26,Current,0,0,0
2025-09-02,26,DPD15-29,7,6,1
2025-09-02,26,DPD3-14,2,1,1
2025-09-02,26,DPD30-59,6,4,2
2025-09-02,26,DPD60-89,0,0,0
2025-09-02,26,DPD90+,0,0,0
2025-09-02,32,Current,0,0,0
2025-09-02,32,DPD15-29,57,42,15
2025-09-02,32,DPD3-14,33,28,5
2025-09-02,32,DPD30-59,34,26,8
2025-09-02,32,DPD60-89,0,0,0
2025-09-02,32,DPD90+,0,0,0
2025-09-02,34,Current,0,0,0
2025-09-02,34,DPD15-29,13,11,2
2025-09-02,34,DPD3-14,5,5,0
2025-09-02,34,DPD30-59,13,12,1
2025-09-02,34,DPD60-89,0,0,0
2025-09-02,34,DPD90+,0,0,0
2025-09-02,36,Current,0,0,0
2025-09-02,36,DPD15-29,14,9,5
2025-09-02,36,DPD3-14,10,5,5
2025-09-02,36,DPD30-59,4,2,2
2025-09-02,36,DPD60-89,0,0,0
2025-09-02,36,DPD90+,0,0,0
2025-09-02,38,Current,7,0,7
2025-09-02,38,DPD15-29,13,9,4
2025-09-02,38,DPD3-14,6,4,2
2025-09-02,38,DPD30-59,15,14,1
2025-09-02,38,DPD60-89,0,0,0
2025-09-02,38,DPD90+,0,0,0
2025-09-02,40,Current,0,0,0
2025-09-02,40,DPD15-29,14,8,6
2025-09-02,40,DPD3-14,5,3,2
2025-09-02,40,DPD30-59,5,5,0
2025-09-02,40,DPD60-89,0,0,0
2025-09-02,40,DPD90+,0,0,0
2025-09-02,42,Current,0,0,0
2025-09-02,42,DPD15-29,7,6,1
2025-09-02,42,DPD3-14,2,2,0
2025-09-02,42,DPD30-59,2,2,0
2025-09-02,42,DPD60-89,0,0,0
2025-09-02,42,DPD90+,0,0,0
2025-09-02,44,Current,0,0,0
2025-09-02,44,DPD15-29,14,8,6
2025-09-02,44,DPD3-14,11,6,5
2025-09-02,44,DPD30-59,13,9,4
2025-09-02,44,DPD60-89,0,0,0
2025-09-02,44,DPD90+,0,0,0
2025-09-02,46,Current,0,0,0
2025-09-02,46,DPD15-29,2,1,1
2025-09-02,46,DPD30-59,0,0,0
2025-09-02,48,Current,0,0,0
2025-09-02,48,DPD15-29,25,18,7
2025-09-02,48,DPD3-14,19,12,7
2025-09-02,48,DPD30-59,9,5,4
2025-09-02,48,DPD60-89,0,0,0
2025-09-02,48,DPD90+,0,0,0
2025-09-02,54,Current,26,1,25
2025-09-02,56,Current,0,0,0
2025-09-02,56,DPD15-29,1,0,1
2025-09-02,56,DPD3-14,3,0,3
2025-09-02,56,DPD30-59,3,2,1
2025-09-02,56,DPD90+,0,0,0
2025-09-02,58,Current,36,1,35
2025-09-02,6,Current,0,0,0
2025-09-01,102,Current,0,0,0
2025-09-01,104,Current,0,0,0
2025-09-01,20,Current,0,0,0
2025-09-01,20,DPD15-29,100,73,27
2025-09-01,20,DPD3-14,126,98,28
2025-09-01,20,DPD30-59,61,45,16
2025-09-01,20,DPD60-89,0,0,0
2025-09-01,20,DPD90+,0,0,0
2025-09-01,22,Current,0,0,0
2025-09-01,24,Current,102,6,96
2025-09-01,24,DPD15-29,73,48,25
2025-09-01,24,DPD3-14,104,69,35
2025-09-01,24,DPD30-59,38,30,8
2025-09-01,24,DPD60-89,0,0,0
2025-09-01,24,DPD90+,0,0,0
2025-09-01,26,Current,0,0,0
2025-09-01,26,DPD15-29,12,7,5
2025-09-01,26,DPD3-14,8,6,2
2025-09-01,26,DPD30-59,4,3,1
2025-09-01,26,DPD60-89,0,0,0
2025-09-01,26,DPD90+,0,0,0
2025-09-01,32,Current,0,0,0
2025-09-01,32,DPD15-29,47,34,13
2025-09-01,32,DPD3-14,81,47,34
2025-09-01,32,DPD30-59,22,18,4
2025-09-01,32,DPD60-89,0,0,0
2025-09-01,32,DPD90+,0,0,0
2025-09-01,34,Current,0,0,0
2025-09-01,34,DPD15-29,17,13,4
2025-09-01,34,DPD3-14,26,21,5
2025-09-01,34,DPD30-59,12,10,2
2025-09-01,34,DPD60-89,0,0,0
2025-09-01,34,DPD90+,0,0,0
2025-09-01,36,Current,0,0,0
2025-09-01,36,DPD15-29,10,7,3
2025-09-01,36,DPD3-14,19,16,3
2025-09-01,36,DPD30-59,4,4,0
2025-09-01,36,DPD60-89,0,0,0
2025-09-01,36,DPD90+,0,0,0
2025-09-01,38,Current,12,0,12
2025-09-01,38,DPD15-29,13,10,3
2025-09-01,38,DPD3-14,27,20,7
2025-09-01,38,DPD30-59,7,6,1
2025-09-01,38,DPD60-89,0,0,0
2025-09-01,38,DPD90+,0,0,0
2025-09-01,40,Current,0,0,0
2025-09-01,40,DPD15-29,8,7,1
2025-09-01,40,DPD3-14,13,7,6
2025-09-01,40,DPD30-59,6,6,0
2025-09-01,40,DPD60-89,0,0,0
2025-09-01,40,DPD90+,0,0,0
2025-09-01,42,Current,0,0,0
2025-09-01,42,DPD15-29,1,1,0
2025-09-01,42,DPD3-14,5,3,2
2025-09-01,42,DPD30-59,3,2,1
2025-09-01,42,DPD90+,0,0,0
2025-09-01,44,Current,0,0,0
2025-09-01,44,DPD15-29,15,10,5
2025-09-01,44,DPD3-14,20,16,4
2025-09-01,44,DPD30-59,12,9,3
2025-09-01,44,DPD60-89,0,0,0
2025-09-01,44,DPD90+,0,0,0
2025-09-01,46,Current,0,0,0
2025-09-01,46,DPD15-29,0,0,0
2025-09-01,46,DPD30-59,0,0,0
2025-09-01,48,Current,25,1,24
2025-09-01,48,DPD15-29,22,17,5
2025-09-01,48,DPD3-14,30,19,11
2025-09-01,48,DPD30-59,13,10,3
2025-09-01,48,DPD60-89,0,0,0
2025-09-01,48,DPD90+,0,0,0
2025-09-01,54,Current,49,2,47
2025-09-01,56,Current,12,0,12
2025-09-01,56,DPD15-29,3,2,1
2025-09-01,56,DPD3-14,3,1,2
2025-09-01,56,DPD30-59,0,0,0
2025-09-01,56,DPD90+,0,0,0
2025-09-01,58,Current,44,2,42
2025-09-01,6,Current,0,0,0
2025-08-31,102,Current,0,0,0
2025-08-31,104,Current,0,0,0
2025-08-31,20,Current,0,0,0
2025-08-31,20,DPD15-29,116,87,29
2025-08-31,20,DPD3-14,121,88,33
2025-08-31,20,DPD30-59,73,59,14
2025-08-31,20,DPD60-89,0,0,0
2025-08-31,20,DPD90+,0,0,0
2025-08-31,22,Current,0,0,0
2025-08-31,24,Current,57,3,54
2025-08-31,24,DPD15-29,85,62,23
2025-08-31,24,DPD3-14,84,66,18
2025-08-31,24,DPD30-59,46,35,11
2025-08-31,24,DPD60-89,0,0,0
2025-08-31,24,DPD90+,0,0,0
2025-08-31,26,Current,0,0,0
2025-08-31,26,DPD15-29,6,4,2
2025-08-31,26,DPD3-14,6,5,1
2025-08-31,26,DPD30-59,8,6,2
2025-08-31,26,DPD60-89,0,0,0
2025-08-31,26,DPD90+,0,0,0
2025-08-31,32,Current,0,0,0
2025-08-31,32,DPD15-29,63,47,16
2025-08-31,32,DPD3-14,66,52,14
2025-08-31,32,DPD30-59,31,25,6
2025-08-31,32,DPD60-89,0,0,0
2025-08-31,32,DPD90+,0,0,0
2025-08-31,34,Current,0,0,0
2025-08-31,34,DPD15-29,12,9,3
2025-08-31,34,DPD3-14,15,12,3
2025-08-31,34,DPD30-59,10,9,1
2025-08-31,34,DPD60-89,0,0,0
2025-08-31,34,DPD90+,0,0,0
2025-08-31,36,Current,0,0,0
2025-08-31,36,DPD15-29,16,11,5
2025-08-31,36,DPD3-14,19,11,8
2025-08-31,36,DPD30-59,6,2,4
2025-08-31,36,DPD60-89,0,0,0
2025-08-31,36,DPD90+,0,0,0
2025-08-31,38,Current,4,0,4
2025-08-31,38,DPD15-29,17,13,4
2025-08-31,38,DPD3-14,18,9,9
2025-08-31,38,DPD30-59,14,13,1
2025-08-31,38,DPD60-89,0,0,0
2025-08-31,38,DPD90+,0,0,0
2025-08-31,40,Current,0,0,0
2025-08-31,40,DPD15-29,15,10,5
2025-08-31,40,DPD3-14,15,11,4
2025-08-31,40,DPD30-59,4,4,0
2025-08-31,40,DPD60-89,0,0,0
2025-08-31,40,DPD90+,0,0,0
2025-08-31,42,Current,0,0,0
2025-08-31,42,DPD15-29,12,11,1
2025-08-31,42,DPD3-14,5,4,1
2025-08-31,42,DPD30-59,1,1,0
2025-08-31,42,DPD60-89,0,0,0
2025-08-31,42,DPD90+,0,0,0
2025-08-31,44,Current,0,0,0
2025-08-31,44,DPD15-29,13,9,4
2025-08-31,44,DPD3-14,17,9,8
2025-08-31,44,DPD30-59,12,9,3
2025-08-31,44,DPD60-89,0,0,0
2025-08-31,44,DPD90+,0,0,0
2025-08-31,46,Current,0,0,0
2025-08-31,46,DPD15-29,2,1,1
2025-08-31,46,DPD30-59,0,0,0
2025-08-31,48,Current,30,1,29
2025-08-31,48,DPD15-29,22,14,8
2025-08-31,48,DPD3-14,39,28,11
2025-08-31,48,DPD30-59,11,7,4
2025-08-31,48,DPD60-89,0,0,0
2025-08-31,48,DPD90+,0,0,0
2025-08-31,54,Current,7,0,7
2025-08-31,56,Current,13,0,13
2025-08-31,56,DPD15-29,1,0,1
2025-08-31,56,DPD3-14,2,0,2
2025-08-31,56,DPD30-59,3,2,1
2025-08-31,56,DPD90+,0,0,0
2025-08-31,58,Current,3,0,3
2025-08-31,6,DPD3-14,1,0,1
2025-08-30,102,Current,0,0,0
2025-08-30,104,Current,0,0,0
2025-08-30,20,Current,0,0,0
2025-08-30,20,DPD15-29,80,58,22
2025-08-30,20,DPD3-14,67,53,14
2025-08-30,20,DPD30-59,62,49,13
2025-08-30,20,DPD60-89,0,0,0
2025-08-30,20,DPD90+,0,0,0
2025-08-30,22,Current,0,0,0
2025-08-30,24,Current,36,5,31
2025-08-30,24,DPD15-29,62,40,22
2025-08-30,24,DPD3-14,42,27,15
2025-08-30,24,DPD30-59,39,30,9
2025-08-30,24,DPD60-89,0,0,0
2025-08-30,24,DPD90+,0,0,0
2025-08-30,26,Current,0,0,0
2025-08-30,26,DPD15-29,8,6,2
2025-08-30,26,DPD3-14,7,5,2
2025-08-30,26,DPD30-59,4,3,1
2025-08-30,26,DPD60-89,0,0,0
2025-08-30,26,DPD90+,0,0,0
2025-08-30,32,Current,0,0,0
2025-08-30,32,DPD15-29,36,25,11
2025-08-30,32,DPD3-14,36,20,16
2025-08-30,32,DPD30-59,19,14,5
2025-08-30,32,DPD60-89,0,0,0
2025-08-30,32,DPD90+,0,0,0
2025-08-30,34,Current,0,0,0
2025-08-30,34,DPD15-29,16,11,5
2025-08-30,34,DPD3-14,19,16,3
2025-08-30,34,DPD30-59,12,10,2
2025-08-30,34,DPD60-89,0,0,0
2025-08-30,34,DPD90+,0,0,0
2025-08-30,36,Current,0,0,0
2025-08-30,36,DPD15-29,6,5,1
2025-08-30,36,DPD3-14,6,4,2
2025-08-30,36,DPD30-59,2,2,0
2025-08-30,36,DPD60-89,0,0,0
2025-08-30,36,DPD90+,0,0,0
2025-08-30,38,Current,0,0,0
2025-08-30,38,DPD15-29,11,9,2
2025-08-30,38,DPD3-14,13,7,6
2025-08-30,38,DPD30-59,7,6,1
2025-08-30,38,DPD60-89,0,0,0
2025-08-30,38,DPD90+,0,0,0
2025-08-30,40,Current,0,0,0
2025-08-30,40,DPD15-29,7,6,1
2025-08-30,40,DPD3-14,4,4,0
2025-08-30,40,DPD30-59,5,4,1
2025-08-30,40,DPD60-89,0,0,0
2025-08-30,40,DPD90+,0,0,0
2025-08-30,42,Current,0,0,0
2025-08-30,42,DPD15-29,1,1,0
2025-08-30,42,DPD3-14,4,3,1
2025-08-30,42,DPD30-59,3,2,1
2025-08-30,42,DPD60-89,0,0,0
2025-08-30,42,DPD90+,0,0,0
2025-08-30,44,Current,0,0,0
2025-08-30,44,DPD15-29,10,6,4
2025-08-30,44,DPD3-14,14,10,4
2025-08-30,44,DPD30-59,10,7,3
2025-08-30,44,DPD60-89,0,0,0
2025-08-30,44,DPD90+,0,0,0
2025-08-30,46,Current,0,0,0
2025-08-30,46,DPD15-29,0,0,0
2025-08-30,46,DPD30-59,0,0,0
2025-08-30,48,Current,23,0,23
2025-08-30,48,DPD15-29,17,14,3
2025-08-30,48,DPD3-14,16,11,5
2025-08-30,48,DPD30-59,12,10,2
2025-08-30,48,DPD60-89,0,0,0
2025-08-30,48,DPD90+,0,0,0
2025-08-30,54,Current,5,0,5
2025-08-30,56,Current,11,1,10
2025-08-30,56,DPD15-29,3,2,1
2025-08-30,56,DPD3-14,1,0,1
2025-08-30,56,DPD30-59,0,0,0
2025-08-30,56,DPD90+,0,0,0
2025-08-30,58,Current,0,0,0
2025-08-30,6,DPD3-14,0,0,0
2025-08-29,102,Current,0,0,0
2025-08-29,104,Current,0,0,0
2025-08-29,20,Current,0,0,0
2025-08-29,20,DPD15-29,79,60,19
2025-08-29,20,DPD3-14,96,72,24
2025-08-29,20,DPD30-59,81,66,15
2025-08-29,20,DPD60-89,0,0,0
2025-08-29,20,DPD90+,0,0,0
2025-08-29,22,Current,0,0,0
2025-08-29,24,Current,58,4,54
2025-08-29,24,DPD15-29,54,35,19
2025-08-29,24,DPD3-14,67,46,21
2025-08-29,24,DPD30-59,43,32,11
2025-08-29,24,DPD60-89,0,0,0
2025-08-29,24,DPD90+,0,0,0
2025-08-29,26,Current,0,0,0
2025-08-29,26,DPD15-29,4,2,2
2025-08-29,26,DPD3-14,7,6,1
2025-08-29,26,DPD30-59,7,5,2
2025-08-29,26,DPD60-89,0,0,0
2025-08-29,26,DPD90+,0,0,0
2025-08-29,32,Current,0,0,0
2025-08-29,32,DPD15-29,40,28,12
2025-08-29,32,DPD3-14,65,43,22
2025-08-29,32,DPD30-59,28,19,9
2025-08-29,32,DPD60-89,0,0,0
2025-08-29,32,DPD90+,0,0,0
2025-08-29,34,Current,0,0,0
2025-08-29,34,DPD15-29,10,6,4
2025-08-29,34,DPD3-14,14,11,3
2025-08-29,34,DPD30-59,13,10,3
2025-08-29,34,DPD60-89,0,0,0
2025-08-29,34,DPD90+,0,0,0
2025-08-29,36,Current,0,0,0
2025-08-29,36,DPD15-29,9,6,3
2025-08-29,36,DPD3-14,9,5,4
2025-08-29,36,DPD30-59,6,3,3
2025-08-29,36,DPD60-89,0,0,0
2025-08-29,36,DPD90+,0,0,0
2025-08-29,38,Current,4,0,4
2025-08-29,38,DPD15-29,13,10,3
2025-08-29,38,DPD3-14,20,10,10
2025-08-29,38,DPD30-59,14,11,3
2025-08-29,38,DPD60-89,0,0,0
2025-08-29,38,DPD90+,0,0,0
2025-08-29,40,Current,0,0,0
2025-08-29,40,DPD15-29,7,5,2
2025-08-29,40,DPD3-14,11,8,3
2025-08-29,40,DPD30-59,5,5,0
2025-08-29,40,DPD60-89,0,0,0
2025-08-29,40,DPD90+,0,0,0
2025-08-29,42,Current,0,0,0
2025-08-29,42,DPD15-29,8,7,1
2025-08-29,42,DPD3-14,5,3,2
2025-08-29,42,DPD30-59,2,1,1
2025-08-29,42,DPD60-89,0,0,0
2025-08-29,42,DPD90+,0,0,0
2025-08-29,44,Current,0,0,0
2025-08-29,44,DPD15-29,9,4,5
2025-08-29,44,DPD3-14,19,11,8
2025-08-29,44,DPD30-59,15,10,5
2025-08-29,44,DPD60-89,0,0,0
2025-08-29,44,DPD90+,0,0,0
2025-08-29,46,Current,0,0,0
2025-08-29,46,DPD3-14,0,0,0
2025-08-29,46,DPD30-59,0,0,0
2025-08-29,48,Current,26,1,25
2025-08-29,48,DPD15-29,18,12,6
2025-08-29,48,DPD3-14,29,18,11
2025-08-29,48,DPD30-59,11,6,5
2025-08-29,48,DPD60-89,0,0,0
2025-08-29,48,DPD90+,0,0,0
2025-08-29,54,Current,16,2,14
2025-08-29,56,Current,17,2,15
2025-08-29,56,DPD15-29,0,0,0
2025-08-29,56,DPD3-14,5,2,3
2025-08-29,56,DPD30-59,2,1,1
2025-08-29,56,DPD90+,0,0,0
2025-08-29,58,Current,11,1,10
2025-08-29,6,Current,0,0,0
2025-08-28,102,Current,0,0,0
2025-08-28,104,Current,0,0,0
2025-08-28,20,Current,1,1,0
2025-08-28,20,DPD15-29,75,57,18
2025-08-28,20,DPD3-14,78,56,22
2025-08-28,20,DPD30-59,45,35,10
2025-08-28,20,DPD60-89,0,0,0
2025-08-28,20,DPD90+,0,0,0
2025-08-28,22,Current,0,0,0
2025-08-28,24,Current,84,9,75
2025-08-28,24,DPD15-29,65,43,22
2025-08-28,24,DPD3-14,63,45,18
2025-08-28,24,DPD30-59,29,22,7
2025-08-28,24,DPD60-89,0,0,0
2025-08-28,24,DPD90+,0,0,0
2025-08-28,26,Current,1,1,0
2025-08-28,26,DPD15-29,7,4,3
2025-08-28,26,DPD3-14,7,7,0
2025-08-28,26,DPD30-59,3,2,1
2025-08-28,26,DPD60-89,0,0,0
2025-08-28,26,DPD90+,0,0,0
2025-08-28,32,Current,1,0,1
2025-08-28,32,DPD15-29,33,22,11
2025-08-28,32,DPD3-14,43,30,13
2025-08-28,32,DPD30-59,16,12,4
2025-08-28,32,DPD60-89,0,0,0
2025-08-28,32,DPD90+,0,0,0
2025-08-28,34,Current,1,1,0
2025-08-28,34,DPD15-29,14,9,5
2025-08-28,34,DPD3-14,8,7,1
2025-08-28,34,DPD30-59,10,8,2
2025-08-28,34,DPD60-89,0,0,0
2025-08-28,34,DPD90+,0,0,0
2025-08-28,36,Current,0,0,0
2025-08-28,36,DPD15-29,10,8,2
2025-08-28,36,DPD3-14,7,2,5
2025-08-28,36,DPD30-59,2,2,0
2025-08-28,36,DPD60-89,0,0,0
2025-08-28,36,DPD90+,0,0,0
2025-08-28,38,Current,8,1,7
2025-08-28,38,DPD15-29,13,10,3
2025-08-28,38,DPD3-14,10,7,3
2025-08-28,38,DPD30-59,5,4,1
2025-08-28,38,DPD60-89,0,0,0
2025-08-28,38,DPD90+,0,0,0
2025-08-28,40,Current,0,0,0
2025-08-28,40,DPD15-29,7,6,1
2025-08-28,40,DPD3-14,4,2,2
2025-08-28,40,DPD30-59,5,4,1
2025-08-28,40,DPD60-89,0,0,0
2025-08-28,40,DPD90+,0,0,0
2025-08-28,42,Current,0,0,0
2025-08-28,42,DPD15-29,1,1,0
2025-08-28,42,DPD3-14,6,3,3
2025-08-28,42,DPD30-59,2,1,1
2025-08-28,42,DPD60-89,0,0,0
2025-08-28,42,DPD90+,0,0,0
2025-08-28,44,Current,1,0,1
2025-08-28,44,DPD15-29,7,4,3
2025-08-28,44,DPD3-14,13,9,4
2025-08-28,44,DPD30-59,11,8,3
2025-08-28,44,DPD60-89,0,0,0
2025-08-28,44,DPD90+,0,0,0
2025-08-28,46,Current,0,0,0
2025-08-28,46,DPD3-14,0,0,0
2025-08-28,46,DPD30-59,0,0,0
2025-08-28,48,Current,57,6,51
2025-08-28,48,DPD15-29,21,15,6
2025-08-28,48,DPD3-14,20,14,6
2025-08-28,48,DPD30-59,9,8,1
2025-08-28,48,DPD60-89,0,0,0
2025-08-28,48,DPD90+,0,0,0
2025-08-28,54,Current,11,0,11
2025-08-28,56,Current,25,1,24
2025-08-28,56,DPD15-29,2,1,1
2025-08-28,56,DPD3-14,2,0,2
2025-08-28,56,DPD30-59,0,0,0
2025-08-28,56,DPD90+,0,0,0
2025-08-28,58,Current,0,0,0
2025-08-28,6,Current,0,0,0
2025-08-27,102,Current,0,0,0
2025-08-27,104,Current,0,0,0
2025-08-27,20,Current,0,0,0
2025-08-27,20,DPD15-29,102,80,22
2025-08-27,20,DPD3-14,95,75,20
2025-08-27,20,DPD30-59,79,63,16
2025-08-27,20,DPD60-89,0,0,0
2025-08-27,20,DPD90+,0,0,0
2025-08-27,22,Current,0,0,0
2025-08-27,24,Current,48,4,44
2025-08-27,24,DPD15-29,70,48,22
2025-08-27,24,DPD3-14,68,46,22
2025-08-27,24,DPD30-59,38,28,10
2025-08-27,24,DPD60-89,0,0,0
2025-08-27,24,DPD90+,0,0,0
2025-08-27,26,Current,0,0,0
2025-08-27,26,DPD15-29,7,5,2
2025-08-27,26,DPD3-14,4,2,2
2025-08-27,26,DPD30-59,5,5,0
2025-08-27,26,DPD60-89,0,0,0
2025-08-27,26,DPD90+,0,0,0
2025-08-27,32,Current,0,0,0
2025-08-27,32,DPD15-29,59,42,17
2025-08-27,32,DPD3-14,64,43,21
2025-08-27,32,DPD30-59,24,15,9
2025-08-27,32,DPD60-89,0,0,0
2025-08-27,32,DPD90+,0,0,0
2025-08-27,34,Current,0,0,0
2025-08-27,34,DPD15-29,14,10,4
2025-08-27,34,DPD3-14,19,16,3
2025-08-27,34,DPD30-59,15,12,3
2025-08-27,34,DPD60-89,0,0,0
2025-08-27,34,DPD90+,0,0,0
2025-08-27,36,Current,0,0,0
2025-08-27,36,DPD15-29,7,5,2
2025-08-27,36,DPD3-14,10,7,3
2025-08-27,36,DPD30-59,8,4,4
2025-08-27,36,DPD60-89,0,0,0
2025-08-27,36,DPD90+,0,0,0
2025-08-27,38,Current,2,0,2
2025-08-27,38,DPD15-29,20,15,5
2025-08-27,38,DPD3-14,23,15,8
2025-08-27,38,DPD30-59,12,9,3
2025-08-27,38,DPD60-89,0,0,0
2025-08-27,38,DPD90+,0,0,0
2025-08-27,40,Current,0,0,0
2025-08-27,40,DPD15-29,11,8,3
2025-08-27,40,DPD3-14,4,3,1
2025-08-27,40,DPD30-59,5,5,0
2025-08-27,40,DPD60-89,0,0,0
2025-08-27,40,DPD90+,0,0,0
2025-08-27,42,Current,0,0,0
2025-08-27,42,DPD15-29,8,6,2
2025-08-27,42,DPD3-14,3,2,1
2025-08-27,42,DPD30-59,3,2,1
2025-08-27,42,DPD60-89,0,0,0
2025-08-27,42,DPD90+,0,0,0
2025-08-27,44,Current,0,0,0
2025-08-27,44,DPD15-29,11,7,4
2025-08-27,44,DPD3-14,20,15,5
2025-08-27,44,DPD30-59,16,12,4
2025-08-27,44,DPD60-89,0,0,0
2025-08-27,44,DPD90+,0,0,0
2025-08-27,46,Current,0,0,0
2025-08-27,46,DPD3-14,0,0,0
2025-08-27,46,DPD30-59,0,0,0
2025-08-27,48,Current,33,3,30
2025-08-27,48,DPD15-29,19,12,7
2025-08-27,48,DPD3-14,25,19,6
2025-08-27,48,DPD30-59,12,6,6
2025-08-27,48,DPD60-89,0,0,0
2025-08-27,48,DPD90+,0,0,0
2025-08-27,54,Current,36,0,36
2025-08-27,56,Current,0,0,0
2025-08-27,56,DPD15-29,0,0,0
2025-08-27,56,DPD3-14,3,2,1
2025-08-27,56,DPD30-59,2,1,1
2025-08-27,56,DPD90+,0,0,0
2025-08-27,58,Current,0,0,0
2025-08-27,6,Current,0,0,0
2025-08-26,102,Current,0,0,0
2025-08-26,104,Current,0,0,0
2025-08-26,20,Current,0,0,0
2025-08-26,20,DPD15-29,75,56,19
2025-08-26,20,DPD3-14,146,108,38
2025-08-26,20,DPD30-59,53,40,13
2025-08-26,20,DPD60-89,0,0,0
2025-08-26,20,DPD90+,0,0,0
2025-08-26,22,Current,0,0,0
2025-08-26,24,Current,70,0,70
2025-08-26,24,DPD15-29,68,44,24
2025-08-26,24,DPD3-14,115,95,20
2025-08-26,24,DPD30-59,39,30,9
2025-08-26,24,DPD60-89,0,0,0
2025-08-26,24,DPD90+,0,0,0
2025-08-26,26,Current,0,0,0
2025-08-26,26,DPD15-29,6,4,2
2025-08-26,26,DPD3-14,9,8,1
2025-08-26,26,DPD30-59,3,2,1
2025-08-26,26,DPD60-89,0,0,0
2025-08-26,26,DPD90+,0,0,0
2025-08-26,32,Current,0,0,0
2025-08-26,32,DPD15-29,37,28,9
2025-08-26,32,DPD3-14,84,68,16
2025-08-26,32,DPD30-59,20,15,5
2025-08-26,32,DPD60-89,0,0,0
2025-08-26,32,DPD90+,0,0,0
2025-08-26,34,Current,0,0,0
2025-08-26,34,DPD15-29,16,10,6
2025-08-26,34,DPD3-14,13,12,1
2025-08-26,34,DPD30-59,12,10,2
2025-08-26,34,DPD60-89,0,0,0
2025-08-26,34,DPD90+,0,0,0
2025-08-26,36,Current,0,0,0
2025-08-26,36,DPD15-29,11,8,3
2025-08-26,36,DPD3-14,18,11,7
2025-08-26,36,DPD30-59,2,1,1
2025-08-26,36,DPD60-89,0,0,0
2025-08-26,36,DPD90+,0,0,0
2025-08-26,38,Current,4,0,4
2025-08-26,38,DPD15-29,14,12,2
2025-08-26,38,DPD3-14,19,11,8
2025-08-26,38,DPD30-59,5,4,1
2025-08-26,38,DPD60-89,0,0,0
2025-08-26,38,DPD90+,0,0,0
2025-08-26,40,Current,0,0,0
2025-08-26,40,DPD15-29,5,5,0
2025-08-26,40,DPD3-14,19,14,5
2025-08-26,40,DPD30-59,5,4,1
2025-08-26,40,DPD60-89,0,0,0
2025-08-26,40,DPD90+,0,0,0
2025-08-26,42,Current,0,0,0
2025-08-26,42,DPD15-29,2,1,1
2025-08-26,42,DPD3-14,10,9,1
2025-08-26,42,DPD30-59,4,2,2
2025-08-26,42,DPD60-89,0,0,0
2025-08-26,42,DPD90+,0,0,0
2025-08-26,44,Current,0,0,0
2025-08-26,44,DPD15-29,8,5,3
2025-08-26,44,DPD3-14,17,11,6
2025-08-26,44,DPD30-59,9,5,4
2025-08-26,44,DPD60-89,0,0,0
2025-08-26,44,DPD90+,0,0,0
2025-08-26,46,Current,0,0,0
2025-08-26,46,DPD3-14,2,1,1
2025-08-26,46,DPD30-59,0,0,0
2025-08-26,48,Current,31,0,31
2025-08-26,48,DPD15-29,16,11,5
2025-08-26,48,DPD3-14,38,26,12
2025-08-26,48,DPD30-59,14,9,5
2025-08-26,48,DPD60-89,0,0,0
2025-08-26,48,DPD90+,0,0,0
2025-08-26,54,Current,22,0,22
2025-08-26,56,Current,0,0,0
2025-08-26,56,DPD15-29,2,1,1
2025-08-26,56,DPD3-14,2,1,1
2025-08-26,56,DPD30-59,0,0,0
2025-08-26,56,DPD90+,0,0,0
2025-08-26,58,Current,0,0,0
2025-08-26,6,Current,0,0,0
2025-08-25,102,Current,0,0,0
2025-08-25,104,Current,0,0,0
2025-08-25,20,Current,0,0,0
2025-08-25,20,DPD15-29,107,86,21
2025-08-25,20,DPD3-14,76,53,23
2025-08-25,20,DPD30-59,71,53,18
2025-08-25,20,DPD60-89,0,0,0
2025-08-25,20,DPD90+,0,0,0
2025-08-25,22,Current,0,0,0
2025-08-25,24,Current,117,10,107
2025-08-25,24,DPD15-29,76,52,24
2025-08-25,24,DPD3-14,69,48,21
2025-08-25,24,DPD30-59,42,34,8
2025-08-25,24,DPD60-89,0,0,0
2025-08-25,24,DPD90+,0,0,0
2025-08-25,26,Current,0,0,0
2025-08-25,26,DPD15-29,9,6,3
2025-08-25,26,DPD3-14,5,4,1
2025-08-25,26,DPD30-59,5,5,0
2025-08-25,26,DPD60-89,0,0,0
2025-08-25,26,DPD90+,0,0,0
2025-08-25,32,Current,0,0,0
2025-08-25,32,DPD15-29,68,49,19
2025-08-25,32,DPD3-14,45,35,10
2025-08-25,32,DPD30-59,23,14,9
2025-08-25,32,DPD60-89,0,0,0
2025-08-25,32,DPD90+,0,0,0
2025-08-25,34,Current,0,0,0
2025-08-25,34,DPD15-29,13,11,2
2025-08-25,34,DPD3-14,15,14,1
2025-08-25,34,DPD30-59,18,14,4
2025-08-25,34,DPD60-89,0,0,0
2025-08-25,34,DPD90+,0,0,0
2025-08-25,36,Current,0,0,0
2025-08-25,36,DPD15-29,7,6,1
2025-08-25,36,DPD3-14,6,5,1
2025-08-25,36,DPD30-59,10,5,5
2025-08-25,36,DPD60-89,0,0,0
2025-08-25,36,DPD90+,0,0,0
2025-08-25,38,Current,9,0,9
2025-08-25,38,DPD15-29,21,15,6
2025-08-25,38,DPD3-14,15,14,1
2025-08-25,38,DPD30-59,13,9,4
2025-08-25,38,DPD60-89,0,0,0
2025-08-25,38,DPD90+,0,0,0
2025-08-25,40,Current,0,0,0
2025-08-25,40,DPD15-29,12,9,3
2025-08-25,40,DPD3-14,3,1,2
2025-08-25,40,DPD30-59,4,4,0
2025-08-25,40,DPD60-89,0,0,0
2025-08-25,40,DPD90+,0,0,0
2025-08-25,42,Current,0,0,0
2025-08-25,42,DPD15-29,8,6,2
2025-08-25,42,DPD3-14,1,1,0
2025-08-25,42,DPD30-59,4,3,1
2025-08-25,42,DPD60-89,0,0,0
2025-08-25,42,DPD90+,0,0,0
2025-08-25,44,Current,0,0,0
2025-08-25,44,DPD15-29,13,10,3
2025-08-25,44,DPD3-14,16,13,3
2025-08-25,44,DPD30-59,17,13,4
2025-08-25,44,DPD60-89,0,0,0
2025-08-25,44,DPD90+,0,0,0
2025-08-25,46,Current,0,0,0
2025-08-25,46,DPD3-14,0,0,0
2025-08-25,46,DPD30-59,0,0,0
2025-08-25,48,Current,69,0,69
2025-08-25,48,DPD15-29,18,12,6
2025-08-25,48,DPD3-14,22,14,8
2025-08-25,48,DPD30-59,14,7,7
2025-08-25,48,DPD60-89,0,0,0
2025-08-25,48,DPD90+,0,0,0
2025-08-25,54,Current,39,2,37
2025-08-25,56,Current,2,1,1
2025-08-25,56,DPD15-29,0,0,0
2025-08-25,56,DPD3-14,5,4,1
2025-08-25,56,DPD30-59,2,1,1
2025-08-25,56,DPD90+,0,0,0
2025-08-25,6,Current,0,0,0
2025-08-24,102,Current,0,0,0
2025-08-24,104,Current,0,0,0
2025-08-24,20,Current,0,0,0
2025-08-24,20,DPD15-29,69,56,13
2025-08-24,20,DPD3-14,112,81,31
2025-08-24,20,DPD30-59,52,41,11
2025-08-24,20,DPD60-89,0,0,0
2025-08-24,20,DPD90+,0,0,0
2025-08-24,22,Current,0,0,0
2025-08-24,24,Current,40,2,38
2025-08-24,24,DPD15-29,63,41,22
2025-08-24,24,DPD3-14,86,68,18
2025-08-24,24,DPD30-59,38,28,10
2025-08-24,24,DPD60-89,0,0,0
2025-08-24,24,DPD90+,0,0,0
2025-08-24,26,Current,0,0,0
2025-08-24,26,DPD15-29,6,3,3
2025-08-24,26,DPD3-14,9,8,1
2025-08-24,26,DPD30-59,4,3,1
2025-08-24,26,DPD60-89,0,0,0
2025-08-24,26,DPD90+,0,0,0
2025-08-24,32,Current,0,0,0
2025-08-24,32,DPD15-29,41,27,14
2025-08-24,32,DPD3-14,51,41,10
2025-08-24,32,DPD30-59,16,12,4
2025-08-24,32,DPD60-89,0,0,0
2025-08-24,32,DPD90+,0,0,0
2025-08-24,34,Current,0,0,0
2025-08-24,34,DPD15-29,16,11,5
2025-08-24,34,DPD3-14,12,10,2
2025-08-24,34,DPD30-59,15,12,3
2025-08-24,34,DPD60-89,0,0,0
2025-08-24,34,DPD90+,0,0,0
2025-08-24,36,Current,0,0,0
2025-08-24,36,DPD15-29,15,9,6
2025-08-24,36,DPD3-14,17,10,7
2025-08-24,36,DPD30-59,1,0,1
2025-08-24,36,DPD60-89,0,0,0
2025-08-24,36,DPD90+,0,0,0
2025-08-24,38,Current,4,0,4
2025-08-24,38,DPD15-29,13,11,2
2025-08-24,38,DPD3-14,13,7,6
2025-08-24,38,DPD30-59,6,4,2
2025-08-24,38,DPD60-89,0,0,0
2025-08-24,38,DPD90+,0,0,0
2025-08-24,40,Current,0,0,0
2025-08-24,40,DPD15-29,4,4,0
2025-08-24,40,DPD3-14,14,11,3
2025-08-24,40,DPD30-59,4,3,1
2025-08-24,40,DPD60-89,0,0,0
2025-08-24,40,DPD90+,0,0,0
2025-08-24,42,Current,0,0,0
2025-08-24,42,DPD15-29,1,1,0
2025-08-24,42,DPD3-14,7,5,2
2025-08-24,42,DPD30-59,4,2,2
2025-08-24,42,DPD60-89,0,0,0
2025-08-24,42,DPD90+,0,0,0
2025-08-24,44,Current,0,0,0
2025-08-24,44,DPD15-29,6,4,2
2025-08-24,44,DPD3-14,15,9,6
2025-08-24,44,DPD30-59,8,5,3
2025-08-24,44,DPD60-89,0,0,0
2025-08-24,44,DPD90+,0,0,0
2025-08-24,46,Current,0,0,0
2025-08-24,46,DPD3-14,0,0,0
2025-08-24,46,DPD30-59,0,0,0
2025-08-24,48,Current,30,0,30
2025-08-24,48,DPD15-29,16,11,5
2025-08-24,48,DPD3-14,32,22,10
2025-08-24,48,DPD30-59,14,9,5
2025-08-24,48,DPD60-89,0,0,0
2025-08-24,48,DPD90+,0,0,0
2025-08-24,54,Current,12,1,11
2025-08-24,56,Current,0,0,0
2025-08-24,56,DPD15-29,2,1,1
2025-08-24,56,DPD3-14,3,2,1
2025-08-24,56,DPD30-59,0,0,0
2025-08-24,56,DPD90+,0,0,0
2025-08-24,6,Current,0,0,0
2025-08-23,102,Current,0,0,0
2025-08-23,104,Current,0,0,0
2025-08-23,20,Current,0,0,0
2025-08-23,20,DPD15-29,111,91,20
2025-08-23,20,DPD3-14,85,61,24
2025-08-23,20,DPD30-59,58,41,17
2025-08-23,20,DPD60-89,0,0,0
2025-08-23,20,DPD90+,0,0,0
2025-08-23,22,Current,0,0,0
2025-08-23,24,Current,48,2,46
2025-08-23,24,DPD15-29,73,51,22
2025-08-23,24,DPD3-14,62,46,16
2025-08-23,24,DPD30-59,37,31,6
2025-08-23,24,DPD60-89,0,0,0
2025-08-23,24,DPD90+,0,0,0
2025-08-23,26,Current,0,0,0
2025-08-23,26,DPD15-29,10,7,3
2025-08-23,26,DPD3-14,8,5,3
2025-08-23,26,DPD30-59,3,3,0
2025-08-23,26,DPD60-89,0,0,0
2025-08-23,26,DPD90+,0,0,0
2025-08-23,32,Current,0,0,0
2025-08-23,32,DPD15-29,71,51,20
2025-08-23,32,DPD3-14,37,25,12
2025-08-23,32,DPD30-59,23,15,8
2025-08-23,32,DPD60-89,0,0,0
2025-08-23,32,DPD90+,0,0,0
2025-08-23,34,Current,0,0,0
2025-08-23,34,DPD15-29,13,11,2
2025-08-23,34,DPD3-14,15,14,1
2025-08-23,34,DPD30-59,15,10,5
2025-08-23,34,DPD60-89,0,0,0
2025-08-23,34,DPD90+,0,0,0
2025-08-23,36,Current,0,0,0
2025-08-23,36,DPD15-29,7,6,1
2025-08-23,36,DPD3-14,5,4,1
2025-08-23,36,DPD30-59,8,4,4
2025-08-23,36,DPD60-89,0,0,0
2025-08-23,36,DPD90+,0,0,0
2025-08-23,38,Current,6,0,6
2025-08-23,38,DPD15-29,25,18,7
2025-08-23,38,DPD3-14,9,6,3
2025-08-23,38,DPD30-59,11,7,4
2025-08-23,38,DPD60-89,0,0,0
2025-08-23,38,DPD90+,0,0,0
2025-08-23,40,Current,0,0,0
2025-08-23,40,DPD15-29,12,9,3
2025-08-23,40,DPD3-14,4,2,2
2025-08-23,40,DPD30-59,3,3,0
2025-08-23,40,DPD60-89,0,0,0
2025-08-23,40,DPD90+,0,0,0
2025-08-23,42,Current,0,0,0
2025-08-23,42,DPD15-29,7,6,1
2025-08-23,42,DPD3-14,2,2,0
2025-08-23,42,DPD30-59,2,1,1
2025-08-23,42,DPD60-89,0,0,0
2025-08-23,42,DPD90+,0,0,0
2025-08-23,44,Current,0,0,0
2025-08-23,44,DPD15-29,16,13,3
2025-08-23,44,DPD3-14,12,9,3
2025-08-23,44,DPD30-59,12,9,3
2025-08-23,44,DPD60-89,0,0,0
2025-08-23,44,DPD90+,0,0,0
2025-08-23,46,Current,0,0,0
2025-08-23,46,DPD3-14,0,0,0
2025-08-23,46,DPD30-59,0,0,0
2025-08-23,48,Current,35,0,35
2025-08-23,48,DPD15-29,19,12,7
2025-08-23,48,DPD3-14,24,19,5
2025-08-23,48,DPD30-59,13,6,7
2025-08-23,48,DPD60-89,0,0,0
2025-08-23,48,DPD90+,0,0,0
2025-08-23,54,Current,16,0,16
2025-08-23,56,Current,0,0,0
2025-08-23,56,DPD15-29,0,0,0
2025-08-23,56,DPD3-14,1,0,1
2025-08-23,56,DPD30-59,1,0,1
2025-08-23,56,DPD90+,0,0,0
2025-08-23,6,Current,0,0,0
2025-08-22,102,Current,0,0,0
2025-08-22,104,Current,0,0,0
2025-08-22,20,Current,0,0,0
2025-08-22,20,DPD15-29,66,56,10
2025-08-22,20,DPD3-14,88,62,26
2025-08-22,20,DPD30-59,58,46,12
2025-08-22,20,DPD60-89,0,0,0
2025-08-22,20,DPD90+,0,0,0
2025-08-22,22,Current,0,0,0
2025-08-22,24,Current,39,3,36
2025-08-22,24,DPD15-29,55,35,20
2025-08-22,24,DPD3-14,66,48,18
2025-08-22,24,DPD30-59,42,30,12
2025-08-22,24,DPD60-89,0,0,0
2025-08-22,24,DPD90+,0,0,0
2025-08-22,26,Current,0,0,0
2025-08-22,26,DPD15-29,5,2,3
2025-08-22,26,DPD3-14,7,4,3
2025-08-22,26,DPD30-59,5,3,2
2025-08-22,26,DPD60-89,0,0,0
2025-08-22,26,DPD90+,0,0,0
2025-08-22,32,Current,0,0,0
2025-08-22,32,DPD15-29,44,30,14
2025-08-22,32,DPD3-14,41,30,11
2025-08-22,32,DPD30-59,22,18,4
2025-08-22,32,DPD60-89,0,0,0
2025-08-22,32,DPD90+,0,0,0
2025-08-22,34,Current,0,0,0
2025-08-22,34,DPD15-29,19,14,5
2025-08-22,34,DPD3-14,15,12,3
2025-08-22,34,DPD30-59,15,13,2
2025-08-22,34,DPD60-89,0,0,0
2025-08-22,34,DPD90+,0,0,0
2025-08-22,36,Current,0,0,0
2025-08-22,36,DPD15-29,14,9,5
2025-08-22,36,DPD3-14,12,7,5
2025-08-22,36,DPD30-59,1,0,1
2025-08-22,36,DPD60-89,0,0,0
2025-08-22,36,DPD90+,0,0,0
2025-08-22,38,Current,4,0,4
2025-08-22,38,DPD15-29,10,8,2
2025-08-22,38,DPD3-14,14,9,5
2025-08-22,38,DPD30-59,7,5,2
2025-08-22,38,DPD60-89,0,0,0
2025-08-22,38,DPD90+,0,0,0
2025-08-22,40,Current,0,0,0
2025-08-22,40,DPD15-29,7,7,0
2025-08-22,40,DPD3-14,9,7,2
2025-08-22,40,DPD30-59,4,3,1
2025-08-22,40,DPD60-89,0,0,0
2025-08-22,40,DPD90+,0,0,0
2025-08-22,42,Current,0,0,0
2025-08-22,42,DPD15-29,2,1,1
2025-08-22,42,DPD3-14,2,1,1
2025-08-22,42,DPD30-59,4,2,2
2025-08-22,42,DPD60-89,0,0,0
2025-08-22,42,DPD90+,0,0,0
2025-08-22,44,Current,1,1,0
2025-08-22,44,DPD15-29,8,5,3
2025-08-22,44,DPD3-14,22,18,4
2025-08-22,44,DPD30-59,8,5,3
2025-08-22,44,DPD60-89,0,0,0
2025-08-22,44,DPD90+,0,0,0
2025-08-22,46,Current,0,0,0
2025-08-22,46,DPD15-29,0,0,0
2025-08-22,46,DPD3-14,0,0,0
2025-08-22,46,DPD30-59,0,0,0
2025-08-22,48,Current,35,1,34
2025-08-22,48,DPD15-29,14,9,5
2025-08-22,48,DPD3-14,27,18,9
2025-08-22,48,DPD30-59,13,8,5
2025-08-22,48,DPD60-89,0,0,0
2025-08-22,48,DPD90+,0,0,0
2025-08-22,54,Current,28,1,27
2025-08-22,56,Current,0,0,0
2025-08-22,56,DPD15-29,2,1,1
2025-08-22,56,DPD3-14,4,1,3
2025-08-22,56,DPD30-59,0,0,0
2025-08-22,56,DPD90+,0,0,0
2025-08-22,6,Current,0,0,0
2025-08-21,102,Current,0,0,0
2025-08-21,104,Current,0,0,0
2025-08-21,20,Current,0,0,0
2025-08-21,20,DPD15-29,133,108,25
2025-08-21,20,DPD3-14,155,103,52
2025-08-21,20,DPD30-59,60,43,17
2025-08-21,20,DPD60-89,0,0,0
2025-08-21,20,DPD90+,0,0,0
2025-08-21,22,Current,0,0,0
2025-08-21,24,Current,93,12,81
2025-08-21,24,DPD15-29,87,61,26
2025-08-21,24,DPD3-14,95,69,26
2025-08-21,24,DPD30-59,36,30,6
2025-08-21,24,DPD60-89,0,0,0
2025-08-21,24,DPD90+,0,0,0
2025-08-21,26,Current,0,0,0
2025-08-21,26,DPD15-29,12,9,3
2025-08-21,26,DPD3-14,8,7,1
2025-08-21,26,DPD30-59,3,3,0
2025-08-21,26,DPD60-89,0,0,0
2025-08-21,26,DPD90+,0,0,0
2025-08-21,32,Current,0,0,0
2025-08-21,32,DPD15-29,79,58,21
2025-08-21,32,DPD3-14,75,58,17
2025-08-21,32,DPD30-59,21,13,8
2025-08-21,32,DPD60-89,0,0,0
2025-08-21,32,DPD90+,0,0,0
2025-08-21,34,Current,0,0,0
2025-08-21,34,DPD15-29,16,14,2
2025-08-21,34,DPD3-14,17,13,4
2025-08-21,34,DPD30-59,12,7,5
2025-08-21,34,DPD60-89,0,0,0
2025-08-21,34,DPD90+,0,0,0
2025-08-21,36,Current,0,0,0
2025-08-21,36,DPD15-29,6,5,1
2025-08-21,36,DPD3-14,11,6,5
2025-08-21,36,DPD30-59,8,5,3
2025-08-21,36,DPD60-89,0,0,0
2025-08-21,36,DPD90+,0,0,0
2025-08-21,38,Current,10,1,9
2025-08-21,38,DPD15-29,23,18,5
2025-08-21,38,DPD3-14,17,14,3
2025-08-21,38,DPD30-59,13,9,4
2025-08-21,38,DPD60-89,0,0,0
2025-08-21,38,DPD90+,0,0,0
2025-08-21,40,Current,0,0,0
2025-08-21,40,DPD15-29,14,11,3
2025-08-21,40,DPD3-14,17,10,7
2025-08-21,40,DPD30-59,2,2,0
2025-08-21,40,DPD60-89,0,0,0
2025-08-21,40,DPD90+,0,0,0
2025-08-21,42,Current,0,0,0
2025-08-21,42,DPD15-29,8,7,1
2025-08-21,42,DPD3-14,10,8,2
2025-08-21,42,DPD30-59,2,1,1
2025-08-21,42,DPD60-89,0,0,0
2025-08-21,42,DPD90+,0,0,0
2025-08-21,44,Current,4,4,0
2025-08-21,44,DPD15-29,19,14,5
2025-08-21,44,DPD3-14,16,10,6
2025-08-21,44,DPD30-59,10,7,3
2025-08-21,44,DPD60-89,0,0,0
2025-08-21,44,DPD90+,0,0,0
2025-08-21,46,Current,0,0,0
2025-08-21,46,DPD3-14,2,1,1
2025-08-21,46,DPD30-59,0,0,0
2025-08-21,48,Current,57,4,53
2025-08-21,48,DPD15-29,19,10,9
2025-08-21,48,DPD3-14,31,22,9
2025-08-21,48,DPD30-59,16,8,8
2025-08-21,48,DPD60-89,0,0,0
2025-08-21,48,DPD90+,0,0,0
2025-08-21,54,Current,13,0,13
2025-08-21,56,Current,29,2,27
2025-08-21,56,DPD15-29,1,1,0
2025-08-21,56,DPD3-14,1,0,1
2025-08-21,56,DPD30-59,0,0,0
2025-08-21,56,DPD90+,0,0,0
2025-08-21,6,Current,0,0,0
2025-08-20,102,Current,0,0,0
2025-08-20,104,Current,0,0,0
2025-08-20,20,Current,0,0,0
2025-08-20,20,DPD15-29,77,65,12
2025-08-20,20,DPD3-14,80,57,23
2025-08-20,20,DPD30-59,63,50,13
2025-08-20,20,DPD60-89,0,0,0
2025-08-20,20,DPD90+,0,0,0
2025-08-20,22,Current,0,0,0
2025-08-20,24,Current,57,14,43
2025-08-20,24,DPD15-29,58,38,20
2025-08-20,24,DPD3-14,68,46,22
2025-08-20,24,DPD30-59,40,29,11
2025-08-20,24,DPD60-89,0,0,0
2025-08-20,24,DPD90+,0,0,0
2025-08-20,26,Current,0,0,0
2025-08-20,26,DPD15-29,4,2,2
2025-08-20,26,DPD3-14,8,6,2
2025-08-20,26,DPD30-59,4,2,2
2025-08-20,26,DPD60-89,0,0,0
2025-08-20,26,DPD90+,0,0,0
2025-08-20,32,Current,0,0,0
2025-08-20,32,DPD15-29,51,39,12
2025-08-20,32,DPD3-14,41,30,11
2025-08-20,32,DPD30-59,25,20,5
2025-08-20,32,DPD60-89,0,0,0
2025-08-20,32,DPD90+,0,0,0
2025-08-20,34,Current,0,0,0
2025-08-20,34,DPD15-29,16,13,3
2025-08-20,34,DPD3-14,12,12,0
2025-08-20,34,DPD30-59,14,12,2
2025-08-20,34,DPD60-89,0,0,0
2025-08-20,34,DPD90+,0,0,0
2025-08-20,36,Current,0,0,0
2025-08-20,36,DPD15-29,17,11,6
2025-08-20,36,DPD3-14,8,5,3
2025-08-20,36,DPD30-59,5,4,1
2025-08-20,36,DPD60-89,0,0,0
2025-08-20,36,DPD90+,0,0,0
2025-08-20,38,Current,4,3,1
2025-08-20,38,DPD15-29,12,9,3
2025-08-20,38,DPD3-14,11,8,3
2025-08-20,38,DPD30-59,6,5,1
2025-08-20,38,DPD60-89,0,0,0
2025-08-20,38,DPD90+,0,0,0
2025-08-20,40,Current,0,0,0
2025-08-20,40,DPD15-29,8,8,0
2025-08-20,40,DPD3-14,8,4,4
2025-08-20,40,DPD30-59,5,4,1
2025-08-20,40,DPD60-89,0,0,0
2025-08-20,40,DPD90+,0,0,0
2025-08-20,42,Current,0,0,0
2025-08-20,42,DPD15-29,2,1,1
2025-08-20,42,DPD3-14,0,0,0
2025-08-20,42,DPD30-59,3,1,2
2025-08-20,42,DPD60-89,0,0,0
2025-08-20,42,DPD90+,0,0,0
2025-08-20,44,Current,7,7,0
2025-08-20,44,DPD15-29,12,9,3
2025-08-20,44,DPD3-14,18,13,5
2025-08-20,44,DPD30-59,9,5,4
2025-08-20,44,DPD60-89,0,0,0
2025-08-20,44,DPD90+,0,0,0
2025-08-20,46,Current,0,0,0
2025-08-20,46,DPD3-14,0,0,0
2025-08-20,46,DPD30-59,0,0,0
2025-08-20,48,Current,32,6,26
2025-08-20,48,DPD15-29,13,9,4
2025-08-20,48,DPD3-14,18,11,7
2025-08-20,48,DPD30-59,13,8,5
2025-08-20,48,DPD60-89,0,0,0
2025-08-20,48,DPD90+,0,0,0
2025-08-20,54,Current,14,1,13
2025-08-20,56,Current,4,4,0
2025-08-20,56,DPD15-29,4,3,1
2025-08-20,56,DPD3-14,4,3,1
2025-08-20,56,DPD30-59,0,0,0
2025-08-20,56,DPD90+,0,0,0
2025-08-20,6,Current,0,0,0
2025-08-19,102,Current,0,0,0
2025-08-19,104,Current,0,0,0
2025-08-19,20,Current,10,1,9
2025-08-19,20,DPD15-29,150,122,28
2025-08-19,20,DPD3-14,141,101,40
2025-08-19,20,DPD30-59,62,46,16
2025-08-19,20,DPD60-89,1,1,0
2025-08-19,20,DPD90+,0,0,0
2025-08-19,22,Current,0,0,0
2025-08-19,24,Current,86,18,68
2025-08-19,24,DPD15-29,93,70,23
2025-08-19,24,DPD3-14,83,60,23
2025-08-19,24,DPD30-59,39,32,7
2025-08-19,24,DPD60-89,0,0,0
2025-08-19,24,DPD90+,1,1,0
2025-08-19,26,Current,1,0,1
2025-08-19,26,DPD15-29,12,9,3
2025-08-19,26,DPD3-14,8,7,1
2025-08-19,26,DPD30-59,3,3,0
2025-08-19,26,DPD60-89,0,0,0
2025-08-19,26,DPD90+,0,0,0
2025-08-19,32,Current,10,3,7
2025-08-19,32,DPD15-29,91,69,22
2025-08-19,32,DPD3-14,64,56,8
2025-08-19,32,DPD30-59,23,15,8
2025-08-19,32,DPD60-89,0,0,0
2025-08-19,32,DPD90+,0,0,0
2025-08-19,34,Current,0,0,0
2025-08-19,34,DPD15-29,24,20,4
2025-08-19,34,DPD3-14,15,12,3
2025-08-19,34,DPD30-59,12,7,5
2025-08-19,34,DPD60-89,0,0,0
2025-08-19,34,DPD90+,0,0,0
2025-08-19,36,Current,0,0,0
2025-08-19,36,DPD15-29,13,12,1
2025-08-19,36,DPD3-14,15,8,7
2025-08-19,36,DPD30-59,9,6,3
2025-08-19,36,DPD60-89,0,0,0
2025-08-19,36,DPD90+,0,0,0
2025-08-19,38,Current,6,1,5
2025-08-19,38,DPD15-29,25,20,5
2025-08-19,38,DPD3-14,28,22,6
2025-08-19,38,DPD30-59,12,9,3
2025-08-19,38,DPD60-89,0,0,0
2025-08-19,38,DPD90+,0,0,0
2025-08-19,40,Current,3,1,2
2025-08-19,40,DPD15-29,14,12,2
2025-08-19,40,DPD3-14,16,11,5
2025-08-19,40,DPD30-59,1,1,0
2025-08-19,40,DPD60-89,0,0,0
2025-08-19,40,DPD90+,0,0,0
2025-08-19,42,Current,0,0,0
2025-08-19,42,DPD15-29,10,9,1
2025-08-19,42,DPD3-14,10,10,0
2025-08-19,42,DPD30-59,2,1,1
2025-08-19,42,DPD60-89,0,0,0
2025-08-19,42,DPD90+,0,0,0
2025-08-19,44,Current,4,1,3
2025-08-19,44,DPD15-29,16,14,2
2025-08-19,44,DPD3-14,19,15,4
2025-08-19,44,DPD30-59,12,9,3
2025-08-19,44,DPD60-89,0,0,0
2025-08-19,44,DPD90+,0,0,0
2025-08-19,46,Current,0,0,0
2025-08-19,46,DPD3-14,2,1,1
2025-08-19,46,DPD30-59,0,0,0
2025-08-19,48,Current,43,8,35
2025-08-19,48,DPD15-29,22,13,9
2025-08-19,48,DPD3-14,31,25,6
2025-08-19,48,DPD30-59,15,8,7
2025-08-19,48,DPD60-89,0,0,0
2025-08-19,48,DPD90+,0,0,0
2025-08-19,54,Current,26,2,24
2025-08-19,56,Current,0,0,0
2025-08-19,56,DPD15-29,1,1,0
2025-08-19,56,DPD3-14,1,1,0
2025-08-19,56,DPD30-59,0,0,0
2025-08-19,56,DPD90+,0,0,0
2025-08-19,6,Current,0,0,0
2025-08-18,102,Current,0,0,0
2025-08-18,104,Current,0,0,0
2025-08-18,20,Current,0,0,0
2025-08-18,20,DPD15-29,89,74,15
2025-08-18,20,DPD3-14,66,43,23
2025-08-18,20,DPD30-59,69,55,14
2025-08-18,20,DPD60-89,0,0,0
2025-08-18,20,DPD90+,0,0,0
2025-08-18,22,Current,0,0,0
2025-08-18,24,Current,112,9,103
2025-08-18,24,DPD15-29,59,37,22
2025-08-18,24,DPD3-14,50,32,18
2025-08-18,24,DPD30-59,35,27,8
2025-08-18,24,DPD60-89,0,0,0
2025-08-18,24,DPD90+,0,0,0
2025-08-18,26,Current,0,0,0
2025-08-18,26,DPD15-29,5,2,3
2025-08-18,26,DPD3-14,6,4,2
2025-08-18,26,DPD30-59,4,2,2
2025-08-18,26,DPD60-89,0,0,0
2025-08-18,26,DPD90+,0,0,0
2025-08-18,32,Current,0,0,0
2025-08-18,32,DPD15-29,53,40,13
2025-08-18,32,DPD3-14,26,17,9
2025-08-18,32,DPD30-59,32,26,6
2025-08-18,32,DPD60-89,0,0,0
2025-08-18,32,DPD90+,0,0,0
2025-08-18,34,Current,0,0,0
2025-08-18,34,DPD15-29,18,15,3
2025-08-18,34,DPD3-14,10,9,1
2025-08-18,34,DPD30-59,14,13,1
2025-08-18,34,DPD60-89,0,0,0
2025-08-18,34,DPD90+,0,0,0
2025-08-18,36,Current,0,0,0
2025-08-18,36,DPD15-29,15,10,5
2025-08-18,36,DPD3-14,5,4,1
2025-08-18,36,DPD30-59,8,7,1
2025-08-18,36,DPD60-89,0,0,0
2025-08-18,36,DPD90+,0,0,0
2025-08-18,38,Current,9,0,9
2025-08-18,38,DPD15-29,15,13,2
2025-08-18,38,DPD3-14,15,10,5
2025-08-18,38,DPD30-59,7,5,2
2025-08-18,38,DPD60-89,0,0,0
2025-08-18,38,DPD90+,0,0,0
2025-08-18,40,Current,0,0,0
2025-08-18,40,DPD15-29,7,7,0
2025-08-18,40,DPD3-14,7,4,3
2025-08-18,40,DPD30-59,6,5,1
2025-08-18,40,DPD60-89,0,0,0
2025-08-18,40,DPD90+,0,0,0
2025-08-18,42,Current,0,0,0
2025-08-18,42,DPD15-29,3,2,1
2025-08-18,42,DPD3-14,0,0,0
2025-08-18,42,DPD30-59,2,0,2
2025-08-18,42,DPD60-89,0,0,0
2025-08-18,42,DPD90+,0,0,0
2025-08-18,44,Current,0,0,0
2025-08-18,44,DPD15-29,15,12,3
2025-08-18,44,DPD3-14,9,8,1
2025-08-18,44,DPD30-59,9,6,3
2025-08-18,44,DPD60-89,0,0,0
2025-08-18,44,DPD90+,0,0,0
2025-08-18,46,Current,0,0,0
2025-08-18,46,DPD3-14,1,1,0
2025-08-18,46,DPD30-59,0,0,0
2025-08-18,48,Current,72,5,67
2025-08-18,48,DPD15-29,14,10,4
2025-08-18,48,DPD3-14,27,20,7
2025-08-18,48,DPD30-59,16,11,5
2025-08-18,48,DPD60-89,0,0,0
2025-08-18,48,DPD90+,0,0,0
2025-08-18,54,Current,25,1,24
2025-08-18,56,Current,14,1,13
2025-08-18,56,DPD15-29,3,2,1
2025-08-18,56,DPD3-14,2,2,0
2025-08-18,56,DPD30-59,0,0,0
2025-08-18,56,DPD90+,0,0,0
2025-08-18,6,Current,0,0,0
2025-08-17,102,Current,0,0,0
2025-08-17,104,Current,0,0,0
2025-08-17,20,Current,0,0,0
2025-08-17,20,DPD15-29,159,128,31
2025-08-17,20,DPD3-14,65,53,12
2025-08-17,20,DPD30-59,60,42,18
2025-08-17,20,DPD60-89,0,0,0
2025-08-17,20,DPD90+,0,0,0
2025-08-17,22,Current,0,0,0
2025-08-17,24,Current,32,2,30
2025-08-17,24,DPD15-29,97,75,22
2025-08-17,24,DPD3-14,43,27,16
2025-08-17,24,DPD30-59,42,34,8
2025-08-17,24,DPD60-89,0,0,0
2025-08-17,24,DPD90+,0,0,0
2025-08-17,26,Current,0,0,0
2025-08-17,26,DPD15-29,10,7,3
2025-08-17,26,DPD3-14,3,2,1
2025-08-17,26,DPD30-59,3,3,0
2025-08-17,26,DPD60-89,0,0,0
2025-08-17,26,DPD90+,0,0,0
2025-08-17,32,Current,0,0,0
2025-08-17,32,DPD15-29,93,71,22
2025-08-17,32,DPD3-14,26,20,6
2025-08-17,32,DPD30-59,21,16,5
2025-08-17,32,DPD60-89,0,0,0
2025-08-17,32,DPD90+,0,0,0
2025-08-17,34,Current,0,0,0
2025-08-17,34,DPD15-29,26,22,4
2025-08-17,34,DPD3-14,15,9,6
2025-08-17,34,DPD30-59,13,8,5
2025-08-17,34,DPD60-89,0,0,0
2025-08-17,34,DPD90+,0,0,0
2025-08-17,36,Current,0,0,0
2025-08-17,36,DPD15-29,14,12,2
2025-08-17,36,DPD3-14,8,4,4
2025-08-17,36,DPD30-59,9,6,3
2025-08-17,36,DPD60-89,0,0,0
2025-08-17,36,DPD90+,0,0,0
2025-08-17,38,Current,3,0,3
2025-08-17,38,DPD15-29,28,23,5
2025-08-17,38,DPD3-14,13,10,3
2025-08-17,38,DPD30-59,13,9,4
2025-08-17,38,DPD60-89,0,0,0
2025-08-17,38,DPD90+,0,0,0
2025-08-17,40,Current,0,0,0
2025-08-17,40,DPD15-29,14,12,2
2025-08-17,40,DPD3-14,2,2,0
2025-08-17,40,DPD30-59,1,1,0
2025-08-17,40,DPD60-89,0,0,0
2025-08-17,40,DPD90+,0,0,0
2025-08-17,42,Current,0,0,0
2025-08-17,42,DPD15-29,9,8,1
2025-08-17,42,DPD3-14,2,2,0
2025-08-17,42,DPD30-59,3,2,1
2025-08-17,42,DPD60-89,0,0,0
2025-08-17,42,DPD90+,0,0,0
2025-08-17,44,Current,0,0,0
2025-08-17,44,DPD15-29,17,15,2
2025-08-17,44,DPD3-14,6,4,2
2025-08-17,44,DPD30-59,13,9,4
2025-08-17,44,DPD60-89,0,0,0
2025-08-17,44,DPD90+,0,0,0
2025-08-17,46,Current,0,0,0
2025-08-17,46,DPD3-14,0,0,0
2025-08-17,46,DPD30-59,0,0,0
2025-08-17,48,Current,22,1,21
2025-08-17,48,DPD15-29,26,17,9
2025-08-17,48,DPD3-14,19,17,2
2025-08-17,48,DPD30-59,14,7,7
2025-08-17,48,DPD60-89,0,0,0
2025-08-17,48,DPD90+,0,0,0
2025-08-17,54,Current,6,0,6
2025-08-17,56,Current,5,0,5
2025-08-17,56,DPD15-29,1,1,0
2025-08-17,56,DPD3-14,1,0,1
2025-08-17,56,DPD30-59,0,0,0
2025-08-17,56,DPD90+,0,0,0
2025-08-17,6,Current,0,0,0
2025-08-16,102,Current,0,0,0
2025-08-16,104,Current,0,0,0
2025-08-16,20,Current,0,0,0
2025-08-16,20,DPD15-29,89,75,14
2025-08-16,20,DPD3-14,79,53,26
2025-08-16,20,DPD30-59,71,54,17
2025-08-16,20,DPD60-89,0,0,0
2025-08-16,20,DPD90+,0,0,0
2025-08-16,22,Current,0,0,0
2025-08-16,24,Current,36,1,35
2025-08-16,24,DPD15-29,57,39,18
2025-08-16,24,DPD3-14,62,38,24
2025-08-16,24,DPD30-59,38,29,9
2025-08-16,24,DPD60-89,0,0,0
2025-08-16,24,DPD90+,0,0,0
2025-08-16,26,Current,0,0,0
2025-08-16,26,DPD15-29,5,3,2
2025-08-16,26,DPD3-14,5,4,1
2025-08-16,26,DPD30-59,4,2,2
2025-08-16,26,DPD60-89,0,0,0
2025-08-16,26,DPD90+,0,0,0
2025-08-16,32,Current,0,0,0
2025-08-16,32,DPD15-29,51,39,12
2025-08-16,32,DPD3-14,28,18,10
2025-08-16,32,DPD30-59,32,26,6
2025-08-16,32,DPD60-89,0,0,0
2025-08-16,32,DPD90+,0,0,0
2025-08-16,34,Current,0,0,0
2025-08-16,34,DPD15-29,17,15,2
2025-08-16,34,DPD3-14,11,6,5
2025-08-16,34,DPD30-59,13,12,1
2025-08-16,34,DPD60-89,0,0,0
2025-08-16,34,DPD90+,0,0,0
2025-08-16,36,Current,0,0,0
2025-08-16,36,DPD15-29,11,6,5
2025-08-16,36,DPD3-14,5,4,1
2025-08-16,36,DPD30-59,8,7,1
2025-08-16,36,DPD60-89,0,0,0
2025-08-16,36,DPD90+,0,0,0
2025-08-16,38,Current,2,0,2
2025-08-16,38,DPD15-29,12,10,2
2025-08-16,38,DPD3-14,14,11,3
2025-08-16,38,DPD30-59,8,5,3
2025-08-16,38,DPD60-89,0,0,0
2025-08-16,38,DPD90+,0,0,0
2025-08-16,40,Current,0,0,0
2025-08-16,40,DPD15-29,7,7,0
2025-08-16,40,DPD3-14,11,7,4
2025-08-16,40,DPD30-59,6,5,1
2025-08-16,40,DPD60-89,0,0,0
2025-08-16,40,DPD90+,0,0,0
2025-08-16,42,Current,0,0,0
2025-08-16,42,DPD15-29,3,2,1
2025-08-16,42,DPD3-14,2,1,1
2025-08-16,42,DPD30-59,2,0,2
2025-08-16,42,DPD60-89,0,0,0
2025-08-16,42,DPD90+,0,0,0
2025-08-16,44,Current,0,0,0
2025-08-16,44,DPD15-29,14,12,2
2025-08-16,44,DPD3-14,9,2,7
2025-08-16,44,DPD30-59,9,7,2
2025-08-16,44,DPD60-89,0,0,0
2025-08-16,44,DPD90+,0,0,0
2025-08-16,46,Current,0,0,0
2025-08-16,46,DPD3-14,0,0,0
2025-08-16,46,DPD30-59,0,0,0
2025-08-16,48,Current,27,2,25
2025-08-16,48,DPD15-29,15,9,6
2025-08-16,48,DPD3-14,23,16,7
2025-08-16,48,DPD30-59,15,11,4
2025-08-16,48,DPD60-89,0,0,0
2025-08-16,48,DPD90+,0,0,0
2025-08-16,54,Current,4,0,4
2025-08-16,56,Current,13,0,13
2025-08-16,56,DPD15-29,2,2,0
2025-08-16,56,DPD3-14,0,0,0
2025-08-16,56,DPD30-59,0,0,0
2025-08-16,56,DPD90+,0,0,0
2025-08-16,6,Current,0,0,0
2025-08-15,102,Current,0,0,0
2025-08-15,104,Current,0,0,0
2025-08-15,20,Current,0,0,0
2025-08-15,20,DPD15-29,171,142,29
2025-08-15,20,DPD3-14,53,40,13
2025-08-15,20,DPD30-59,67,49,18
2025-08-15,20,DPD60-89,0,0,0
2025-08-15,20,DPD90+,0,0,0
2025-08-15,22,Current,0,0,0
2025-08-15,24,Current,52,5,47
2025-08-15,24,DPD15-29,96,76,20
2025-08-15,24,DPD3-14,57,37,20
2025-08-15,24,DPD30-59,43,33,10
2025-08-15,24,DPD60-89,0,0,0
2025-08-15,24,DPD90+,0,0,0
2025-08-15,26,Current,1,1,0
2025-08-15,26,DPD15-29,10,8,2
2025-08-15,26,DPD3-14,3,1,2
2025-08-15,26,DPD30-59,4,4,0
2025-08-15,26,DPD60-89,0,0,0
2025-08-15,26,DPD90+,0,0,0
2025-08-15,32,Current,0,0,0
2025-08-15,32,DPD15-29,83,66,17
2025-08-15,32,DPD3-14,16,12,4
2025-08-15,32,DPD30-59,19,15,4
2025-08-15,32,DPD60-89,0,0,0
2025-08-15,32,DPD90+,0,0,0
2025-08-15,34,Current,0,0,0
2025-08-15,34,DPD15-29,24,21,3
2025-08-15,34,DPD3-14,12,7,5
2025-08-15,34,DPD30-59,14,9,5
2025-08-15,34,DPD60-89,0,0,0
2025-08-15,34,DPD90+,0,0,0
2025-08-15,36,Current,0,0,0
2025-08-15,36,DPD15-29,12,9,3
2025-08-15,36,DPD3-14,7,4,3
2025-08-15,36,DPD30-59,10,7,3
2025-08-15,36,DPD60-89,0,0,0
2025-08-15,36,DPD90+,0,0,0
2025-08-15,38,Current,3,0,3
2025-08-15,38,DPD15-29,26,22,4
2025-08-15,38,DPD3-14,9,3,6
2025-08-15,38,DPD30-59,13,10,3
2025-08-15,38,DPD60-89,0,0,0
2025-08-15,38,DPD90+,0,0,0
2025-08-15,40,Current,0,0,0
2025-08-15,40,DPD15-29,12,10,2
2025-08-15,40,DPD3-14,8,5,3
2025-08-15,40,DPD30-59,2,2,0
2025-08-15,40,DPD60-89,0,0,0
2025-08-15,40,DPD90+,0,0,0
2025-08-15,42,Current,0,0,0
2025-08-15,42,DPD15-29,6,5,1
2025-08-15,42,DPD3-14,0,0,0
2025-08-15,42,DPD30-59,5,4,1
2025-08-15,42,DPD60-89,0,0,0
2025-08-15,42,DPD90+,0,0,0
2025-08-15,44,Current,0,0,0
2025-08-15,44,DPD15-29,23,21,2
2025-08-15,44,DPD3-14,6,3,3
2025-08-15,44,DPD30-59,13,9,4
2025-08-15,44,DPD60-89,0,0,0
2025-08-15,44,DPD90+,0,0,0
2025-08-15,46,Current,0,0,0
2025-08-15,46,DPD3-14,0,0,0
2025-08-15,46,DPD30-59,0,0,0
2025-08-15,48,Current,36,0,36
2025-08-15,48,DPD15-29,26,18,8
2025-08-15,48,DPD3-14,12,6,6
2025-08-15,48,DPD30-59,14,8,6
2025-08-15,48,DPD60-89,0,0,0
2025-08-15,48,DPD90+,0,0,0
2025-08-15,54,Current,12,0,12
2025-08-15,56,Current,10,0,10
2025-08-15,56,DPD15-29,1,1,0
2025-08-15,56,DPD3-14,3,2,1
2025-08-15,56,DPD30-59,0,0,0
2025-08-15,56,DPD90+,0,0,0
2025-08-15,6,Current,0,0,0
2025-08-14,102,Current,0,0,0
2025-08-14,104,Current,0,0,0
2025-08-14,20,Current,1,1,0
2025-08-14,20,DPD15-29,143,123,20
2025-08-14,20,DPD3-14,90,55,35
2025-08-14,20,DPD30-59,71,55,16
2025-08-14,20,DPD60-89,0,0,0
2025-08-14,20,DPD90+,0,0,0
2025-08-14,22,Current,0,0,0
2025-08-14,24,Current,76,6,70
2025-08-14,24,DPD15-29,78,58,20
2025-08-14,24,DPD3-14,64,37,27
2025-08-14,24,DPD30-59,42,33,9
2025-08-14,24,DPD60-89,0,0,0
2025-08-14,24,DPD90+,0,0,0
2025-08-14,26,Current,0,0,0
2025-08-14,26,DPD15-29,9,7,2
2025-08-14,26,DPD3-14,7,5,2
2025-08-14,26,DPD30-59,7,4,3
2025-08-14,26,DPD60-89,0,0,0
2025-08-14,26,DPD90+,0,0,0
2025-08-14,32,Current,0,0,0
2025-08-14,32,DPD15-29,74,60,14
2025-08-14,32,DPD3-14,34,23,11
2025-08-14,32,DPD30-59,36,30,6
2025-08-14,32,DPD60-89,0,0,0
2025-08-14,32,DPD90+,0,0,0
2025-08-14,34,Current,0,0,0
2025-08-14,34,DPD15-29,21,19,2
2025-08-14,34,DPD3-14,14,5,9
2025-08-14,34,DPD30-59,10,9,1
2025-08-14,34,DPD60-89,0,0,0
2025-08-14,34,DPD90+,0,0,0
2025-08-14,36,Current,0,0,0
2025-08-14,36,DPD15-29,22,15,7
2025-08-14,36,DPD3-14,4,3,1
2025-08-14,36,DPD30-59,10,9,1
2025-08-14,36,DPD60-89,0,0,0
2025-08-14,36,DPD90+,0,0,0
2025-08-14,38,Current,4,0,4
2025-08-14,38,DPD15-29,16,14,2
2025-08-14,38,DPD3-14,15,14,1
2025-08-14,38,DPD30-59,7,4,3
2025-08-14,38,DPD60-89,0,0,0
2025-08-14,38,DPD90+,0,0,0
2025-08-14,40,Current,0,0,0
2025-08-14,40,DPD15-29,16,14,2
2025-08-14,40,DPD3-14,10,5,5
2025-08-14,40,DPD30-59,7,6,1
2025-08-14,40,DPD60-89,0,0,0
2025-08-14,40,DPD90+,0,0,0
2025-08-14,42,Current,0,0,0
2025-08-14,42,DPD15-29,5,4,1
2025-08-14,42,DPD3-14,3,1,2
2025-08-14,42,DPD30-59,1,0,1
2025-08-14,42,DPD60-89,0,0,0
2025-08-14,42,DPD90+,0,0,0
2025-08-14,44,Current,0,0,0
2025-08-14,44,DPD15-29,19,16,3
2025-08-14,44,DPD3-14,15,9,6
2025-08-14,44,DPD30-59,11,9,2
2025-08-14,44,DPD60-89,0,0,0
2025-08-14,44,DPD90+,0,0,0
2025-08-14,46,Current,0,0,0
2025-08-14,46,DPD3-14,0,0,0
2025-08-14,46,DPD30-59,0,0,0
2025-08-14,48,Current,50,0,50
2025-08-14,48,DPD15-29,19,14,5
2025-08-14,48,DPD3-14,20,16,4
2025-08-14,48,DPD30-59,15,11,4
2025-08-14,48,DPD60-89,0,0,0
2025-08-14,48,DPD90+,0,0,0
2025-08-14,54,Current,7,1,6
2025-08-14,56,Current,21,1,20
2025-08-14,56,DPD15-29,3,3,0
2025-08-14,56,DPD3-14,0,0,0
2025-08-14,56,DPD30-59,0,0,0
2025-08-14,56,DPD90+,0,0,0
2025-08-14,6,Current,0,0,0
2025-08-13,102,Current,0,0,0
2025-08-13,104,Current,0,0,0
2025-08-13,20,Current,1,1,0
2025-08-13,20,DPD15-29,198,163,35
2025-08-13,20,DPD3-14,49,33,16
2025-08-13,20,DPD30-59,78,60,18
2025-08-13,20,DPD60-89,0,0,0
2025-08-13,20,DPD90+,0,0,0
2025-08-13,22,Current,0,0,0
2025-08-13,24,Current,46,5,41
2025-08-13,24,DPD15-29,112,89,23
2025-08-13,24,DPD3-14,48,32,16
2025-08-13,24,DPD30-59,43,33,10
2025-08-13,24,DPD60-89,0,0,0
2025-08-13,24,DPD90+,0,0,0
2025-08-13,26,Current,0,0,0
2025-08-13,26,DPD15-29,13,10,3
2025-08-13,26,DPD3-14,3,0,3
2025-08-13,26,DPD30-59,6,6,0
2025-08-13,26,DPD60-89,0,0,0
2025-08-13,26,DPD90+,0,0,0
2025-08-13,32,Current,0,0,0
2025-08-13,32,DPD15-29,97,78,19
2025-08-13,32,DPD3-14,24,15,9
2025-08-13,32,DPD30-59,32,26,6
2025-08-13,32,DPD60-89,0,0,0
2025-08-13,32,DPD90+,0,0,0
2025-08-13,34,Current,0,0,0
2025-08-13,34,DPD15-29,30,26,4
2025-08-13,34,DPD3-14,11,9,2
2025-08-13,34,DPD30-59,19,15,4
2025-08-13,34,DPD60-89,0,0,0
2025-08-13,34,DPD90+,0,0,0
2025-08-13,36,Current,0,0,0
2025-08-13,36,DPD15-29,15,12,3
2025-08-13,36,DPD3-14,8,7,1
2025-08-13,36,DPD30-59,9,6,3
2025-08-13,36,DPD60-89,0,0,0
2025-08-13,36,DPD90+,0,0,0
2025-08-13,38,Current,7,1,6
2025-08-13,38,DPD15-29,31,25,6
2025-08-13,38,DPD3-14,14,8,6
2025-08-13,38,DPD30-59,13,9,4
2025-08-13,38,DPD60-89,0,0,0
2025-08-13,38,DPD90+,0,0,0
2025-08-13,40,Current,0,0,0
2025-08-13,40,DPD15-29,15,12,3
2025-08-13,40,DPD3-14,10,6,4
2025-08-13,40,DPD30-59,4,2,2
2025-08-13,40,DPD60-89,0,0,0
2025-08-13,40,DPD90+,0,0,0
2025-08-13,42,Current,0,0,0
2025-08-13,42,DPD15-29,6,5,1
2025-08-13,42,DPD3-14,1,1,0
2025-08-13,42,DPD30-59,5,4,1
2025-08-13,42,DPD60-89,0,0,0
2025-08-13,42,DPD90+,0,0,0
2025-08-13,44,Current,0,0,0
2025-08-13,44,DPD15-29,26,23,3
2025-08-13,44,DPD3-14,9,6,3
2025-08-13,44,DPD30-59,16,12,4
2025-08-13,44,DPD60-89,0,0,0
2025-08-13,44,DPD90+,0,0,0
2025-08-13,46,Current,0,0,0
2025-08-13,46,DPD15-29,0,0,0
2025-08-13,46,DPD3-14,1,1,0
2025-08-13,46,DPD30-59,0,0,0
2025-08-13,48,Current,33,2,31
2025-08-13,48,DPD15-29,30,21,9
2025-08-13,48,DPD3-14,19,13,6
2025-08-13,48,DPD30-59,11,6,5
2025-08-13,48,DPD60-89,0,0,0
2025-08-13,48,DPD90+,0,0,0
2025-08-13,54,Current,13,0,13
2025-08-13,56,Current,0,0,0
2025-08-13,56,DPD15-29,0,0,0
2025-08-13,56,DPD3-14,1,0,1
2025-08-13,56,DPD30-59,0,0,0
2025-08-13,56,DPD90+,0,0,0
2025-08-13,6,Current,0,0,0
2025-08-12,102,Current,0,0,0
2025-08-12,104,Current,0,0,0
2025-08-12,20,Current,0,0,0
2025-08-12,20,DPD15-29,157,135,22
2025-08-12,20,DPD3-14,83,57,26
2025-08-12,20,DPD30-59,75,58,17
2025-08-12,20,DPD60-89,0,0,0
2025-08-12,20,DPD90+,0,0,0
2025-08-12,22,Current,0,0,0
2025-08-12,24,Current,589,562,27
2025-08-12,24,DPD15-29,92,71,21
2025-08-12,24,DPD3-14,77,53,24
2025-08-12,24,DPD30-59,47,37,10
2025-08-12,24,DPD60-89,1,1,0
2025-08-12,24,DPD90+,0,0,0
2025-08-12,26,Current,0,0,0
2025-08-12,26,DPD15-29,9,7,2
2025-08-12,26,DPD3-14,8,3,5
2025-08-12,26,DPD30-59,7,4,3
2025-08-12,26,DPD60-89,0,0,0
2025-08-12,26,DPD90+,0,0,0
2025-08-12,32,Current,0,0,0
2025-08-12,32,DPD15-29,85,71,14
2025-08-12,32,DPD3-14,49,35,14
2025-08-12,32,DPD30-59,41,33,8
2025-08-12,32,DPD60-89,0,0,0
2025-08-12,32,DPD90+,0,0,0
2025-08-12,34,Current,0,0,0
2025-08-12,34,DPD15-29,22,19,3
2025-08-12,34,DPD3-14,19,10,9
2025-08-12,34,DPD30-59,8,7,1
2025-08-12,34,DPD60-89,0,0,0
2025-08-12,34,DPD90+,0,0,0
2025-08-12,36,Current,0,0,0
2025-08-12,36,DPD15-29,24,17,7
2025-08-12,36,DPD3-14,11,8,3
2025-08-12,36,DPD30-59,11,10,1
2025-08-12,36,DPD60-89,0,0,0
2025-08-12,36,DPD90+,0,0,0
2025-08-12,38,Current,62,58,4
2025-08-12,38,DPD15-29,18,16,2
2025-08-12,38,DPD3-14,23,19,4
2025-08-12,38,DPD30-59,7,4,3
2025-08-12,38,DPD60-89,0,0,0
2025-08-12,38,DPD90+,0,0,0
2025-08-12,40,Current,0,0,0
2025-08-12,40,DPD15-29,17,15,2
2025-08-12,40,DPD3-14,10,10,0
2025-08-12,40,DPD30-59,8,7,1
2025-08-12,40,DPD60-89,0,0,0
2025-08-12,40,DPD90+,0,0,0
2025-08-12,42,Current,0,0,0
2025-08-12,42,DPD15-29,4,3,1
2025-08-12,42,DPD3-14,6,5,1
2025-08-12,42,DPD30-59,1,0,1
2025-08-12,42,DPD60-89,0,0,0
2025-08-12,42,DPD90+,0,0,0
2025-08-12,44,Current,150,150,0
2025-08-12,44,DPD15-29,22,19,3
2025-08-12,44,DPD3-14,18,13,5
2025-08-12,44,DPD30-59,13,10,3
2025-08-12,44,DPD60-89,0,0,0
2025-08-12,44,DPD90+,0,0,0
2025-08-12,46,Current,0,0,0
2025-08-12,46,DPD15-29,1,0,1
2025-08-12,46,DPD3-14,0,0,0
2025-08-12,46,DPD30-59,0,0,0
2025-08-12,48,Current,184,159,25
2025-08-12,48,DPD15-29,23,18,5
2025-08-12,48,DPD3-14,20,14,6
2025-08-12,48,DPD30-59,16,12,4
2025-08-12,48,DPD60-89,0,0,0
2025-08-12,48,DPD90+,0,0,0
2025-08-12,54,Current,30,2,28
2025-08-12,56,Current,66,65,1
2025-08-12,56,DPD15-29,3,3,0
2025-08-12,56,DPD3-14,2,1,1
2025-08-12,56,DPD30-59,0,0,0
2025-08-12,56,DPD90+,0,0,0
2025-08-12,6,Current,0,0,0
2025-08-11,102,Current,0,0,0
2025-08-11,104,Current,0,0,0
2025-08-11,20,Current,4,0,4
2025-08-11,20,DPD15-29,147,118,29
2025-08-11,20,DPD3-14,37,25,12
2025-08-11,20,DPD30-59,83,64,19
2025-08-11,20,DPD60-89,0,0,0
2025-08-11,20,DPD90+,0,0,0
2025-08-11,22,Current,0,0,0
2025-08-11,24,Current,88,9,79
2025-08-11,24,DPD15-29,86,67,19
2025-08-11,24,DPD3-14,40,26,14
2025-08-11,24,DPD30-59,41,33,8
2025-08-11,24,DPD60-89,0,0,0
2025-08-11,24,DPD90+,0,0,0
2025-08-11,26,Current,1,1,0
2025-08-11,26,DPD15-29,11,8,3
2025-08-11,26,DPD3-14,3,1,2
2025-08-11,26,DPD30-59,5,5,0
2025-08-11,26,DPD60-89,0,0,0
2025-08-11,26,DPD90+,0,0,0
2025-08-11,32,Current,6,1,5
2025-08-11,32,DPD15-29,70,59,11
2025-08-11,32,DPD3-14,22,12,10
2025-08-11,32,DPD30-59,32,26,6
2025-08-11,32,DPD60-89,0,0,0
2025-08-11,32,DPD90+,0,0,0
2025-08-11,34,Current,2,2,0
2025-08-11,34,DPD15-29,21,18,3
2025-08-11,34,DPD3-14,4,3,1
2025-08-11,34,DPD30-59,21,17,4
2025-08-11,34,DPD60-89,0,0,0
2025-08-11,34,DPD90+,0,0,0
2025-08-11,36,Current,0,0,0
2025-08-11,36,DPD15-29,13,9,4
2025-08-11,36,DPD3-14,1,1,0
2025-08-11,36,DPD30-59,7,6,1
2025-08-11,36,DPD60-89,0,0,0
2025-08-11,36,DPD90+,0,0,0
2025-08-11,38,Current,16,2,14
2025-08-11,38,DPD15-29,23,19,4
2025-08-11,38,DPD3-14,13,8,5
2025-08-11,38,DPD30-59,13,9,4
2025-08-11,38,DPD60-89,0,0,0
2025-08-11,38,DPD90+,0,0,0
2025-08-11,40,Current,1,0,1
2025-08-11,40,DPD15-29,8,8,0
2025-08-11,40,DPD3-14,2,1,1
2025-08-11,40,DPD30-59,4,2,2
2025-08-11,40,DPD60-89,0,0,0
2025-08-11,40,DPD90+,0,0,0
2025-08-11,42,Current,0,0,0
2025-08-11,42,DPD15-29,3,3,0
2025-08-11,42,DPD3-14,2,2,0
2025-08-11,42,DPD30-59,5,4,1
2025-08-11,42,DPD60-89,0,0,0
2025-08-11,42,DPD90+,0,0,0
2025-08-11,44,Current,3,1,2
2025-08-11,44,DPD15-29,18,15,3
2025-08-11,44,DPD3-14,13,4,9
2025-08-11,44,DPD30-59,15,11,4
2025-08-11,44,DPD60-89,0,0,0
2025-08-11,44,DPD90+,0,0,0
2025-08-11,46,Current,0,0,0
2025-08-11,46,DPD15-29,0,0,0
2025-08-11,46,DPD3-14,1,1,0
2025-08-11,46,DPD30-59,0,0,0
2025-08-11,48,Current,61,6,55
2025-08-11,48,DPD15-29,30,22,8
2025-08-11,48,DPD3-14,26,17,9
2025-08-11,48,DPD30-59,11,6,5
2025-08-11,48,DPD60-89,0,0,0
2025-08-11,48,DPD90+,0,0,0
2025-08-11,54,Current,53,2,51
2025-08-11,56,Current,1,1,0
2025-08-11,56,DPD15-29,0,0,0
2025-08-11,56,DPD3-14,1,0,1
2025-08-11,56,DPD90+,0,0,0
2025-08-11,6,Current,0,0,0
2025-08-10,102,Current,0,0,0
2025-08-10,104,Current,0,0,0
2025-08-10,20,Current,0,0,0
2025-08-10,20,DPD15-29,142,121,21
2025-08-10,20,DPD3-14,28,22,6
2025-08-10,20,DPD30-59,72,54,18
2025-08-10,20,DPD60-89,0,0,0
2025-08-10,20,DPD90+,0,0,0
2025-08-10,22,Current,0,0,0
2025-08-10,24,Current,39,1,38
2025-08-10,24,DPD15-29,76,63,13
2025-08-10,24,DPD3-14,37,24,13
2025-08-10,24,DPD30-59,44,35,9
2025-08-10,24,DPD60-89,0,0,0
2025-08-10,24,DPD90+,0,0,0
2025-08-10,26,Current,0,0,0
2025-08-10,26,DPD15-29,8,6,2
2025-08-10,26,DPD3-14,4,2,2
2025-08-10,26,DPD30-59,7,4,3
2025-08-10,26,DPD60-89,0,0,0
2025-08-10,26,DPD90+,0,0,0
2025-08-10,32,Current,0,0,0
2025-08-10,32,DPD15-29,80,66,14
2025-08-10,32,DPD3-14,14,11,3
2025-08-10,32,DPD30-59,42,34,8
2025-08-10,32,DPD60-89,0,0,0
2025-08-10,32,DPD90+,0,0,0
2025-08-10,34,Current,0,0,0
2025-08-10,34,DPD15-29,19,16,3
2025-08-10,34,DPD3-14,10,5,5
2025-08-10,34,DPD30-59,8,7,1
2025-08-10,34,DPD60-89,0,0,0
2025-08-10,34,DPD90+,0,0,0
2025-08-10,36,Current,0,0,0
2025-08-10,36,DPD15-29,20,14,6
2025-08-10,36,DPD3-14,7,5,2
2025-08-10,36,DPD30-59,11,10,1
2025-08-10,36,DPD60-89,0,0,0
2025-08-10,36,DPD90+,0,0,0
2025-08-10,38,Current,2,0,2
2025-08-10,38,DPD15-29,20,18,2
2025-08-10,38,DPD3-14,10,6,4
2025-08-10,38,DPD30-59,7,3,4
2025-08-10,38,DPD60-89,0,0,0
2025-08-10,38,DPD90+,0,0,0
2025-08-10,40,Current,0,0,0
2025-08-10,40,DPD15-29,13,11,2
2025-08-10,40,DPD3-14,6,5,1
2025-08-10,40,DPD30-59,7,7,0
2025-08-10,40,DPD60-89,0,0,0
2025-08-10,40,DPD90+,0,0,0
2025-08-10,42,Current,0,0,0
2025-08-10,42,DPD15-29,5,4,1
2025-08-10,42,DPD3-14,1,0,1
2025-08-10,42,DPD30-59,1,0,1
2025-08-10,42,DPD60-89,0,0,0
2025-08-10,42,DPD90+,0,0,0
2025-08-10,44,Current,0,0,0
2025-08-10,44,DPD15-29,18,15,3
2025-08-10,44,DPD3-14,3,1,2
2025-08-10,44,DPD30-59,13,10,3
2025-08-10,44,DPD60-89,0,0,0
2025-08-10,44,DPD90+,0,0,0
2025-08-10,46,Current,0,0,0
2025-08-10,46,DPD15-29,1,0,1
2025-08-10,46,DPD3-14,0,0,0
2025-08-10,46,DPD30-59,0,0,0
2025-08-10,48,Current,29,1,28
2025-08-10,48,DPD15-29,22,16,6
2025-08-10,48,DPD3-14,9,6,3
2025-08-10,48,DPD30-59,15,10,5
2025-08-10,48,DPD60-89,0,0,0
2025-08-10,48,DPD90+,0,0,0
2025-08-10,54,Current,32,1,31
2025-08-10,56,Current,0,0,0
2025-08-10,56,DPD15-29,3,2,1
2025-08-10,56,DPD3-14,3,3,0
2025-08-10,56,DPD90+,0,0,0
2025-08-10,6,Current,0,0,0
2025-08-09,102,Current,0,0,0
2025-08-09,104,Current,0,0,0
2025-08-09,20,Current,0,0,0
2025-08-09,20,DPD15-29,129,104,25
2025-08-09,20,DPD3-14,42,29,13
2025-08-09,20,DPD30-59,78,61,17
2025-08-09,20,DPD60-89,0,0,0
2025-08-09,20,DPD90+,0,0,0
2025-08-09,22,Current,0,0,0
2025-08-09,24,Current,32,1,31
2025-08-09,24,DPD15-29,84,66,18
2025-08-09,24,DPD3-14,42,25,17
2025-08-09,24,DPD30-59,40,33,7
2025-08-09,24,DPD60-89,0,0,0
2025-08-09,24,DPD90+,0,0,0
2025-08-09,26,Current,0,0,0
2025-08-09,26,DPD15-29,11,8,3
2025-08-09,26,DPD3-14,5,3,2
2025-08-09,26,DPD30-59,5,5,0
2025-08-09,26,DPD60-89,0,0,0
2025-08-09,26,DPD90+,0,0,0
2025-08-09,32,Current,0,0,0
2025-08-09,32,DPD15-29,60,55,5
2025-08-09,32,DPD3-14,21,14,7
2025-08-09,32,DPD30-59,29,26,3
2025-08-09,32,DPD60-89,0,0,0
2025-08-09,32,DPD90+,0,0,0
2025-08-09,34,Current,0,0,0
2025-08-09,34,DPD15-29,20,15,5
2025-08-09,34,DPD3-14,1,0,1
2025-08-09,34,DPD30-59,20,17,3
2025-08-09,34,DPD60-89,0,0,0
2025-08-09,34,DPD90+,0,0,0
2025-08-09,36,Current,0,0,0
2025-08-09,36,DPD15-29,12,9,3
2025-08-09,36,DPD3-14,1,1,0
2025-08-09,36,DPD30-59,5,4,1
2025-08-09,36,DPD60-89,0,0,0
2025-08-09,36,DPD90+,0,0,0
2025-08-09,38,Current,3,0,3
2025-08-09,38,DPD15-29,23,19,4
2025-08-09,38,DPD3-14,8,5,3
2025-08-09,38,DPD30-59,10,9,1
2025-08-09,38,DPD60-89,0,0,0
2025-08-09,38,DPD90+,0,0,0
2025-08-09,40,Current,0,0,0
2025-08-09,40,DPD15-29,6,6,0
2025-08-09,40,DPD3-14,6,0,6
2025-08-09,40,DPD30-59,4,2,2
2025-08-09,40,DPD60-89,0,0,0
2025-08-09,40,DPD90+,0,0,0
2025-08-09,42,Current,0,0,0
2025-08-09,42,DPD15-29,4,4,0
2025-08-09,42,DPD3-14,1,1,0
2025-08-09,42,DPD30-59,3,3,0
2025-08-09,42,DPD60-89,0,0,0
2025-08-09,42,DPD90+,0,0,0
2025-08-09,44,Current,0,0,0
2025-08-09,44,DPD15-29,19,15,4
2025-08-09,44,DPD3-14,10,3,7
2025-08-09,44,DPD30-59,13,11,2
2025-08-09,44,DPD60-89,0,0,0
2025-08-09,44,DPD90+,0,0,0
2025-08-09,46,Current,0,0,0
2025-08-09,46,DPD15-29,0,0,0
2025-08-09,46,DPD30-59,0,0,0
2025-08-09,48,Current,22,0,22
2025-08-09,48,DPD15-29,29,21,8
2025-08-09,48,DPD3-14,19,13,6
2025-08-09,48,DPD30-59,8,6,2
2025-08-09,48,DPD60-89,0,0,0
2025-08-09,48,DPD90+,0,0,0
2025-08-09,54,Current,8,0,8
2025-08-09,56,Current,0,0,0
2025-08-09,56,DPD15-29,0,0,0
2025-08-09,56,DPD3-14,1,1,0
2025-08-09,56,DPD90+,0,0,0
2025-08-09,6,Current,0,0,0
2025-08-08,102,Current,0,0,0
2025-08-08,104,Current,0,0,0
2025-08-08,20,Current,0,0,0
2025-08-08,20,DPD15-29,142,117,25
2025-08-08,20,DPD3-14,105,87,18
2025-08-08,20,DPD30-59,82,63,19
2025-08-08,20,DPD60-89,0,0,0
2025-08-08,20,DPD90+,0,0,0
2025-08-08,22,Current,0,0,0
2025-08-08,24,Current,42,2,40
2025-08-08,24,DPD15-29,83,69,14
2025-08-08,24,DPD3-14,94,66,28
2025-08-08,24,DPD30-59,50,39,11
2025-08-08,24,DPD60-89,0,0,0
2025-08-08,24,DPD90+,0,0,0
2025-08-08,26,Current,0,0,0
2025-08-08,26,DPD15-29,9,7,2
2025-08-08,26,DPD3-14,8,4,4
2025-08-08,26,DPD30-59,7,4,3
2025-08-08,26,DPD60-89,0,0,0
2025-08-08,26,DPD90+,0,0,0
2025-08-08,32,Current,0,0,0
2025-08-08,32,DPD15-29,74,65,9
2025-08-08,32,DPD3-14,59,41,18
2025-08-08,32,DPD30-59,44,36,8
2025-08-08,32,DPD60-89,0,0,0
2025-08-08,32,DPD90+,0,0,0
2025-08-08,34,Current,0,0,0
2025-08-08,34,DPD15-29,19,15,4
2025-08-08,34,DPD3-14,22,18,4
2025-08-08,34,DPD30-59,8,7,1
2025-08-08,34,DPD60-89,0,0,0
2025-08-08,34,DPD90+,0,0,0
2025-08-08,36,Current,0,0,0
2025-08-08,36,DPD15-29,18,14,4
2025-08-08,36,DPD3-14,18,15,3
2025-08-08,36,DPD30-59,11,10,1
2025-08-08,36,DPD60-89,0,0,0
2025-08-08,36,DPD90+,0,0,0
2025-08-08,38,Current,5,1,4
2025-08-08,38,DPD15-29,23,21,2
2025-08-08,38,DPD3-14,22,17,5
2025-08-08,38,DPD30-59,8,4,4
2025-08-08,38,DPD60-89,0,0,0
2025-08-08,38,DPD90+,0,0,0
2025-08-08,40,Current,0,0,0
2025-08-08,40,DPD15-29,14,11,3
2025-08-08,40,DPD3-14,11,7,4
2025-08-08,40,DPD30-59,9,9,0
2025-08-08,40,DPD60-89,0,0,0
2025-08-08,40,DPD90+,0,0,0
2025-08-08,42,Current,0,0,0
2025-08-08,42,DPD15-29,7,6,1
2025-08-08,42,DPD3-14,4,3,1
2025-08-08,42,DPD30-59,2,1,1
2025-08-08,42,DPD60-89,0,0,0
2025-08-08,42,DPD90+,0,0,0
2025-08-08,44,Current,0,0,0
2025-08-08,44,DPD15-29,23,19,4
2025-08-08,44,DPD3-14,18,12,6
2025-08-08,44,DPD30-59,12,9,3
2025-08-08,44,DPD60-89,0,0,0
2025-08-08,44,DPD90+,0,0,0
2025-08-08,46,Current,0,0,0
2025-08-08,46,DPD15-29,1,0,1
2025-08-08,46,DPD30-59,0,0,0
2025-08-08,48,Current,28,1,27
2025-08-08,48,DPD15-29,26,19,7
2025-08-08,48,DPD3-14,22,13,9
2025-08-08,48,DPD30-59,16,10,6
2025-08-08,48,DPD60-89,0,0,0
2025-08-08,48,DPD90+,0,0,0
2025-08-08,54,Current,30,0,30
2025-08-08,56,Current,0,0,0
2025-08-08,56,DPD15-29,3,2,1
2025-08-08,56,DPD3-14,3,1,2
2025-08-08,56,DPD90+,0,0,0
2025-08-08,6,Current,0,0,0
2025-08-07,102,Current,0,0,0
2025-08-07,104,Current,0,0,0
2025-08-07,20,Current,18,4,14
2025-08-07,20,DPD15-29,145,122,23
2025-08-07,20,DPD3-14,107,75,32
2025-08-07,20,DPD30-59,86,66,20
2025-08-07,20,DPD60-89,0,0,0
2025-08-07,20,DPD90+,0,0,0
2025-08-07,22,Current,0,0,0
2025-08-07,24,Current,91,11,80
2025-08-07,24,DPD15-29,97,78,19
2025-08-07,24,DPD3-14,85,52,33
2025-08-07,24,DPD30-59,45,38,7
2025-08-07,24,DPD60-89,0,0,0
2025-08-07,24,DPD90+,0,0,0
2025-08-07,26,Current,0,0,0
2025-08-07,26,DPD15-29,11,8,3
2025-08-07,26,DPD3-14,8,4,4
2025-08-07,26,DPD30-59,5,5,0
2025-08-07,26,DPD60-89,0,0,0
2025-08-07,26,DPD90+,0,0,0
2025-08-07,32,Current,10,5,5
2025-08-07,32,DPD15-29,60,55,5
2025-08-07,32,DPD3-14,64,46,18
2025-08-07,32,DPD30-59,30,26,4
2025-08-07,32,DPD60-89,0,0,0
2025-08-07,32,DPD90+,0,0,0
2025-08-07,34,Current,0,0,0
2025-08-07,34,DPD15-29,18,13,5
2025-08-07,34,DPD3-14,17,8,9
2025-08-07,34,DPD30-59,21,18,3
2025-08-07,34,DPD60-89,0,0,0
2025-08-07,34,DPD90+,0,0,0
2025-08-07,36,Current,0,0,0
2025-08-07,36,DPD15-29,15,12,3
2025-08-07,36,DPD3-14,16,13,3
2025-08-07,36,DPD30-59,4,3,1
2025-08-07,36,DPD60-89,0,0,0
2025-08-07,36,DPD90+,1,1,0
2025-08-07,38,Current,9,0,9
2025-08-07,38,DPD15-29,22,18,4
2025-08-07,38,DPD3-14,15,11,4
2025-08-07,38,DPD30-59,10,9,1
2025-08-07,38,DPD60-89,0,0,0
2025-08-07,38,DPD90+,0,0,0
2025-08-07,40,Current,4,1,3
2025-08-07,40,DPD15-29,6,6,0
2025-08-07,40,DPD3-14,15,9,6
2025-08-07,40,DPD30-59,6,4,2
2025-08-07,40,DPD60-89,0,0,0
2025-08-07,40,DPD90+,0,0,0
2025-08-07,42,Current,0,0,0
2025-08-07,42,DPD15-29,5,5,0
2025-08-07,42,DPD3-14,3,3,0
2025-08-07,42,DPD30-59,3,3,0
2025-08-07,42,DPD60-89,0,0,0
2025-08-07,42,DPD90+,0,0,0
2025-08-07,44,Current,3,0,3
2025-08-07,44,DPD15-29,19,16,3
2025-08-07,44,DPD3-14,15,12,3
2025-08-07,44,DPD30-59,13,11,2
2025-08-07,44,DPD60-89,0,0,0
2025-08-07,44,DPD90+,0,0,0
2025-08-07,46,Current,0,0,0
2025-08-07,46,DPD15-29,0,0,0
2025-08-07,46,DPD30-59,0,0,0
2025-08-07,48,Current,56,10,46
2025-08-07,48,DPD15-29,32,25,7
2025-08-07,48,DPD3-14,19,13,6
2025-08-07,48,DPD30-59,10,8,2
2025-08-07,48,DPD60-89,0,0,0
2025-08-07,48,DPD90+,0,0,0
2025-08-07,54,Current,10,0,10
2025-08-07,56,Current,20,0,20
2025-08-07,56,DPD15-29,0,0,0
2025-08-07,56,DPD3-14,3,2,1
2025-08-07,56,DPD60-89,0,0,0
2025-08-07,6,Current,0,0,0
2025-08-06,102,Current,0,0,0
2025-08-06,104,Current,0,0,0
2025-08-06,20,Current,33,6,27
2025-08-06,20,DPD15-29,137,113,24
2025-08-06,20,DPD3-14,54,37,17
2025-08-06,20,DPD30-59,66,51,15
2025-08-06,20,DPD60-89,2,2,0
2025-08-06,20,DPD90+,0,0,0
2025-08-06,22,Current,0,0,0
2025-08-06,24,Current,188,24,164
2025-08-06,24,DPD15-29,82,71,11
2025-08-06,24,DPD3-14,44,26,18
2025-08-06,24,DPD30-59,39,29,10
2025-08-06,24,DPD60-89,0,0,0
2025-08-06,24,DPD90+,1,1,0
2025-08-06,26,Current,2,0,2
2025-08-06,26,DPD15-29,9,7,2
2025-08-06,26,DPD3-14,3,0,3
2025-08-06,26,DPD30-59,5,3,2
2025-08-06,26,DPD60-89,0,0,0
2025-08-06,26,DPD90+,0,0,0
2025-08-06,32,Current,17,4,13
2025-08-06,32,DPD15-29,70,58,12
2025-08-06,32,DPD3-14,31,17,14
2025-08-06,32,DPD30-59,39,31,8
2025-08-06,32,DPD60-89,2,2,0
2025-08-06,32,DPD90+,0,0,0
2025-08-06,34,Current,0,0,0
2025-08-06,34,DPD15-29,20,16,4
2025-08-06,34,DPD3-14,9,7,2
2025-08-06,34,DPD30-59,5,4,1
2025-08-06,34,DPD60-89,0,0,0
2025-08-06,34,DPD90+,0,0,0
2025-08-06,36,Current,0,0,0
2025-08-06,36,DPD15-29,16,13,3
2025-08-06,36,DPD3-14,8,6,2
2025-08-06,36,DPD30-59,9,9,0
2025-08-06,36,DPD60-89,0,0,0
2025-08-06,36,DPD90+,0,0,0
2025-08-06,38,Current,15,2,13
2025-08-06,38,DPD15-29,21,19,2
2025-08-06,38,DPD3-14,5,5,0
2025-08-06,38,DPD30-59,7,3,4
2025-08-06,38,DPD60-89,0,0,0
2025-08-06,38,DPD90+,0,0,0
2025-08-06,40,Current,6,1,5
2025-08-06,40,DPD15-29,15,12,3
2025-08-06,40,DPD3-14,2,2,0
2025-08-06,40,DPD30-59,11,10,1
2025-08-06,40,DPD60-89,0,0,0
2025-08-06,40,DPD90+,0,0,0
2025-08-06,42,Current,0,0,0
2025-08-06,42,DPD15-29,4,4,0
2025-08-06,42,DPD3-14,1,1,0
2025-08-06,42,DPD30-59,2,2,0
2025-08-06,42,DPD60-89,0,0,0
2025-08-06,42,DPD90+,0,0,0
2025-08-06,44,Current,14,4,10
2025-08-06,44,DPD15-29,18,16,2
2025-08-06,44,DPD3-14,10,4,6
2025-08-06,44,DPD30-59,11,10,1
2025-08-06,44,DPD60-89,0,0,0
2025-08-06,44,DPD90+,0,0,0
2025-08-06,46,Current,0,0,0
2025-08-06,46,DPD15-29,1,0,1
2025-08-06,46,DPD30-59,0,0,0
2025-08-06,48,Current,110,15,95
2025-08-06,48,DPD15-29,30,22,8
2025-08-06,48,DPD3-14,16,9,7
2025-08-06,48,DPD30-59,12,8,4
2025-08-06,48,DPD60-89,0,0,0
2025-08-06,48,DPD90+,0,0,0
2025-08-06,54,Current,82,1,81
2025-08-06,56,Current,5,0,5
2025-08-06,56,DPD15-29,3,2,1
2025-08-06,56,DPD3-14,2,0,2
2025-08-06,56,DPD60-89,0,0,0
2025-08-06,6,Current,0,0,0
2025-08-05,102,Current,0,0,0
2025-08-05,104,Current,0,0,0
2025-08-05,20,Current,0,0,0
2025-08-05,20,DPD15-29,142,122,20
2025-08-05,20,DPD3-14,89,71,18
2025-08-05,20,DPD30-59,82,64,18
2025-08-05,20,DPD60-89,0,0,0
2025-08-05,20,DPD90+,0,0,0
2025-08-05,22,Current,0,0,0
2025-08-05,24,Current,961,800,161
2025-08-05,24,DPD15-29,99,79,20
2025-08-05,24,DPD3-14,68,48,20
2025-08-05,24,DPD30-59,43,36,7
2025-08-05,24,DPD60-89,1,1,0
2025-08-05,24,DPD90+,0,0,0
2025-08-05,26,Current,0,0,0
2025-08-05,26,DPD15-29,13,9,4
2025-08-05,26,DPD3-14,5,2,3
2025-08-05,26,DPD30-59,4,4,0
2025-08-05,26,DPD60-89,0,0,0
2025-08-05,26,DPD90+,0,0,0
2025-08-05,32,Current,0,0,0
2025-08-05,32,DPD15-29,57,50,7
2025-08-05,32,DPD3-14,50,33,17
2025-08-05,32,DPD30-59,33,29,4
2025-08-05,32,DPD60-89,0,0,0
2025-08-05,32,DPD90+,0,0,0
2025-08-05,34,Current,0,0,0
2025-08-05,34,DPD15-29,18,13,5
2025-08-05,34,DPD3-14,11,5,6
2025-08-05,34,DPD30-59,18,15,3
2025-08-05,34,DPD60-89,0,0,0
2025-08-05,34,DPD90+,0,0,0
2025-08-05,36,Current,0,0,0
2025-08-05,36,DPD15-29,14,12,2
2025-08-05,36,DPD3-14,15,11,4
2025-08-05,36,DPD30-59,2,2,0
2025-08-05,36,DPD60-89,0,0,0
2025-08-05,36,DPD90+,0,0,0
2025-08-05,38,Current,116,99,17
2025-08-05,38,DPD15-29,22,19,3
2025-08-05,38,DPD3-14,12,9,3
2025-08-05,38,DPD30-59,10,8,2
2025-08-05,38,DPD60-89,0,0,0
2025-08-05,38,DPD90+,0,0,0
2025-08-05,40,Current,0,0,0
2025-08-05,40,DPD15-29,6,6,0
2025-08-05,40,DPD3-14,8,6,2
2025-08-05,40,DPD30-59,6,4,2
2025-08-05,40,DPD60-89,0,0,0
2025-08-05,40,DPD90+,0,0,0
2025-08-05,42,Current,0,0,0
2025-08-05,42,DPD15-29,4,3,1
2025-08-05,42,DPD3-14,4,3,1
2025-08-05,42,DPD30-59,2,2,0
2025-08-05,42,DPD60-89,0,0,0
2025-08-05,42,DPD90+,0,0,0
2025-08-05,44,Current,230,229,1
2025-08-05,44,DPD15-29,20,17,3
2025-08-05,44,DPD3-14,11,7,4
2025-08-05,44,DPD30-59,12,10,2
2025-08-05,44,DPD60-89,0,0,0
2025-08-05,44,DPD90+,0,0,0
2025-08-05,46,Current,0,0,0
2025-08-05,46,DPD15-29,0,0,0
2025-08-05,46,DPD30-59,0,0,0
2025-08-05,48,Current,350,238,112
2025-08-05,48,DPD15-29,30,24,6
2025-08-05,48,DPD3-14,14,9,5
2025-08-05,48,DPD30-59,9,7,2
2025-08-05,48,DPD60-89,0,0,0
2025-08-05,48,DPD90+,0,0,0
2025-08-05,54,Current,61,0,61
2025-08-05,56,Current,100,93,7
2025-08-05,56,DPD15-29,0,0,0
2025-08-05,56,DPD3-14,2,1,1
2025-08-05,56,DPD60-89,0,0,0
2025-08-05,6,Current,0,0,0
2025-08-04,102,Current,0,0,0
2025-08-04,104,Current,0,0,0
2025-08-04,20,Current,0,0,0
2025-08-04,20,DPD15-29,128,103,25
2025-08-04,20,DPD3-14,13,9,4
2025-08-04,20,DPD30-59,64,53,11
2025-08-04,20,DPD60-89,0,0,0
2025-08-04,20,DPD90+,0,0,0
2025-08-04,22,Current,0,0,0
2025-08-04,24,Current,231,8,223
2025-08-04,24,DPD15-29,81,70,11
2025-08-04,24,DPD3-14,10,7,3
2025-08-04,24,DPD30-59,43,29,14
2025-08-04,24,DPD60-89,0,0,0
2025-08-04,24,DPD90+,0,0,0
2025-08-04,26,Current,0,0,0
2025-08-04,26,DPD15-29,8,6,2
2025-08-04,26,DPD3-14,3,3,0
2025-08-04,26,DPD30-59,4,2,2
2025-08-04,26,DPD60-89,0,0,0
2025-08-04,26,DPD90+,0,0,0
2025-08-04,32,Current,0,0,0
2025-08-04,32,DPD15-29,59,47,12
2025-08-04,32,DPD3-14,11,9,2
2025-08-04,32,DPD30-59,37,31,6
2025-08-04,32,DPD60-89,0,0,0
2025-08-04,32,DPD90+,0,0,0
2025-08-04,34,Current,1,1,0
2025-08-04,34,DPD15-29,21,17,4
2025-08-04,34,DPD3-14,5,5,0
2025-08-04,34,DPD30-59,6,6,0
2025-08-04,34,DPD60-89,0,0,0
2025-08-04,34,DPD90+,0,0,0
2025-08-04,36,Current,0,0,0
2025-08-04,36,DPD15-29,12,11,1
2025-08-04,36,DPD3-14,2,1,1
2025-08-04,36,DPD30-59,9,9,0
2025-08-04,36,DPD60-89,0,0,0
2025-08-04,36,DPD90+,0,0,0
2025-08-04,38,Current,14,1,13
2025-08-04,38,DPD15-29,24,22,2
2025-08-04,38,DPD3-14,4,4,0
2025-08-04,38,DPD30-59,6,3,3
2025-08-04,38,DPD60-89,0,0,0
2025-08-04,38,DPD90+,0,0,0
2025-08-04,40,Current,0,0,0
2025-08-04,40,DPD15-29,12,9,3
2025-08-04,40,DPD3-14,2,2,0
2025-08-04,40,DPD30-59,11,10,1
2025-08-04,40,DPD60-89,0,0,0
2025-08-04,40,DPD90+,0,0,0
2025-08-04,42,Current,0,0,0
2025-08-04,42,DPD15-29,6,5,1
2025-08-04,42,DPD3-14,2,2,0
2025-08-04,42,DPD30-59,2,2,0
2025-08-04,42,DPD60-89,0,0,0
2025-08-04,42,DPD90+,0,0,0
2025-08-04,44,Current,6,0,6
2025-08-04,44,DPD15-29,18,14,4
2025-08-04,44,DPD3-14,5,3,2
2025-08-04,44,DPD30-59,11,10,1
2025-08-04,44,DPD60-89,0,0,0
2025-08-04,44,DPD90+,0,0,0
2025-08-04,46,Current,0,0,0
2025-08-04,46,DPD15-29,1,0,1
2025-08-04,46,DPD30-59,0,0,0
2025-08-04,48,Current,147,5,142
2025-08-04,48,DPD15-29,31,23,8
2025-08-04,48,DPD3-14,12,7,5
2025-08-04,48,DPD30-59,12,8,4
2025-08-04,48,DPD60-89,0,0,0
2025-08-04,48,DPD90+,0,0,0
2025-08-04,54,Current,127,3,124
2025-08-04,56,Current,20,2,18
2025-08-04,56,DPD15-29,2,1,1
2025-08-04,56,DPD3-14,0,0,0
2025-08-04,56,DPD60-89,0,0,0
2025-08-04,6,Current,0,0,0
2025-08-03,102,Current,0,0,0
2025-08-03,104,Current,0,0,0
2025-08-03,20,Current,0,0,0
2025-08-03,20,DPD15-29,93,76,17
2025-08-03,20,DPD3-14,102,87,15
2025-08-03,20,DPD30-59,84,67,17
2025-08-03,20,DPD60-89,0,0,0
2025-08-03,20,DPD90+,0,0,0
2025-08-03,22,DPD15-29,0,0,0
2025-08-03,24,Current,151,2,149
2025-08-03,24,DPD15-29,75,59,16
2025-08-03,24,DPD3-14,83,63,20
2025-08-03,24,DPD30-59,40,33,7
2025-08-03,24,DPD60-89,0,0,0
2025-08-03,24,DPD90+,0,0,0
2025-08-03,26,Current,0,0,0
2025-08-03,26,DPD15-29,10,6,4
2025-08-03,26,DPD3-14,5,3,2
2025-08-03,26,DPD30-59,5,4,1
2025-08-03,26,DPD60-89,0,0,0
2025-08-03,26,DPD90+,0,0,0
2025-08-03,32,Current,0,0,0
2025-08-03,32,DPD15-29,42,36,6
2025-08-03,32,DPD3-14,66,49,17
2025-08-03,32,DPD30-59,28,24,4
2025-08-03,32,DPD60-89,0,0,0
2025-08-03,32,DPD90+,0,0,0
2025-08-03,34,Current,0,0,0
2025-08-03,34,DPD15-29,14,10,4
2025-08-03,34,DPD3-14,23,19,4
2025-08-03,34,DPD30-59,13,11,2
2025-08-03,34,DPD60-89,0,0,0
2025-08-03,34,DPD90+,0,0,0
2025-08-03,36,Current,0,0,0
2025-08-03,36,DPD15-29,10,9,1
2025-08-03,36,DPD3-14,14,12,2
2025-08-03,36,DPD30-59,3,2,1
2025-08-03,36,DPD60-89,0,0,0
2025-08-03,36,DPD90+,0,0,0
2025-08-03,38,Current,13,0,13
2025-08-03,38,DPD15-29,18,16,2
2025-08-03,38,DPD3-14,26,19,7
2025-08-03,38,DPD30-59,7,6,1
2025-08-03,38,DPD60-89,0,0,0
2025-08-03,38,DPD90+,0,0,0
2025-08-03,40,Current,0,0,0
2025-08-03,40,DPD15-29,6,6,0
2025-08-03,40,DPD3-14,12,7,5
2025-08-03,40,DPD30-59,6,5,1
2025-08-03,40,DPD60-89,0,0,0
2025-08-03,40,DPD90+,0,0,0
2025-08-03,42,Current,0,0,0
2025-08-03,42,DPD15-29,4,3,1
2025-08-03,42,DPD3-14,8,5,3
2025-08-03,42,DPD30-59,1,1,0
2025-08-03,42,DPD60-89,0,0,0
2025-08-03,42,DPD90+,0,0,0
2025-08-03,44,Current,8,2,6
2025-08-03,44,DPD15-29,20,17,3
2025-08-03,44,DPD3-14,15,11,4
2025-08-03,44,DPD30-59,10,8,2
2025-08-03,44,DPD60-89,0,0,0
2025-08-03,44,DPD90+,0,0,0
2025-08-03,46,Current,0,0,0
2025-08-03,46,DPD15-29,0,0,0
2025-08-03,48,Current,98,3,95
2025-08-03,48,DPD15-29,24,19,5
2025-08-03,48,DPD3-14,17,12,5
2025-08-03,48,DPD30-59,10,8,2
2025-08-03,48,DPD60-89,0,0,0
2025-08-03,48,DPD90+,0,0,0
2025-08-03,54,Current,43,0,43
2025-08-03,56,Current,27,1,26
2025-08-03,56,DPD15-29,0,0,0
2025-08-03,56,DPD3-14,1,1,0
2025-08-03,56,DPD60-89,0,0,0
2025-08-03,6,Current,0,0,0
2025-08-02,102,Current,0,0,0
2025-08-02,104,Current,0,0,0
2025-08-02,20,Current,0,0,0
2025-08-02,20,DPD15-29,122,99,23
2025-08-02,20,DPD3-14,59,44,15
2025-08-02,20,DPD30-59,60,50,10
2025-08-02,20,DPD60-89,0,0,0
2025-08-02,20,DPD90+,0,0,0
2025-08-02,22,DPD3-14,0,0,0
2025-08-02,24,Current,201,5,196
2025-08-02,24,DPD15-29,72,60,12
2025-08-02,24,DPD3-14,51,40,11
2025-08-02,24,DPD30-59,42,30,12
2025-08-02,24,DPD60-89,0,0,0
2025-08-02,24,DPD90+,0,0,0
2025-08-02,26,Current,0,0,0
2025-08-02,26,DPD15-29,9,8,1
2025-08-02,26,DPD3-14,3,3,0
2025-08-02,26,DPD30-59,3,2,1
2025-08-02,26,DPD60-89,0,0,0
2025-08-02,26,DPD90+,0,0,0
2025-08-02,32,Current,0,0,0
2025-08-02,32,DPD15-29,51,41,10
2025-08-02,32,DPD3-14,30,27,3
2025-08-02,32,DPD30-59,34,28,6
2025-08-02,32,DPD60-89,0,0,0
2025-08-02,32,DPD90+,0,0,0
2025-08-02,34,Current,0,0,0
2025-08-02,34,DPD15-29,17,13,4
2025-08-02,34,DPD3-14,7,6,1
2025-08-02,34,DPD30-59,7,7,0
2025-08-02,34,DPD60-89,0,0,0
2025-08-02,34,DPD90+,0,0,0
2025-08-02,36,Current,0,0,0
2025-08-02,36,DPD15-29,13,10,3
2025-08-02,36,DPD3-14,9,6,3
2025-08-02,36,DPD30-59,11,11,0
2025-08-02,36,DPD60-89,0,0,0
2025-08-02,36,DPD90+,0,0,0
2025-08-02,38,Current,16,0,16
2025-08-02,38,DPD15-29,20,19,1
2025-08-02,38,DPD3-14,5,4,1
2025-08-02,38,DPD30-59,5,2,3
2025-08-02,38,DPD60-89,0,0,0
2025-08-02,38,DPD90+,0,0,0
2025-08-02,40,Current,0,0,0
2025-08-02,40,DPD15-29,12,9,3
2025-08-02,40,DPD3-14,7,5,2
2025-08-02,40,DPD30-59,11,10,1
2025-08-02,40,DPD60-89,0,0,0
2025-08-02,40,DPD90+,0,0,0
2025-08-02,42,Current,0,0,0
2025-08-02,42,DPD15-29,6,5,1
2025-08-02,42,DPD3-14,3,3,0
2025-08-02,42,DPD30-59,2,2,0
2025-08-02,42,DPD60-89,0,0,0
2025-08-02,42,DPD90+,0,0,0
2025-08-02,44,Current,11,0,11
2025-08-02,44,DPD15-29,15,12,3
2025-08-02,44,DPD3-14,8,7,1
2025-08-02,44,DPD30-59,12,10,2
2025-08-02,44,DPD60-89,0,0,0
2025-08-02,44,DPD90+,0,0,0
2025-08-02,46,Current,0,0,0
2025-08-02,46,DPD15-29,1,0,1
2025-08-02,48,Current,128,5,123
2025-08-02,48,DPD15-29,29,21,8
2025-08-02,48,DPD3-14,15,11,4
2025-08-02,48,DPD30-59,14,10,4
2025-08-02,48,DPD60-89,0,0,0
2025-08-02,48,DPD90+,0,0,0
2025-08-02,54,Current,113,1,112
2025-08-02,56,Current,27,1,26
2025-08-02,56,DPD15-29,2,1,1
2025-08-02,56,DPD3-14,2,1,1
2025-08-02,56,DPD60-89,0,0,0
2025-08-02,6,Current,0,0,0
2025-08-01,102,Current,0,0,0
2025-08-01,104,Current,0,0,0
2025-08-01,20,Current,1,1,0
2025-08-01,20,DPD15-29,96,79,17
2025-08-01,20,DPD3-14,155,114,41
2025-08-01,20,DPD30-59,80,65,15
2025-08-01,20,DPD60-89,0,0,0
2025-08-01,20,DPD90+,0,0,0
2025-08-01,22,DPD3-14,0,0,0
2025-08-01,24,Current,170,4,166
2025-08-01,24,DPD15-29,76,58,18
2025-08-01,24,DPD3-14,121,90,31
2025-08-01,24,DPD30-59,44,36,8
2025-08-01,24,DPD60-89,0,0,0
2025-08-01,24,DPD90+,0,0,0
2025-08-01,26,Current,0,0,0
2025-08-01,26,DPD15-29,11,8,3
2025-08-01,26,DPD3-14,9,5,4
2025-08-01,26,DPD30-59,5,4,1
2025-08-01,26,DPD60-89,0,0,0
2025-08-01,26,DPD90+,0,0,0
2025-08-01,32,Current,0,0,0
2025-08-01,32,DPD15-29,41,32,9
2025-08-01,32,DPD3-14,95,65,30
2025-08-01,32,DPD30-59,27,24,3
2025-08-01,32,DPD60-89,0,0,0
2025-08-01,32,DPD90+,0,0,0
2025-08-01,34,Current,0,0,0
2025-08-01,34,DPD15-29,14,10,4
2025-08-01,34,DPD3-14,20,15,5
2025-08-01,34,DPD30-59,13,12,1
2025-08-01,34,DPD60-89,0,0,0
2025-08-01,34,DPD90+,0,0,0
2025-08-01,36,Current,0,0,0
2025-08-01,36,DPD15-29,14,11,3
2025-08-01,36,DPD3-14,22,18,4
2025-08-01,36,DPD30-59,3,2,1
2025-08-01,36,DPD60-89,0,0,0
2025-08-01,36,DPD90+,0,0,0
2025-08-01,38,Current,16,0,16
2025-08-01,38,DPD15-29,18,16,2
2025-08-01,38,DPD3-14,30,20,10
2025-08-01,38,DPD30-59,8,7,1
2025-08-01,38,DPD60-89,0,0,0
2025-08-01,38,DPD90+,0,0,0
2025-08-01,40,Current,0,0,0
2025-08-01,40,DPD15-29,10,9,1
2025-08-01,40,DPD3-14,13,7,6
2025-08-01,40,DPD30-59,6,5,1
2025-08-01,40,DPD60-89,0,0,0
2025-08-01,40,DPD90+,0,0,0
2025-08-01,42,Current,0,0,0
2025-08-01,42,DPD15-29,4,3,1
2025-08-01,42,DPD3-14,8,5,3
2025-08-01,42,DPD30-59,1,1,0
2025-08-01,42,DPD60-89,0,0,0
2025-08-01,42,DPD90+,0,0,0
2025-08-01,44,Current,1,1,0
2025-08-01,44,DPD15-29,17,14,3
2025-08-01,44,DPD3-14,17,13,4
2025-08-01,44,DPD30-59,10,8,2
2025-08-01,44,DPD60-89,0,0,0
2025-08-01,44,DPD90+,0,0,0
2025-08-01,46,Current,0,0,0
2025-08-01,46,DPD15-29,0,0,0
2025-08-01,48,Current,109,1,108
2025-08-01,48,DPD15-29,23,18,5
2025-08-01,48,DPD3-14,34,23,11
2025-08-01,48,DPD30-59,12,10,2
2025-08-01,48,DPD60-89,0,0,0
2025-08-01,48,DPD90+,0,0,0
2025-08-01,54,Current,62,0,62
2025-08-01,56,Current,28,1,27
2025-08-01,56,DPD15-29,0,0,0
2025-08-01,56,DPD3-14,2,1,1
2025-08-01,56,DPD60-89,0,0,0
2025-08-01,6,Current,0,0,0
2025-07-31,102,Current,0,0,0
2025-07-31,104,Current,0,0,0
2025-07-31,20,Current,0,0,0
2025-07-31,20,DPD15-29,145,112,33
2025-07-31,20,DPD3-14,148,116,32
2025-07-31,20,DPD30-59,60,50,10
2025-07-31,20,DPD60-89,0,0,0
2025-07-31,20,DPD90+,0,0,0
2025-07-31,22,DPD3-14,0,0,0
2025-07-31,24,Current,197,8,189
2025-07-31,24,DPD15-29,88,72,16
2025-07-31,24,DPD3-14,104,79,25
2025-07-31,24,DPD30-59,42,31,11
2025-07-31,24,DPD60-89,0,0,0
2025-07-31,24,DPD90+,0,0,0
2025-07-31,26,Current,0,0,0
2025-07-31,26,DPD15-29,11,10,1
2025-07-31,26,DPD3-14,6,6,0
2025-07-31,26,DPD30-59,3,2,1
2025-07-31,26,DPD60-89,0,0,0
2025-07-31,26,DPD90+,0,0,0
2025-07-31,32,Current,0,0,0
2025-07-31,32,DPD15-29,68,51,17
2025-07-31,32,DPD3-14,68,51,17
2025-07-31,32,DPD30-59,36,31,5
2025-07-31,32,DPD60-89,0,0,0
2025-07-31,32,DPD90+,0,0,0
2025-07-31,34,Current,0,0,0
2025-07-31,34,DPD15-29,19,16,3
2025-07-31,34,DPD3-14,19,17,2
2025-07-31,34,DPD30-59,7,7,0
2025-07-31,34,DPD60-89,0,0,0
2025-07-31,34,DPD90+,0,0,0
2025-07-31,36,Current,0,0,0
2025-07-31,36,DPD15-29,21,16,5
2025-07-31,36,DPD3-14,18,12,6
2025-07-31,36,DPD30-59,8,8,0
2025-07-31,36,DPD60-89,0,0,0
2025-07-31,36,DPD90+,0,0,0
2025-07-31,38,Current,9,0,9
2025-07-31,38,DPD15-29,31,26,5
2025-07-31,38,DPD3-14,18,15,3
2025-07-31,38,DPD30-59,5,2,3
2025-07-31,38,DPD60-89,0,0,0
2025-07-31,38,DPD90+,0,0,0
2025-07-31,40,Current,0,0,0
2025-07-31,40,DPD15-29,17,14,3
2025-07-31,40,DPD3-14,18,11,7
2025-07-31,40,DPD30-59,10,9,1
2025-07-31,40,DPD60-89,0,0,0
2025-07-31,40,DPD90+,0,0,0
2025-07-31,42,Current,0,0,0
2025-07-31,42,DPD15-29,11,9,2
2025-07-31,42,DPD3-14,5,3,2
2025-07-31,42,DPD30-59,2,2,0
2025-07-31,42,DPD60-89,0,0,0
2025-07-31,42,DPD90+,0,0,0
2025-07-31,44,Current,1,1,0
2025-07-31,44,DPD15-29,18,13,5
2025-07-31,44,DPD3-14,12,9,3
2025-07-31,44,DPD30-59,9,8,1
2025-07-31,44,DPD60-89,0,0,0
2025-07-31,44,DPD90+,0,0,0
2025-07-31,46,Current,0,0,0
2025-07-31,46,DPD15-29,2,1,1
2025-07-31,48,Current,128,7,121
2025-07-31,48,DPD15-29,29,20,9
2025-07-31,48,DPD3-14,37,28,9
2025-07-31,48,DPD30-59,16,12,4
2025-07-31,48,DPD60-89,0,0,0
2025-07-31,48,DPD90+,0,0,0
2025-07-31,54,Current,105,4,101
2025-07-31,56,Current,34,0,34
2025-07-31,56,DPD15-29,2,1,1
2025-07-31,56,DPD3-14,3,1,2
2025-07-31,56,DPD60-89,0,0,0
2025-07-31,6,Current,0,0,0
2025-07-30,102,Current,0,0,0
2025-07-30,104,Current,0,0,0
2025-07-30,20,Current,1,1,0
2025-07-30,20,DPD15-29,92,76,16
2025-07-30,20,DPD3-14,79,59,20
2025-07-30,20,DPD30-59,87,70,17
2025-07-30,20,DPD60-89,0,0,0
2025-07-30,20,DPD90+,0,0,0
2025-07-30,22,DPD3-14,0,0,0
2025-07-30,24,Current,115,1,114
2025-07-30,24,DPD15-29,65,47,18
2025-07-30,24,DPD3-14,56,39,17
2025-07-30,24,DPD30-59,46,37,9
2025-07-30,24,DPD60-89,0,0,0
2025-07-30,24,DPD90+,0,0,0
2025-07-30,26,Current,0,0,0
2025-07-30,26,DPD15-29,9,7,2
2025-07-30,26,DPD3-14,8,5,3
2025-07-30,26,DPD30-59,6,4,2
2025-07-30,26,DPD60-89,0,0,0
2025-07-30,26,DPD90+,0,0,0
2025-07-30,32,Current,0,0,0
2025-07-30,32,DPD15-29,36,29,7
2025-07-30,32,DPD3-14,44,31,13
2025-07-30,32,DPD30-59,25,20,5
2025-07-30,32,DPD60-89,0,0,0
2025-07-30,32,DPD90+,0,0,0
2025-07-30,34,Current,0,0,0
2025-07-30,34,DPD15-29,11,7,4
2025-07-30,34,DPD3-14,11,11,0
2025-07-30,34,DPD30-59,13,11,2
2025-07-30,34,DPD60-89,0,0,0
2025-07-30,34,DPD90+,0,0,0
2025-07-30,36,Current,0,0,0
2025-07-30,36,DPD15-29,9,6,3
2025-07-30,36,DPD3-14,9,7,2
2025-07-30,36,DPD30-59,3,2,1
2025-07-30,36,DPD60-89,0,0,0
2025-07-30,36,DPD90+,0,0,0
2025-07-30,38,Current,9,0,9
2025-07-30,38,DPD15-29,19,17,2
2025-07-30,38,DPD3-14,21,13,8
2025-07-30,38,DPD30-59,7,6,1
2025-07-30,38,DPD60-89,0,0,0
2025-07-30,38,DPD90+,0,0,0
2025-07-30,40,Current,0,0,0
2025-07-30,40,DPD15-29,7,6,1
2025-07-30,40,DPD3-14,7,5,2
2025-07-30,40,DPD30-59,8,6,2
2025-07-30,40,DPD60-89,0,0,0
2025-07-30,40,DPD90+,0,0,0
2025-07-30,42,Current,0,0,0
2025-07-30,42,DPD15-29,4,3,1
2025-07-30,42,DPD3-14,4,4,0
2025-07-30,42,DPD30-59,1,1,0
2025-07-30,42,DPD60-89,0,0,0
2025-07-30,42,DPD90+,0,0,0
2025-07-30,44,Current,0,0,0
2025-07-30,44,DPD15-29,13,10,3
2025-07-30,44,DPD3-14,12,9,3
2025-07-30,44,DPD30-59,12,10,2
2025-07-30,44,DPD60-89,0,0,0
2025-07-30,44,DPD90+,0,0,0
2025-07-30,46,Current,0,0,0
2025-07-30,46,DPD15-29,0,0,0
2025-07-30,48,Current,67,2,65
2025-07-30,48,DPD15-29,18,16,2
2025-07-30,48,DPD3-14,24,18,6
2025-07-30,48,DPD30-59,14,10,4
2025-07-30,48,DPD60-89,0,0,0
2025-07-30,48,DPD90+,0,0,0
2025-07-30,54,Current,38,0,38
2025-07-30,56,Current,0,0,0
2025-07-30,56,DPD15-29,2,1,1
2025-07-30,56,DPD3-14,1,0,1
2025-07-30,56,DPD60-89,0,0,0
2025-07-30,6,Current,0,0,0
2025-07-29,102,Current,0,0,0
2025-07-29,104,Current,0,0,0
2025-07-29,20,Current,0,0,0
2025-07-29,20,DPD15-29,93,64,29
2025-07-29,20,DPD3-14,96,76,20
2025-07-29,20,DPD30-59,47,37,10
2025-07-29,20,DPD60-89,0,0,0
2025-07-29,20,DPD90+,0,0,0
2025-07-29,22,DPD3-14,0,0,0
2025-07-29,24,Current,1976,1871,105
2025-07-29,24,DPD15-29,64,50,14
2025-07-29,24,DPD3-14,80,64,16
2025-07-29,24,DPD30-59,42,31,11
2025-07-29,24,DPD60-89,0,0,0
2025-07-29,24,DPD90+,0,0,0
2025-07-29,26,Current,0,0,0
2025-07-29,26,DPD15-29,8,7,1
2025-07-29,26,DPD3-14,4,2,2
2025-07-29,26,DPD30-59,2,2,0
2025-07-29,26,DPD60-89,0,0,0
2025-07-29,26,DPD90+,0,0,0
2025-07-29,32,Current,0,0,0
2025-07-29,32,DPD15-29,46,33,13
2025-07-29,32,DPD3-14,48,36,12
2025-07-29,32,DPD30-59,24,20,4
2025-07-29,32,DPD60-89,0,0,0
2025-07-29,32,DPD90+,0,0,0
2025-07-29,34,Current,0,0,0
2025-07-29,34,DPD15-29,12,8,4
2025-07-29,34,DPD3-14,20,17,3
2025-07-29,34,DPD30-59,7,7,0
2025-07-29,34,DPD60-89,0,0,0
2025-07-29,34,DPD90+,0,0,0
2025-07-29,36,Current,0,0,0
2025-07-29,36,DPD15-29,11,8,3
2025-07-29,36,DPD3-14,8,5,3
2025-07-29,36,DPD30-59,7,7,0
2025-07-29,36,DPD60-89,0,0,0
2025-07-29,36,DPD90+,0,0,0
2025-07-29,38,Current,245,239,6
2025-07-29,38,DPD15-29,26,21,5
2025-07-29,38,DPD3-14,24,17,7
2025-07-29,38,DPD30-59,4,2,2
2025-07-29,38,DPD60-89,0,0,0
2025-07-29,38,DPD90+,0,0,0
2025-07-29,40,Current,0,0,0
2025-07-29,40,DPD15-29,7,6,1
2025-07-29,40,DPD3-14,11,7,4
2025-07-29,40,DPD30-59,8,7,1
2025-07-29,40,DPD60-89,0,0,0
2025-07-29,40,DPD90+,0,0,0
2025-07-29,42,Current,0,0,0
2025-07-29,42,DPD15-29,7,5,2
2025-07-29,42,DPD3-14,5,4,1
2025-07-29,42,DPD30-59,1,1,0
2025-07-29,42,DPD60-89,0,0,0
2025-07-29,42,DPD90+,0,0,0
2025-07-29,44,Current,588,588,0
2025-07-29,44,DPD15-29,10,6,4
2025-07-29,44,DPD3-14,22,20,2
2025-07-29,44,DPD30-59,7,6,1
2025-07-29,44,DPD60-89,0,0,0
2025-07-29,44,DPD90+,0,0,0
2025-07-29,46,Current,0,0,0
2025-07-29,46,DPD15-29,1,1,0
2025-07-29,46,DPD3-14,0,0,0
2025-07-29,48,Current,623,549,74
2025-07-29,48,DPD15-29,25,17,8
2025-07-29,48,DPD3-14,22,18,4
2025-07-29,48,DPD30-59,13,9,4
2025-07-29,48,DPD60-89,0,0,0
2025-07-29,48,DPD90+,0,0,0
2025-07-29,54,Current,73,0,73
2025-07-29,56,Current,251,248,3
2025-07-29,56,DPD15-29,2,1,1
2025-07-29,56,DPD3-14,7,5,2
2025-07-29,56,DPD60-89,0,0,0
2025-07-29,6,Current,0,0,0
2025-07-28,102,Current,0,0,0
2025-07-28,104,Current,0,0,0
2025-07-28,20,Current,1,1,0
2025-07-28,20,DPD15-29,107,89,18
2025-07-28,20,DPD3-14,79,64,15
2025-07-28,20,DPD30-59,85,70,15
2025-07-28,20,DPD60-89,0,0,0
2025-07-28,20,DPD90+,0,0,0
2025-07-28,22,DPD3-14,0,0,0
2025-07-28,24,Current,148,3,145
2025-07-28,24,DPD15-29,76,53,23
2025-07-28,24,DPD3-14,63,46,17
2025-07-28,24,DPD30-59,44,35,9
2025-07-28,24,DPD60-89,0,0,0
2025-07-28,24,DPD90+,0,0,0
2025-07-28,26,Current,0,0,0
2025-07-28,26,DPD15-29,11,7,4
2025-07-28,26,DPD3-14,7,6,1
2025-07-28,26,DPD30-59,6,4,2
2025-07-28,26,DPD60-89,0,0,0
2025-07-28,26,DPD90+,0,0,0
2025-07-28,32,Current,0,0,0
2025-07-28,32,DPD15-29,45,33,12
2025-07-28,32,DPD3-14,43,38,5
2025-07-28,32,DPD30-59,21,16,5
2025-07-28,32,DPD60-89,0,0,0
2025-07-28,32,DPD90+,0,0,0
2025-07-28,34,Current,0,0,0
2025-07-28,34,DPD15-29,8,5,3
2025-07-28,34,DPD3-14,14,10,4
2025-07-28,34,DPD30-59,12,10,2
2025-07-28,34,DPD60-89,0,0,0
2025-07-28,34,DPD90+,0,0,0
2025-07-28,36,Current,0,0,0
2025-07-28,36,DPD15-29,9,5,4
2025-07-28,36,DPD3-14,6,2,4
2025-07-28,36,DPD30-59,3,2,1
2025-07-28,36,DPD60-89,0,0,0
2025-07-28,36,DPD90+,0,0,0
2025-07-28,38,Current,15,4,11
2025-07-28,38,DPD15-29,20,17,3
2025-07-28,38,DPD3-14,18,13,5
2025-07-28,38,DPD30-59,7,6,1
2025-07-28,38,DPD60-89,0,0,0
2025-07-28,38,DPD90+,0,0,0
2025-07-28,40,Current,0,0,0
2025-07-28,40,DPD15-29,8,7,1
2025-07-28,40,DPD3-14,9,6,3
2025-07-28,40,DPD30-59,8,6,2
2025-07-28,40,DPD60-89,0,0,0
2025-07-28,40,DPD90+,0,0,0
2025-07-28,42,Current,0,0,0
2025-07-28,42,DPD15-29,5,3,2
2025-07-28,42,DPD3-14,5,5,0
2025-07-28,42,DPD30-59,1,1,0
2025-07-28,42,DPD60-89,0,0,0
2025-07-28,42,DPD90+,0,0,0
2025-07-28,44,Current,1,1,0
2025-07-28,44,DPD15-29,16,13,3
2025-07-28,44,DPD3-14,12,9,3
2025-07-28,44,DPD30-59,12,10,2
2025-07-28,44,DPD60-89,0,0,0
2025-07-28,44,DPD90+,0,0,0
2025-07-28,46,Current,0,0,0
2025-07-28,46,DPD15-29,0,0,0
2025-07-28,46,DPD3-14,0,0,0
2025-07-28,48,Current,93,6,87
2025-07-28,48,DPD15-29,21,17,4
2025-07-28,48,DPD3-14,22,17,5
2025-07-28,48,DPD30-59,14,10,4
2025-07-28,48,DPD60-89,0,0,0
2025-07-28,48,DPD90+,0,0,0
2025-07-28,54,Current,59,2,57
2025-07-28,56,Current,0,0,0
2025-07-28,56,DPD15-29,2,1,1
2025-07-28,56,DPD3-14,0,0,0
2025-07-28,56,DPD60-89,0,0,0
2025-07-28,6,Current,0,0,0
2025-07-27,102,Current,0,0,0
2025-07-27,104,Current,0,0,0
2025-07-27,20,Current,0,0,0
2025-07-27,20,DPD15-29,97,68,29
2025-07-27,20,DPD3-14,96,71,25
2025-07-27,20,DPD30-59,40,31,9
2025-07-27,20,DPD60-89,0,0,0
2025-07-27,20,DPD90+,0,0,0
2025-07-27,22,DPD3-14,0,0,0
2025-07-27,24,Current,69,1,68
2025-07-27,24,DPD15-29,60,46,14
2025-07-27,24,DPD3-14,78,58,20
2025-07-27,24,DPD30-59,32,23,9
2025-07-27,24,DPD60-89,0,0,0
2025-07-27,24,DPD90+,0,0,0
2025-07-27,26,Current,0,0,0
2025-07-27,26,DPD15-29,7,6,1
2025-07-27,26,DPD3-14,5,3,2
2025-07-27,26,DPD30-59,1,1,0
2025-07-27,26,DPD60-89,0,0,0
2025-07-27,26,DPD90+,0,0,0
2025-07-27,32,Current,0,0,0
2025-07-27,32,DPD15-29,50,37,13
2025-07-27,32,DPD3-14,55,43,12
2025-07-27,32,DPD30-59,23,20,3
2025-07-27,32,DPD60-89,0,0,0
2025-07-27,32,DPD90+,0,0,0
2025-07-27,34,Current,0,0,0
2025-07-27,34,DPD15-29,12,8,4
2025-07-27,34,DPD3-14,21,19,2
2025-07-27,34,DPD30-59,7,7,0
2025-07-27,34,DPD60-89,0,0,0
2025-07-27,34,DPD90+,0,0,0
2025-07-27,36,Current,0,0,0
2025-07-27,36,DPD15-29,13,9,4
2025-07-27,36,DPD3-14,13,10,3
2025-07-27,36,DPD30-59,6,6,0
2025-07-27,36,DPD60-89,0,0,0
2025-07-27,36,DPD90+,0,0,0
2025-07-27,38,Current,5,0,5
2025-07-27,38,DPD15-29,25,20,5
2025-07-27,38,DPD3-14,25,19,6
2025-07-27,38,DPD30-59,3,2,1
2025-07-27,38,DPD60-89,0,0,0
2025-07-27,38,DPD90+,0,0,0
2025-07-27,40,Current,0,0,0
2025-07-27,40,DPD15-29,7,6,1
2025-07-27,40,DPD3-14,9,8,1
2025-07-27,40,DPD30-59,6,5,1
2025-07-27,40,DPD60-89,0,0,0
2025-07-27,40,DPD90+,0,0,0
2025-07-27,42,Current,0,0,0
2025-07-27,42,DPD15-29,6,4,2
2025-07-27,42,DPD3-14,5,4,1
2025-07-27,42,DPD30-59,1,1,0
2025-07-27,42,DPD60-89,0,0,0
2025-07-27,42,DPD90+,0,0,0
2025-07-27,44,Current,0,0,0
2025-07-27,44,DPD15-29,12,7,5
2025-07-27,44,DPD3-14,16,12,4
2025-07-27,44,DPD30-59,4,3,1
2025-07-27,44,DPD60-89,0,0,0
2025-07-27,44,DPD90+,0,0,0
2025-07-27,46,Current,0,0,0
2025-07-27,46,DPD15-29,1,1,0
2025-07-27,46,DPD3-14,0,0,0
2025-07-27,48,Current,49,1,48
2025-07-27,48,DPD15-29,27,18,9
2025-07-27,48,DPD3-14,27,19,8
2025-07-27,48,DPD30-59,12,8,4
2025-07-27,48,DPD60-89,0,0,0
2025-07-27,48,DPD90+,0,0,0
2025-07-27,54,Current,42,0,42
2025-07-27,56,Current,0,0,0
2025-07-27,56,DPD15-29,0,0,0
2025-07-27,56,DPD3-14,4,2,2
2025-07-27,56,DPD60-89,0,0,0
2025-07-27,6,Current,0,0,0
2025-07-26,102,Current,0,0,0
2025-07-26,104,Current,0,0,0
2025-07-26,20,Current,0,0,0
2025-07-26,20,DPD15-29,103,82,21
2025-07-26,20,DPD3-14,171,142,29
2025-07-26,20,DPD30-59,86,70,16
2025-07-26,20,DPD60-89,0,0,0
2025-07-26,20,DPD90+,0,0,0
2025-07-26,22,DPD3-14,0,0,0
2025-07-26,24,Current,127,4,123
2025-07-26,24,DPD15-29,70,52,18
2025-07-26,24,DPD3-14,108,91,17
2025-07-26,24,DPD30-59,46,39,7
2025-07-26,24,DPD60-89,0,0,0
2025-07-26,24,DPD90+,0,0,0
2025-07-26,26,Current,0,0,0
2025-07-26,26,DPD15-29,11,7,4
2025-07-26,26,DPD3-14,12,11,1
2025-07-26,26,DPD30-59,7,5,2
2025-07-26,26,DPD60-89,0,0,0
2025-07-26,26,DPD90+,0,0,0
2025-07-26,32,Current,0,0,0
2025-07-26,32,DPD15-29,53,41,12
2025-07-26,32,DPD3-14,71,62,9
2025-07-26,32,DPD30-59,31,23,8
2025-07-26,32,DPD60-89,0,0,0
2025-07-26,32,DPD90+,0,0,0
2025-07-26,34,Current,0,0,0
2025-07-26,34,DPD15-29,12,8,4
2025-07-26,34,DPD3-14,18,14,4
2025-07-26,34,DPD30-59,17,14,3
2025-07-26,34,DPD60-89,0,0,0
2025-07-26,34,DPD90+,0,0,0
2025-07-26,36,Current,0,0,0
2025-07-26,36,DPD15-29,8,4,4
2025-07-26,36,DPD3-14,19,13,6
2025-07-26,36,DPD30-59,4,2,2
2025-07-26,36,DPD60-89,0,0,0
2025-07-26,36,DPD90+,0,0,0
2025-07-26,38,Current,7,0,7
2025-07-26,38,DPD15-29,17,15,2
2025-07-26,38,DPD3-14,27,23,4
2025-07-26,38,DPD30-59,7,6,1
2025-07-26,38,DPD60-89,0,0,0
2025-07-26,38,DPD90+,0,0,0
2025-07-26,40,Current,0,0,0
2025-07-26,40,DPD15-29,11,10,1
2025-07-26,40,DPD3-14,22,19,3
2025-07-26,40,DPD30-59,7,5,2
2025-07-26,40,DPD60-89,0,0,0
2025-07-26,40,DPD90+,0,0,0
2025-07-26,42,Current,0,0,0
2025-07-26,42,DPD15-29,5,3,2
2025-07-26,42,DPD3-14,9,8,1
2025-07-26,42,DPD30-59,2,1,1
2025-07-26,42,DPD60-89,0,0,0
2025-07-26,42,DPD90+,0,0,0
2025-07-26,44,Current,1,1,0
2025-07-26,44,DPD15-29,16,13,3
2025-07-26,44,DPD3-14,18,15,3
2025-07-26,44,DPD30-59,14,12,2
2025-07-26,44,DPD60-89,0,0,0
2025-07-26,44,DPD90+,0,0,0
2025-07-26,46,Current,0,0,0
2025-07-26,46,DPD15-29,0,0,0
2025-07-26,46,DPD3-14,1,0,1
2025-07-26,48,Current,74,2,72
2025-07-26,48,DPD15-29,17,13,4
2025-07-26,48,DPD3-14,30,25,5
2025-07-26,48,DPD30-59,13,10,3
2025-07-26,48,DPD60-89,0,0,0
2025-07-26,48,DPD90+,0,0,0
2025-07-26,54,Current,47,0,47
2025-07-26,56,Current,0,0,0
2025-07-26,56,DPD15-29,3,2,1
2025-07-26,56,DPD3-14,1,1,0
2025-07-26,56,DPD60-89,0,0,0
2025-07-26,6,Current,0,0,0
2025-07-25,102,Current,0,0,0
2025-07-25,104,Current,0,0,0
2025-07-25,20,Current,0,0,0
2025-07-25,20,DPD15-29,110,82,28
2025-07-25,20,DPD3-14,87,66,21
2025-07-25,20,DPD30-59,38,30,8
2025-07-25,20,DPD60-89,0,0,0
2025-07-25,20,DPD90+,0,0,0
2025-07-25,22,DPD3-14,0,0,0
2025-07-25,24,Current,105,2,103
2025-07-25,24,DPD15-29,71,59,12
2025-07-25,24,DPD3-14,72,60,12
2025-07-25,24,DPD30-59,33,24,9
2025-07-25,24,DPD60-89,0,0,0
2025-07-25,24,DPD90+,0,0,0
2025-07-25,26,Current,0,0,0
2025-07-25,26,DPD15-29,7,6,1
2025-07-25,26,DPD3-14,12,6,6
2025-07-25,26,DPD30-59,0,0,0
2025-07-25,26,DPD60-89,0,0,0
2025-07-25,26,DPD90+,0,0,0
2025-07-25,32,Current,0,0,0
2025-07-25,32,DPD15-29,56,45,11
2025-07-25,32,DPD3-14,39,36,3
2025-07-25,32,DPD30-59,22,18,4
2025-07-25,32,DPD60-89,0,0,0
2025-07-25,32,DPD90+,0,0,0
2025-07-25,34,Current,0,0,0
2025-07-25,34,DPD15-29,19,12,7
2025-07-25,34,DPD3-14,18,15,3
2025-07-25,34,DPD30-59,10,8,2
2025-07-25,34,DPD60-89,0,0,0
2025-07-25,34,DPD90+,0,0,0
2025-07-25,36,Current,0,0,0
2025-07-25,36,DPD15-29,14,10,4
2025-07-25,36,DPD3-14,9,4,5
2025-07-25,36,DPD30-59,4,4,0
2025-07-25,36,DPD60-89,0,0,0
2025-07-25,36,DPD90+,0,0,0
2025-07-25,38,Current,6,1,5
2025-07-25,38,DPD15-29,26,22,4
2025-07-25,38,DPD3-14,26,22,4
2025-07-25,38,DPD30-59,5,4,1
2025-07-25,38,DPD60-89,0,0,0
2025-07-25,38,DPD90+,0,0,0
2025-07-25,40,Current,0,0,0
2025-07-25,40,DPD15-29,9,8,1
2025-07-25,40,DPD3-14,7,4,3
2025-07-25,40,DPD30-59,5,3,2
2025-07-25,40,DPD60-89,0,0,0
2025-07-25,40,DPD90+,0,0,0
2025-07-25,42,Current,0,0,0
2025-07-25,42,DPD15-29,7,5,2
2025-07-25,42,DPD3-14,2,1,1
2025-07-25,42,DPD30-59,1,1,0
2025-07-25,42,DPD60-89,0,0,0
2025-07-25,42,DPD90+,0,0,0
2025-07-25,44,Current,1,1,0
2025-07-25,44,DPD15-29,12,7,5
2025-07-25,44,DPD3-14,13,11,2
2025-07-25,44,DPD30-59,1,0,1
2025-07-25,44,DPD60-89,0,0,0
2025-07-25,44,DPD90+,0,0,0
2025-07-25,46,Current,0,0,0
2025-07-25,46,DPD15-29,1,1,0
2025-07-25,46,DPD3-14,0,0,0
2025-07-25,48,Current,70,5,65
2025-07-25,48,DPD15-29,27,20,7
2025-07-25,48,DPD3-14,26,19,7
2025-07-25,48,DPD30-59,14,9,5
2025-07-25,48,DPD60-89,0,0,0
2025-07-25,48,DPD90+,0,0,0
2025-07-25,54,Current,62,2,60
2025-07-25,56,Current,0,0,0
2025-07-25,56,DPD15-29,0,0,0
2025-07-25,56,DPD3-14,4,3,1
2025-07-25,56,DPD60-89,0,0,0
2025-07-25,6,Current,0,0,0
2025-07-24,102,Current,0,0,0
2025-07-24,104,Current,0,0,0
2025-07-24,20,Current,0,0,0
2025-07-24,20,DPD15-29,112,87,25
2025-07-24,20,DPD3-14,125,104,21
2025-07-24,20,DPD30-59,80,66,14
2025-07-24,20,DPD60-89,0,0,0
2025-07-24,20,DPD90+,0,0,0
2025-07-24,22,DPD3-14,0,0,0
2025-07-24,24,Current,131,12,119
2025-07-24,24,DPD15-29,65,50,15
2025-07-24,24,DPD3-14,99,81,18
2025-07-24,24,DPD30-59,44,39,5
2025-07-24,24,DPD60-89,0,0,0
2025-07-24,24,DPD90+,0,0,0
2025-07-24,26,Current,0,0,0
2025-07-24,26,DPD15-29,12,8,4
2025-07-24,26,DPD3-14,11,9,2
2025-07-24,26,DPD30-59,6,4,2
2025-07-24,26,DPD60-89,0,0,0
2025-07-24,26,DPD90+,0,0,0
2025-07-24,32,Current,0,0,0
2025-07-24,32,DPD15-29,62,49,13
2025-07-24,32,DPD3-14,61,51,10
2025-07-24,32,DPD30-59,22,17,5
2025-07-24,32,DPD60-89,0,0,0
2025-07-24,32,DPD90+,0,0,0
2025-07-24,34,Current,0,0,0
2025-07-24,34,DPD15-29,16,13,3
2025-07-24,34,DPD3-14,15,11,4
2025-07-24,34,DPD30-59,13,10,3
2025-07-24,34,DPD60-89,0,0,0
2025-07-24,34,DPD90+,0,0,0
2025-07-24,36,Current,0,0,0
2025-07-24,36,DPD15-29,8,4,4
2025-07-24,36,DPD3-14,15,12,3
2025-07-24,36,DPD30-59,3,2,1
2025-07-24,36,DPD60-89,0,0,0
2025-07-24,36,DPD90+,0,0,0
2025-07-24,38,Current,11,3,8
2025-07-24,38,DPD15-29,20,17,3
2025-07-24,38,DPD3-14,22,16,6
2025-07-24,38,DPD30-59,7,6,1
2025-07-24,38,DPD60-89,0,0,0
2025-07-24,38,DPD90+,0,0,0
2025-07-24,40,Current,0,0,0
2025-07-24,40,DPD15-29,10,9,1
2025-07-24,40,DPD3-14,9,7,2
2025-07-24,40,DPD30-59,7,6,1
2025-07-24,40,DPD60-89,0,0,0
2025-07-24,40,DPD90+,0,0,0
2025-07-24,42,Current,0,0,0
2025-07-24,42,DPD15-29,4,2,2
2025-07-24,42,DPD3-14,4,3,1
2025-07-24,42,DPD30-59,1,0,1
2025-07-24,42,DPD60-89,0,0,0
2025-07-24,42,DPD90+,0,0,0
2025-07-24,44,Current,2,0,2
2025-07-24,44,DPD15-29,12,10,2
2025-07-24,44,DPD3-14,12,9,3
2025-07-24,44,DPD30-59,8,6,2
2025-07-24,44,DPD60-89,0,0,0
2025-07-24,44,DPD90+,0,0,0
2025-07-24,46,Current,0,0,0
2025-07-24,46,DPD15-29,0,0,0
2025-07-24,46,DPD3-14,0,0,0
2025-07-24,48,Current,80,9,71
2025-07-24,48,DPD15-29,15,11,4
2025-07-24,48,DPD3-14,33,26,7
2025-07-24,48,DPD30-59,13,10,3
2025-07-24,48,DPD60-89,0,0,0
2025-07-24,48,DPD90+,0,0,0
2025-07-24,54,Current,35,2,33
2025-07-24,56,Current,26,2,24
2025-07-24,56,DPD15-29,2,2,0
2025-07-24,56,DPD3-14,2,1,1
2025-07-24,56,DPD60-89,0,0,0
2025-07-24,6,Current,0,0,0
2025-07-23,102,Current,0,0,0
2025-07-23,104,Current,0,0,0
2025-07-23,20,Current,0,0,0
2025-07-23,20,DPD15-29,113,83,30
2025-07-23,20,DPD3-14,78,67,11
2025-07-23,20,DPD30-59,49,41,8
2025-07-23,20,DPD60-89,0,0,0
2025-07-23,20,DPD90+,0,0,0
2025-07-23,22,DPD3-14,0,0,0
2025-07-23,24,Current,36,2,34
2025-07-23,24,DPD15-29,76,62,14
2025-07-23,24,DPD3-14,69,51,18
2025-07-23,24,DPD30-59,34,25,9
2025-07-23,24,DPD60-89,0,0,0
2025-07-23,24,DPD90+,0,0,0
2025-07-23,26,Current,0,0,0
2025-07-23,26,DPD15-29,7,6,1
2025-07-23,26,DPD3-14,6,5,1
2025-07-23,26,DPD30-59,0,0,0
2025-07-23,26,DPD60-89,0,0,0
2025-07-23,26,DPD90+,0,0,0
2025-07-23,32,Current,0,0,0
2025-07-23,32,DPD15-29,69,56,13
2025-07-23,32,DPD3-14,29,24,5
2025-07-23,32,DPD30-59,18,14,4
2025-07-23,32,DPD60-89,0,0,0
2025-07-23,32,DPD90+,0,0,0
2025-07-23,34,Current,0,0,0
2025-07-23,34,DPD15-29,23,15,8
2025-07-23,34,DPD3-14,15,13,2
2025-07-23,34,DPD30-59,12,9,3
2025-07-23,34,DPD60-89,0,0,0
2025-07-23,34,DPD90+,0,0,0
2025-07-23,36,Current,0,0,0
2025-07-23,36,DPD15-29,13,8,5
2025-07-23,36,DPD3-14,4,3,1
2025-07-23,36,DPD30-59,4,4,0
2025-07-23,36,DPD60-89,0,0,0
2025-07-23,36,DPD90+,0,0,0
2025-07-23,38,Current,8,0,8
2025-07-23,38,DPD15-29,26,22,4
2025-07-23,38,DPD3-14,10,7,3
2025-07-23,38,DPD30-59,9,6,3
2025-07-23,38,DPD60-89,0,0,0
2025-07-23,38,DPD90+,0,0,0
2025-07-23,40,Current,0,0,0
2025-07-23,40,DPD15-29,9,9,0
2025-07-23,40,DPD3-14,4,3,1
2025-07-23,40,DPD30-59,6,3,3
2025-07-23,40,DPD60-89,0,0,0
2025-07-23,40,DPD90+,0,0,0
2025-07-23,42,Current,0,0,0
2025-07-23,42,DPD15-29,8,6,2
2025-07-23,42,DPD3-14,2,2,0
2025-07-23,42,DPD30-59,1,1,0
2025-07-23,42,DPD60-89,0,0,0
2025-07-23,42,DPD90+,0,0,0
2025-07-23,44,Current,0,0,0
2025-07-23,44,DPD15-29,12,7,5
2025-07-23,44,DPD3-14,11,9,2
2025-07-23,44,DPD30-59,2,1,1
2025-07-23,44,DPD60-89,0,0,0
2025-07-23,44,DPD90+,0,0,0
2025-07-23,46,Current,0,0,0
2025-07-23,46,DPD15-29,1,1,0
2025-07-23,46,DPD3-14,0,0,0
2025-07-23,48,Current,21,0,21
2025-07-23,48,DPD15-29,27,19,8
2025-07-23,48,DPD3-14,24,19,5
2025-07-23,48,DPD30-59,12,7,5
2025-07-23,48,DPD60-89,0,0,0
2025-07-23,48,DPD90+,0,0,0
2025-07-23,54,Current,26,2,24
2025-07-23,56,Current,0,0,0
2025-07-23,56,DPD15-29,0,0,0
2025-07-23,56,DPD3-14,0,0,0
2025-07-23,56,DPD60-89,0,0,0
2025-07-23,6,Current,0,0,0
2025-07-22,102,Current,0,0,0
2025-07-22,104,Current,0,0,0
2025-07-22,20,Current,8,1,7
2025-07-22,20,DPD15-29,106,83,23
2025-07-22,20,DPD3-14,81,59,22
2025-07-22,20,DPD30-59,78,66,12
2025-07-22,20,DPD60-89,0,0,0
2025-07-22,20,DPD90+,0,0,0
2025-07-22,22,DPD3-14,0,0,0
2025-07-22,24,Current,58,15,43
2025-07-22,24,DPD15-29,67,50,17
2025-07-22,24,DPD3-14,65,50,15
2025-07-22,24,DPD30-59,42,37,5
2025-07-22,24,DPD60-89,1,1,0
2025-07-22,24,DPD90+,0,0,0
2025-07-22,26,Current,2,0,2
2025-07-22,26,DPD15-29,11,7,4
2025-07-22,26,DPD3-14,8,5,3
2025-07-22,26,DPD30-59,5,3,2
2025-07-22,26,DPD60-89,0,0,0
2025-07-22,26,DPD90+,0,0,0
2025-07-22,32,Current,12,4,8
2025-07-22,32,DPD15-29,62,45,17
2025-07-22,32,DPD3-14,50,34,16
2025-07-22,32,DPD30-59,25,20,5
2025-07-22,32,DPD60-89,0,0,0
2025-07-22,32,DPD90+,0,0,0
2025-07-22,34,Current,0,0,0
2025-07-22,34,DPD15-29,19,17,2
2025-07-22,34,DPD3-14,16,14,2
2025-07-22,34,DPD30-59,14,10,4
2025-07-22,34,DPD60-89,0,0,0
2025-07-22,34,DPD90+,0,0,0
2025-07-22,36,Current,0,0,0
2025-07-22,36,DPD15-29,9,6,3
2025-07-22,36,DPD3-14,11,10,1
2025-07-22,36,DPD30-59,4,3,1
2025-07-22,36,DPD60-89,0,0,0
2025-07-22,36,DPD90+,0,0,0
2025-07-22,38,Current,5,2,3
2025-07-22,38,DPD15-29,20,16,4
2025-07-22,38,DPD3-14,12,10,2
2025-07-22,38,DPD30-59,8,7,1
2025-07-22,38,DPD60-89,0,0,0
2025-07-22,38,DPD90+,0,0,0
2025-07-22,40,Current,3,1,2
2025-07-22,40,DPD15-29,8,7,1
2025-07-22,40,DPD3-14,9,7,2
2025-07-22,40,DPD30-59,7,6,1
2025-07-22,40,DPD60-89,0,0,0
2025-07-22,40,DPD90+,0,0,0
2025-07-22,42,Current,0,0,0
2025-07-22,42,DPD15-29,4,2,2
2025-07-22,42,DPD3-14,3,1,2
2025-07-22,42,DPD30-59,1,0,1
2025-07-22,42,DPD60-89,0,0,0
2025-07-22,42,DPD90+,0,0,0
2025-07-22,44,Current,4,1,3
2025-07-22,44,DPD15-29,13,11,2
2025-07-22,44,DPD3-14,18,14,4
2025-07-22,44,DPD30-59,8,6,2
2025-07-22,44,DPD60-89,0,0,0
2025-07-22,44,DPD90+,0,0,0
2025-07-22,46,Current,0,0,0
2025-07-22,46,DPD15-29,0,0,0
2025-07-22,46,DPD3-14,0,0,0
2025-07-22,48,Current,26,6,20
2025-07-22,48,DPD15-29,15,9,6
2025-07-22,48,DPD3-14,28,20,8
2025-07-22,48,DPD30-59,14,10,4
2025-07-22,48,DPD60-89,0,0,0
2025-07-22,48,DPD90+,0,0,0
2025-07-22,54,Current,23,2,21
2025-07-22,56,Current,0,0,0
2025-07-22,56,DPD15-29,4,4,0
2025-07-22,56,DPD3-14,1,0,1
2025-07-22,56,DPD60-89,0,0,0
2025-07-22,6,Current,0,0,0
2025-07-21,102,Current,0,0,0
2025-07-21,104,Current,0,0,0
2025-07-21,20,Current,0,0,0
2025-07-21,20,DPD15-29,129,99,30
2025-07-21,20,DPD3-14,149,125,24
2025-07-21,20,DPD30-59,52,45,7
2025-07-21,20,DPD60-89,0,0,0
2025-07-21,20,DPD90+,0,0,0
2025-07-21,22,Current,0,0,0
2025-07-21,24,Current,2963,2266,697
2025-07-21,24,DPD15-29,78,63,15
2025-07-21,24,DPD3-14,117,90,27
2025-07-21,24,DPD30-59,34,26,8
2025-07-21,24,DPD60-89,0,0,0
2025-07-21,24,DPD90+,0,0,0
2025-07-21,26,Current,0,0,0
2025-07-21,26,DPD15-29,9,7,2
2025-07-21,26,DPD3-14,7,6,1
2025-07-21,26,DPD30-59,0,0,0
2025-07-21,26,DPD60-89,0,0,0
2025-07-21,26,DPD90+,0,0,0
2025-07-21,32,Current,0,0,0
2025-07-21,32,DPD15-29,77,63,14
2025-07-21,32,DPD3-14,66,57,9
2025-07-21,32,DPD30-59,20,16,4
2025-07-21,32,DPD60-89,0,0,0
2025-07-21,32,DPD90+,0,0,0
2025-07-21,34,Current,0,0,0
2025-07-21,34,DPD15-29,17,10,7
2025-07-21,34,DPD3-14,19,15,4
2025-07-21,34,DPD30-59,13,10,3
2025-07-21,34,DPD60-89,0,0,0
2025-07-21,34,DPD90+,0,0,0
2025-07-21,36,Current,0,0,0
2025-07-21,36,DPD15-29,15,11,4
2025-07-21,36,DPD3-14,12,9,3
2025-07-21,36,DPD30-59,4,4,0
2025-07-21,36,DPD60-89,0,0,0
2025-07-21,36,DPD90+,0,0,0
2025-07-21,38,Current,395,298,97
2025-07-21,38,DPD15-29,24,20,4
2025-07-21,38,DPD3-14,24,19,5
2025-07-21,38,DPD30-59,8,6,2
2025-07-21,38,DPD60-89,0,0,0
2025-07-21,38,DPD90+,0,0,0
2025-07-21,40,Current,0,0,0
2025-07-21,40,DPD15-29,11,10,1
2025-07-21,40,DPD3-14,19,16,3
2025-07-21,40,DPD30-59,6,3,3
2025-07-21,40,DPD60-89,0,0,0
2025-07-21,40,DPD90+,0,0,0
2025-07-21,42,Current,0,0,0
2025-07-21,42,DPD15-29,8,6,2
2025-07-21,42,DPD3-14,9,9,0
2025-07-21,42,DPD30-59,1,1,0
2025-07-21,42,DPD60-89,0,0,0
2025-07-21,42,DPD90+,0,0,0
2025-07-21,44,Current,922,690,232
2025-07-21,44,DPD15-29,13,8,5
2025-07-21,44,DPD3-14,32,28,4
2025-07-21,44,DPD30-59,3,2,1
2025-07-21,44,DPD60-89,0,0,0
2025-07-21,44,DPD90+,0,0,0
2025-07-21,46,Current,0,0,0
2025-07-21,46,DPD15-29,0,0,0
2025-07-21,46,DPD3-14,2,1,1
2025-07-21,48,Current,1003,737,266
2025-07-21,48,DPD15-29,24,17,7
2025-07-21,48,DPD3-14,34,24,10
2025-07-21,48,DPD30-59,14,8,6
2025-07-21,48,DPD60-89,0,0,0
2025-07-21,48,DPD90+,0,0,0
2025-07-21,54,Current,47,0,47
2025-07-21,56,Current,451,273,178
2025-07-21,56,DPD15-29,2,1,1
2025-07-21,56,DPD3-14,6,5,1
2025-07-21,56,DPD60-89,0,0,0
2025-07-21,6,Current,0,0,0
2025-07-20,102,Current,0,0,0
2025-07-20,104,Current,0,0,0
2025-07-20,20,Current,0,0,0
2025-07-20,20,DPD15-29,120,99,21
2025-07-20,20,DPD3-14,94,70,24
2025-07-20,20,DPD30-59,81,70,11
2025-07-20,20,DPD60-89,0,0,0
2025-07-20,20,DPD90+,0,0,0
2025-07-20,22,Current,0,0,0
2025-07-20,24,Current,31,0,31
2025-07-20,24,DPD15-29,71,56,15
2025-07-20,24,DPD3-14,74,59,15
2025-07-20,24,DPD30-59,44,39,5
2025-07-20,24,DPD60-89,0,0,0
2025-07-20,24,DPD90+,0,0,0
2025-07-20,26,Current,0,0,0
2025-07-20,26,DPD15-29,10,6,4
2025-07-20,26,DPD3-14,6,5,1
2025-07-20,26,DPD30-59,5,3,2
2025-07-20,26,DPD60-89,0,0,0
2025-07-20,26,DPD90+,0,0,0
2025-07-20,32,Current,0,0,0
2025-07-20,32,DPD15-29,75,59,16
2025-07-20,32,DPD3-14,51,33,18
2025-07-20,32,DPD30-59,31,26,5
2025-07-20,32,DPD60-89,0,0,0
2025-07-20,32,DPD90+,0,0,0
2025-07-20,34,Current,0,0,0
2025-07-20,34,DPD15-29,21,19,2
2025-07-20,34,DPD3-14,16,11,5
2025-07-20,34,DPD30-59,15,11,4
2025-07-20,34,DPD60-89,0,0,0
2025-07-20,34,DPD90+,0,0,0
2025-07-20,36,Current,0,0,0
2025-07-20,36,DPD15-29,11,10,1
2025-07-20,36,DPD3-14,11,7,4
2025-07-20,36,DPD30-59,3,2,1
2025-07-20,36,DPD60-89,0,0,0
2025-07-20,36,DPD90+,0,0,0
2025-07-20,38,Current,4,0,4
2025-07-20,38,DPD15-29,19,14,5
2025-07-20,38,DPD3-14,11,8,3
2025-07-20,38,DPD30-59,9,8,1
2025-07-20,38,DPD60-89,0,0,0
2025-07-20,38,DPD90+,0,0,0
2025-07-20,40,Current,0,0,0
2025-07-20,40,DPD15-29,10,9,1
2025-07-20,40,DPD3-14,9,8,1
2025-07-20,40,DPD30-59,8,7,1
2025-07-20,40,DPD60-89,0,0,0
2025-07-20,40,DPD90+,0,0,0
2025-07-20,42,Current,0,0,0
2025-07-20,42,DPD15-29,3,3,0
2025-07-20,42,DPD3-14,1,1,0
2025-07-20,42,DPD30-59,1,0,1
2025-07-20,42,DPD60-89,0,0,0
2025-07-20,42,DPD90+,0,0,0
2025-07-20,44,Current,0,0,0
2025-07-20,44,DPD15-29,11,9,2
2025-07-20,44,DPD3-14,18,15,3
2025-07-20,44,DPD30-59,6,5,1
2025-07-20,44,DPD60-89,0,0,0
2025-07-20,44,DPD90+,0,0,0
2025-07-20,46,Current,0,0,0
2025-07-20,46,DPD15-29,0,0,0
2025-07-20,46,DPD3-14,0,0,0
2025-07-20,48,Current,22,0,22
2025-07-20,48,DPD15-29,20,15,5
2025-07-20,48,DPD3-14,25,20,5
2025-07-20,48,DPD30-59,15,11,4
2025-07-20,48,DPD60-89,0,0,0
2025-07-20,48,DPD90+,0,0,0
2025-07-20,54,Current,4,1,3
2025-07-20,56,Current,6,0,6
2025-07-20,56,DPD15-29,2,2,0
2025-07-20,56,DPD3-14,1,1,0
2025-07-20,56,DPD60-89,0,0,0
2025-07-20,6,Current,0,0,0
2025-07-19,102,Current,0,0,0
2025-07-19,104,Current,0,0,0
2025-07-19,20,Current,0,0,0
2025-07-19,20,DPD15-29,124,99,25
2025-07-19,20,DPD3-14,148,117,31
2025-07-19,20,DPD30-59,51,44,7
2025-07-19,20,DPD60-89,0,0,0
2025-07-19,20,DPD90+,0,0,0
2025-07-19,22,Current,0,0,0
2025-07-19,24,Current,32,0,32
2025-07-19,24,DPD15-29,70,55,15
2025-07-19,24,DPD3-14,92,77,15
2025-07-19,24,DPD30-59,31,25,6
2025-07-19,24,DPD60-89,0,0,0
2025-07-19,24,DPD90+,0,0,0
2025-07-19,26,Current,0,0,0
2025-07-19,26,DPD15-29,7,6,1
2025-07-19,26,DPD3-14,5,5,0
2025-07-19,26,DPD30-59,0,0,0
2025-07-19,26,DPD60-89,0,0,0
2025-07-19,26,DPD90+,0,0,0
2025-07-19,32,Current,0,0,0
2025-07-19,32,DPD15-29,75,62,13
2025-07-19,32,DPD3-14,78,65,13
2025-07-19,32,DPD30-59,25,21,4
2025-07-19,32,DPD60-89,0,0,0
2025-07-19,32,DPD90+,0,0,0
2025-07-19,34,Current,0,0,0
2025-07-19,34,DPD15-29,20,13,7
2025-07-19,34,DPD3-14,19,14,5
2025-07-19,34,DPD30-59,14,11,3
2025-07-19,34,DPD60-89,0,0,0
2025-07-19,34,DPD90+,0,0,0
2025-07-19,36,Current,0,0,0
2025-07-19,36,DPD15-29,14,10,4
2025-07-19,36,DPD3-14,14,11,3
2025-07-19,36,DPD30-59,7,7,0
2025-07-19,36,DPD60-89,0,0,0
2025-07-19,36,DPD90+,0,0,0
2025-07-19,38,Current,6,0,6
2025-07-19,38,DPD15-29,16,12,4
2025-07-19,38,DPD3-14,22,21,1
2025-07-19,38,DPD30-59,8,6,2
2025-07-19,38,DPD60-89,0,0,0
2025-07-19,38,DPD90+,0,0,0
2025-07-19,40,Current,0,0,0
2025-07-19,40,DPD15-29,11,10,1
2025-07-19,40,DPD3-14,17,14,3
2025-07-19,40,DPD30-59,5,2,3
2025-07-19,40,DPD60-89,0,0,0
2025-07-19,40,DPD90+,0,0,0
2025-07-19,42,Current,0,0,0
2025-07-19,42,DPD15-29,6,5,1
2025-07-19,42,DPD3-14,10,10,0
2025-07-19,42,DPD30-59,0,0,0
2025-07-19,42,DPD60-89,0,0,0
2025-07-19,42,DPD90+,0,0,0
2025-07-19,44,Current,0,0,0
2025-07-19,44,DPD15-29,15,10,5
2025-07-19,44,DPD3-14,22,18,4
2025-07-19,44,DPD30-59,4,3,1
2025-07-19,44,DPD60-89,0,0,0
2025-07-19,44,DPD90+,0,0,0
2025-07-19,46,Current,0,0,0
2025-07-19,46,DPD3-14,2,1,1
2025-07-19,48,Current,25,3,22
2025-07-19,48,DPD15-29,16,10,6
2025-07-19,48,DPD3-14,26,20,6
2025-07-19,48,DPD30-59,13,8,5
2025-07-19,48,DPD60-89,0,0,0
2025-07-19,48,DPD90+,0,0,0
2025-07-19,54,Current,7,0,7
2025-07-19,56,Current,19,0,19
2025-07-19,56,DPD15-29,0,0,0
2025-07-19,56,DPD3-14,3,1,2
2025-07-19,56,DPD60-89,0,0,0
2025-07-19,6,Current,0,0,0
2025-07-18,102,Current,0,0,0
2025-07-18,104,Current,0,0,0
2025-07-18,20,Current,0,0,0
2025-07-18,20,DPD15-29,130,112,18
2025-07-18,20,DPD3-14,71,53,18
2025-07-18,20,DPD30-59,92,82,10
2025-07-18,20,DPD60-89,0,0,0
2025-07-18,20,DPD90+,0,0,0
2025-07-18,22,Current,0,0,0
2025-07-18,24,Current,45,3,42
2025-07-18,24,DPD15-29,79,61,18
2025-07-18,24,DPD3-14,64,38,26
2025-07-18,24,DPD30-59,44,39,5
2025-07-18,24,DPD60-89,0,0,0
2025-07-18,24,DPD90+,0,0,0
2025-07-18,26,Current,0,0,0
2025-07-18,26,DPD15-29,11,7,4
2025-07-18,26,DPD3-14,6,5,1
2025-07-18,26,DPD30-59,7,5,2
2025-07-18,26,DPD60-89,0,0,0
2025-07-18,26,DPD90+,0,0,0
2025-07-18,32,Current,0,0,0
2025-07-18,32,DPD15-29,80,62,18
2025-07-18,32,DPD3-14,33,24,9
2025-07-18,32,DPD30-59,40,35,5
2025-07-18,32,DPD60-89,0,0,0
2025-07-18,32,DPD90+,0,0,0
2025-07-18,34,Current,0,0,0
2025-07-18,34,DPD15-29,21,20,1
2025-07-18,34,DPD3-14,17,13,4
2025-07-18,34,DPD30-59,14,10,4
2025-07-18,34,DPD60-89,0,0,0
2025-07-18,34,DPD90+,0,0,0
2025-07-18,36,Current,0,0,0
2025-07-18,36,DPD15-29,12,10,2
2025-07-18,36,DPD3-14,6,3,3
2025-07-18,36,DPD30-59,7,6,1
2025-07-18,36,DPD60-89,0,0,0
2025-07-18,36,DPD90+,0,0,0
2025-07-18,38,Current,8,1,7
2025-07-18,38,DPD15-29,22,17,5
2025-07-18,38,DPD3-14,17,11,6
2025-07-18,38,DPD30-59,12,11,1
2025-07-18,38,DPD60-89,0,0,0
2025-07-18,38,DPD90+,0,0,0
2025-07-18,40,Current,0,0,0
2025-07-18,40,DPD15-29,13,12,1
2025-07-18,40,DPD3-14,6,5,1
2025-07-18,40,DPD30-59,6,5,1
2025-07-18,40,DPD60-89,0,0,0
2025-07-18,40,DPD90+,0,0,0
2025-07-18,42,Current,0,0,0
2025-07-18,42,DPD15-29,6,6,0
2025-07-18,42,DPD3-14,2,1,1
2025-07-18,42,DPD30-59,1,0,1
2025-07-18,42,DPD60-89,0,0,0
2025-07-18,42,DPD90+,0,0,0
2025-07-18,44,Current,0,0,0
2025-07-18,44,DPD15-29,19,17,2
2025-07-18,44,DPD3-14,7,6,1
2025-07-18,44,DPD30-59,12,11,1
2025-07-18,44,DPD60-89,0,0,0
2025-07-18,44,DPD90+,0,0,0
2025-07-18,46,Current,0,0,0
2025-07-18,46,DPD3-14,1,1,0
2025-07-18,48,Current,27,4,23
2025-07-18,48,DPD15-29,25,20,5
2025-07-18,48,DPD3-14,27,21,6
2025-07-18,48,DPD30-59,21,15,6
2025-07-18,48,DPD60-89,0,0,0
2025-07-18,48,DPD90+,0,0,0
2025-07-18,54,Current,10,1,9
2025-07-18,56,Current,13,2,11
2025-07-18,56,DPD15-29,2,2,0
2025-07-18,56,DPD3-14,2,2,0
2025-07-18,56,DPD60-89,0,0,0
2025-07-18,6,Current,0,0,0
2025-07-17,102,Current,0,0,0
2025-07-17,104,Current,0,0,0
2025-07-17,20,Current,0,0,0
2025-07-17,20,DPD15-29,153,127,26
2025-07-17,20,DPD3-14,75,53,22
2025-07-17,20,DPD30-59,48,41,7
2025-07-17,20,DPD60-89,0,0,0
2025-07-17,20,DPD90+,0,0,0
2025-07-17,22,Current,0,0,0
2025-07-17,24,Current,67,6,61
2025-07-17,24,DPD15-29,86,68,18
2025-07-17,24,DPD3-14,47,29,18
2025-07-17,24,DPD30-59,28,23,5
2025-07-17,24,DPD60-89,0,0,0
2025-07-17,24,DPD90+,0,0,0
2025-07-17,26,Current,0,0,0
2025-07-17,26,DPD15-29,4,4,0
2025-07-17,26,DPD3-14,8,7,1
2025-07-17,26,DPD30-59,1,1,0
2025-07-17,26,DPD60-89,0,0,0
2025-07-17,26,DPD90+,0,0,0
2025-07-17,32,Current,0,0,0
2025-07-17,32,DPD15-29,87,73,14
2025-07-17,32,DPD3-14,32,24,8
2025-07-17,32,DPD30-59,27,23,4
2025-07-17,32,DPD60-89,0,0,0
2025-07-17,32,DPD90+,0,0,0
2025-07-17,34,Current,0,0,0
2025-07-17,34,DPD15-29,24,17,7
2025-07-17,34,DPD3-14,12,10,2
2025-07-17,34,DPD30-59,16,12,4
2025-07-17,34,DPD60-89,0,0,0
2025-07-17,34,DPD90+,0,0,0
2025-07-17,36,Current,0,0,0
2025-07-17,36,DPD15-29,15,12,3
2025-07-17,36,DPD3-14,7,4,3
2025-07-17,36,DPD30-59,8,8,0
2025-07-17,36,DPD60-89,0,0,0
2025-07-17,36,DPD90+,0,0,0
2025-07-17,38,Current,4,2,2
2025-07-17,38,DPD15-29,20,14,6
2025-07-17,38,DPD3-14,22,15,7
2025-07-17,38,DPD30-59,8,6,2
2025-07-17,38,DPD60-89,0,0,0
2025-07-17,38,DPD90+,0,0,0
2025-07-17,40,Current,0,0,0
2025-07-17,40,DPD15-29,14,13,1
2025-07-17,40,DPD3-14,4,2,2
2025-07-17,40,DPD30-59,3,1,2
2025-07-17,40,DPD60-89,0,0,0
2025-07-17,40,DPD90+,0,0,0
2025-07-17,42,Current,0,0,0
2025-07-17,42,DPD15-29,8,6,2
2025-07-17,42,DPD3-14,4,3,1
2025-07-17,42,DPD30-59,2,2,0
2025-07-17,42,DPD60-89,0,0,0
2025-07-17,42,DPD90+,0,0,0
2025-07-17,44,Current,0,0,0
2025-07-17,44,DPD15-29,22,17,5
2025-07-17,44,DPD3-14,10,7,3
2025-07-17,44,DPD30-59,4,3,1
2025-07-17,44,DPD60-89,0,0,0
2025-07-17,44,DPD90+,0,0,0
2025-07-17,46,Current,0,0,0
2025-07-17,46,DPD3-14,0,0,0
2025-07-17,48,Current,26,1,25
2025-07-17,48,DPD15-29,16,10,6
2025-07-17,48,DPD3-14,20,15,5
2025-07-17,48,DPD30-59,13,8,5
2025-07-17,48,DPD60-89,0,0,0
2025-07-17,48,DPD90+,0,0,0
2025-07-17,54,Current,12,0,12
2025-07-17,56,Current,13,0,13
2025-07-17,56,DPD15-29,0,0,0
2025-07-17,56,DPD3-14,4,3,1
2025-07-17,56,DPD60-89,0,0,0
2025-07-17,6,Current,0,0,0
2025-07-16,102,Current,0,0,0
2025-07-16,104,DPD3-14,0,0,0
2025-07-16,20,Current,9,2,7
2025-07-16,20,DPD15-29,138,122,16
2025-07-16,20,DPD3-14,82,60,22
2025-07-16,20,DPD30-59,97,88,9
2025-07-16,20,DPD60-89,0,0,0
2025-07-16,20,DPD90+,0,0,0
2025-07-16,22,Current,0,0,0
2025-07-16,24,Current,81,21,60
2025-07-16,24,DPD15-29,88,68,20
2025-07-16,24,DPD3-14,77,48,29
2025-07-16,24,DPD30-59,49,44,5
2025-07-16,24,DPD60-89,1,1,0
2025-07-16,24,DPD90+,0,0,0
2025-07-16,26,Current,2,0,2
2025-07-16,26,DPD15-29,11,8,3
2025-07-16,26,DPD3-14,9,7,2
2025-07-16,26,DPD30-59,9,7,2
2025-07-16,26,DPD60-89,0,0,0
2025-07-16,26,DPD90+,0,0,0
2025-07-16,32,Current,11,3,8
2025-07-16,32,DPD15-29,100,77,23
2025-07-16,32,DPD3-14,23,17,6
2025-07-16,32,DPD30-59,45,40,5
2025-07-16,32,DPD60-89,0,0,0
2025-07-16,32,DPD90+,0,0,0
2025-07-16,34,Current,0,0,0
2025-07-16,34,DPD15-29,21,20,1
2025-07-16,34,DPD3-14,8,4,4
2025-07-16,34,DPD30-59,16,12,4
2025-07-16,34,DPD60-89,0,0,0
2025-07-16,34,DPD90+,0,0,0
2025-07-16,36,Current,1,1,0
2025-07-16,36,DPD15-29,13,12,1
2025-07-16,36,DPD3-14,6,4,2
2025-07-16,36,DPD30-59,8,7,1
2025-07-16,36,DPD60-89,0,0,0
2025-07-16,36,DPD90+,0,0,0
2025-07-16,38,Current,9,4,5
2025-07-16,38,DPD15-29,21,17,4
2025-07-16,38,DPD3-14,19,16,3
2025-07-16,38,DPD30-59,11,11,0
2025-07-16,38,DPD60-89,0,0,0
2025-07-16,38,DPD90+,0,0,0
2025-07-16,40,Current,3,1,2
2025-07-16,40,DPD15-29,13,13,0
2025-07-16,40,DPD3-14,6,6,0
2025-07-16,40,DPD30-59,4,3,1
2025-07-16,40,DPD60-89,0,0,0
2025-07-16,40,DPD90+,0,0,0
2025-07-16,42,Current,0,0,0
2025-07-16,42,DPD15-29,5,5,0
2025-07-16,42,DPD3-14,4,3,1
2025-07-16,42,DPD30-59,2,1,1
2025-07-16,42,DPD60-89,0,0,0
2025-07-16,42,DPD90+,0,0,0
2025-07-16,44,Current,6,1,5
2025-07-16,44,DPD15-29,19,17,2
2025-07-16,44,DPD3-14,12,8,4
2025-07-16,44,DPD30-59,13,12,1
2025-07-16,44,DPD60-89,0,0,0
2025-07-16,44,DPD90+,0,0,0
2025-07-16,46,Current,0,0,0
2025-07-16,46,DPD3-14,0,0,0
2025-07-16,48,Current,37,10,27
2025-07-16,48,DPD15-29,32,24,8
2025-07-16,48,DPD3-14,32,26,6
2025-07-16,48,DPD30-59,20,15,5
2025-07-16,48,DPD60-89,0,0,0
2025-07-16,48,DPD90+,0,0,0
2025-07-16,54,Current,22,1,21
2025-07-16,56,Current,2,2,0
2025-07-16,56,DPD15-29,2,2,0
2025-07-16,56,DPD3-14,2,1,1
2025-07-16,56,DPD60-89,0,0,0
2025-07-16,6,Current,0,0,0
2025-07-15,102,Current,0,0,0
2025-07-15,104,DPD3-14,0,0,0
2025-07-15,20,Current,3344,515,2829
2025-07-15,20,DPD15-29,203,164,39
2025-07-15,20,DPD3-14,138,96,42
2025-07-15,20,DPD30-59,100,85,15
2025-07-15,20,DPD60-89,61,57,4
2025-07-15,20,DPD90+,58,52,6
2025-07-15,22,Current,0,0,0
2025-07-15,24,Current,7331,2405,4926
2025-07-15,24,DPD15-29,154,119,35
2025-07-15,24,DPD3-14,144,97,47
2025-07-15,24,DPD30-59,73,55,18
2025-07-15,24,DPD60-89,67,62,5
2025-07-15,24,DPD90+,47,41,6
2025-07-15,26,Current,0,0,0
2025-07-15,26,DPD15-29,9,9,0
2025-07-15,26,DPD3-14,1,0,1
2025-07-15,26,DPD30-59,1,1,0
2025-07-15,26,DPD60-89,0,0,0
2025-07-15,26,DPD90+,0,0,0
2025-07-15,32,Current,169,23,146
2025-07-15,32,DPD15-29,91,80,11
2025-07-15,32,DPD3-14,30,22,8
2025-07-15,32,DPD30-59,31,28,3
2025-07-15,32,DPD60-89,2,2,0
2025-07-15,32,DPD90+,2,2,0
2025-07-15,34,Current,0,0,0
2025-07-15,34,DPD15-29,30,23,7
2025-07-15,34,DPD3-14,9,7,2
2025-07-15,34,DPD30-59,16,12,4
2025-07-15,34,DPD60-89,0,0,0
2025-07-15,34,DPD90+,0,0,0
2025-07-15,36,Current,149,25,124
2025-07-15,36,DPD15-29,18,15,3
2025-07-15,36,DPD3-14,8,7,1
2025-07-15,36,DPD30-59,10,10,0
2025-07-15,36,DPD60-89,5,5,0
2025-07-15,36,DPD90+,2,1,1
2025-07-15,38,Current,639,287,352
2025-07-15,38,DPD15-29,16,16,0
2025-07-15,38,DPD3-14,12,6,6
2025-07-15,38,DPD30-59,11,8,3
2025-07-15,38,DPD60-89,2,1,1
2025-07-15,38,DPD90+,2,2,0
2025-07-15,40,Current,162,25,137
2025-07-15,40,DPD15-29,17,12,5
2025-07-15,40,DPD3-14,9,6,3
2025-07-15,40,DPD30-59,8,5,3
2025-07-15,40,DPD60-89,3,3,0
2025-07-15,40,DPD90+,4,4,0
2025-07-15,42,Current,0,0,0
2025-07-15,42,DPD15-29,5,5,0
2025-07-15,42,DPD3-14,1,0,1
2025-07-15,42,DPD30-59,1,1,0
2025-07-15,42,DPD60-89,0,0,0
2025-07-15,42,DPD90+,0,0,0
2025-07-15,44,Current,672,552,120
2025-07-15,44,DPD15-29,27,22,5
2025-07-15,44,DPD3-14,13,12,1
2025-07-15,44,DPD30-59,9,7,2
2025-07-15,44,DPD60-89,3,3,0
2025-07-15,44,DPD90+,1,1,0
2025-07-15,46,Current,3,0,3
2025-07-15,46,DPD3-14,0,0,0
2025-07-15,48,Current,4788,1105,3683
2025-07-15,48,DPD15-29,66,50,16
2025-07-15,48,DPD3-14,80,52,28
2025-07-15,48,DPD30-59,60,39,21
2025-07-15,48,DPD60-89,53,46,7
2025-07-15,48,DPD90+,47,42,5
2025-07-15,54,Current,12,0,12
2025-07-15,56,Current,85,84,1
2025-07-15,56,DPD15-29,0,0,0
2025-07-15,56,DPD3-14,4,3,1
2025-07-15,56,DPD60-89,1,1,0
2025-07-15,6,Current,0,0,0
2025-07-14,100,DPD3-14,0,0,0
2025-07-14,102,Current,0,0,0
2025-07-14,104,Current,0,0,0
2025-07-14,20,Current,0,0,0
2025-07-14,20,DPD15-29,156,132,24
2025-07-14,20,DPD3-14,64,46,18
2025-07-14,20,DPD30-59,99,91,8
2025-07-14,20,DPD60-89,0,0,0
2025-07-14,20,DPD90+,0,0,0
2025-07-14,22,Current,0,0,0
2025-07-14,24,Current,102,4,98
2025-07-14,24,DPD15-29,109,87,22
2025-07-14,24,DPD3-14,64,48,16
2025-07-14,24,DPD30-59,51,47,4
2025-07-14,24,DPD60-89,0,0,0
2025-07-14,24,DPD90+,0,0,0
2025-07-14,26,Current,0,0,0
2025-07-14,26,DPD15-29,14,9,5
2025-07-14,26,DPD3-14,10,8,2
2025-07-14,26,DPD30-59,7,6,1
2025-07-14,26,DPD60-89,0,0,0
2025-07-14,26,DPD90+,0,0,0
2025-07-14,32,Current,0,0,0
2025-07-14,32,DPD15-29,116,92,24
2025-07-14,32,DPD3-14,25,23,2
2025-07-14,32,DPD30-59,53,48,5
2025-07-14,32,DPD60-89,0,0,0
2025-07-14,32,DPD90+,0,0,0
2025-07-14,34,Current,0,0,0
2025-07-14,34,DPD15-29,26,25,1
2025-07-14,34,DPD3-14,9,2,7
2025-07-14,34,DPD30-59,17,14,3
2025-07-14,34,DPD60-89,0,0,0
2025-07-14,34,DPD90+,0,0,0
2025-07-14,36,Current,0,0,0
2025-07-14,36,DPD15-29,18,17,1
2025-07-14,36,DPD3-14,5,2,3
2025-07-14,36,DPD30-59,7,7,0
2025-07-14,36,DPD60-89,0,0,0
2025-07-14,36,DPD90+,0,0,0
2025-07-14,38,Current,10,2,8
2025-07-14,38,DPD15-29,26,22,4
2025-07-14,38,DPD3-14,15,10,5
2025-07-14,38,DPD30-59,14,12,2
2025-07-14,38,DPD60-89,0,0,0
2025-07-14,38,DPD90+,0,0,0
2025-07-14,40,Current,0,0,0
2025-07-14,40,DPD15-29,13,13,0
2025-07-14,40,DPD3-14,10,9,1
2025-07-14,40,DPD30-59,6,5,1
2025-07-14,40,DPD60-89,0,0,0
2025-07-14,40,DPD90+,0,0,0
2025-07-14,42,Current,0,0,0
2025-07-14,42,DPD15-29,7,6,1
2025-07-14,42,DPD3-14,3,3,0
2025-07-14,42,DPD30-59,4,3,1
2025-07-14,42,DPD60-89,0,0,0
2025-07-14,42,DPD90+,0,0,0
2025-07-14,44,Current,3,3,0
2025-07-14,44,DPD15-29,21,18,3
2025-07-14,44,DPD3-14,16,12,4
2025-07-14,44,DPD30-59,16,15,1
2025-07-14,44,DPD60-89,0,0,0
2025-07-14,44,DPD90+,0,0,0
2025-07-14,46,Current,0,0,0
2025-07-14,46,DPD3-14,0,0,0
2025-07-14,48,Current,64,4,60
2025-07-14,48,DPD15-29,36,28,8
2025-07-14,48,DPD3-14,24,18,6
2025-07-14,48,DPD30-59,18,13,5
2025-07-14,48,DPD60-89,0,0,0
2025-07-14,48,DPD90+,0,0,0
2025-07-14,54,Current,41,0,41
2025-07-14,56,Current,0,0,0
2025-07-14,56,DPD15-29,1,1,0
2025-07-14,56,DPD3-14,2,0,2
2025-07-14,56,DPD60-89,0,0,0
2025-07-14,6,Current,0,0,0
2025-07-13,100,DPD3-14,0,0,0
2025-07-13,102,Current,0,0,0
2025-07-13,104,Current,0,0,0
2025-07-13,20,Current,0,0,0
2025-07-13,20,DPD15-29,167,145,22
2025-07-13,20,DPD3-14,58,47,11
2025-07-13,20,DPD30-59,69,63,6
2025-07-13,20,DPD60-89,0,0,0
2025-07-13,20,DPD90+,0,0,0
2025-07-13,22,Current,0,0,0
2025-07-13,24,Current,30,3,27
2025-07-13,24,DPD15-29,92,78,14
2025-07-13,24,DPD3-14,58,47,11
2025-07-13,24,DPD30-59,41,40,1
2025-07-13,24,DPD60-89,0,0,0
2025-07-13,24,DPD90+,0,0,0
2025-07-13,26,Current,0,0,0
2025-07-13,26,DPD15-29,10,10,0
2025-07-13,26,DPD3-14,2,0,2
2025-07-13,26,DPD30-59,1,1,0
2025-07-13,26,DPD60-89,0,0,0
2025-07-13,26,DPD90+,0,0,0
2025-07-13,32,Current,0,0,0
2025-07-13,32,DPD15-29,91,81,10
2025-07-13,32,DPD3-14,30,22,8
2025-07-13,32,DPD30-59,38,35,3
2025-07-13,32,DPD60-89,0,0,0
2025-07-13,32,DPD90+,0,0,0
2025-07-13,34,Current,0,0,0
2025-07-13,34,DPD15-29,31,24,7
2025-07-13,34,DPD3-14,10,7,3
2025-07-13,34,DPD30-59,19,15,4
2025-07-13,34,DPD60-89,0,0,0
2025-07-13,34,DPD90+,0,0,0
2025-07-13,36,Current,0,0,0
2025-07-13,36,DPD15-29,18,14,4
2025-07-13,36,DPD3-14,6,4,2
2025-07-13,36,DPD30-59,10,10,0
2025-07-13,36,DPD60-89,0,0,0
2025-07-13,36,DPD90+,0,0,0
2025-07-13,38,Current,2,0,2
2025-07-13,38,DPD15-29,12,12,0
2025-07-13,38,DPD3-14,14,10,4
2025-07-13,38,DPD30-59,13,11,2
2025-07-13,38,DPD60-89,0,0,0
2025-07-13,38,DPD90+,0,0,0
2025-07-13,40,Current,0,0,0
2025-07-13,40,DPD15-29,15,11,4
2025-07-13,40,DPD3-14,7,3,4
2025-07-13,40,DPD30-59,3,1,2
2025-07-13,40,DPD60-89,0,0,0
2025-07-13,40,DPD90+,0,0,0
2025-07-13,42,Current,0,0,0
2025-07-13,42,DPD15-29,6,5,1
2025-07-13,42,DPD3-14,3,1,2
2025-07-13,42,DPD30-59,2,2,0
2025-07-13,42,DPD60-89,0,0,0
2025-07-13,42,DPD90+,0,0,0
2025-07-13,44,Current,0,0,0
2025-07-13,44,DPD15-29,26,22,4
2025-07-13,44,DPD3-14,12,9,3
2025-07-13,44,DPD30-59,4,4,0
2025-07-13,44,DPD60-89,0,0,0
2025-07-13,44,DPD90+,0,0,0
2025-07-13,46,Current,0,0,0
2025-07-13,46,DPD3-14,1,1,0
2025-07-13,48,Current,12,0,12
2025-07-13,48,DPD15-29,17,15,2
2025-07-13,48,DPD3-14,17,11,6
2025-07-13,48,DPD30-59,15,11,4
2025-07-13,48,DPD60-89,0,0,0
2025-07-13,48,DPD90+,0,0,0
2025-07-13,54,Current,5,0,5
2025-07-13,56,Current,0,0,0
2025-07-13,56,DPD15-29,0,0,0
2025-07-13,56,DPD3-14,2,0,2
2025-07-13,56,DPD60-89,0,0,0
2025-07-13,6,Current,0,0,0
2025-07-12,100,DPD3-14,0,0,0
2025-07-12,102,Current,0,0,0
2025-07-12,104,Current,0,0,0
2025-07-12,20,Current,0,0,0
2025-07-12,20,DPD15-29,119,97,22
2025-07-12,20,DPD3-14,100,70,30
2025-07-12,20,DPD30-59,98,90,8
2025-07-12,20,DPD60-89,0,0,0
2025-07-12,20,DPD90+,0,0,0
2025-07-12,22,Current,0,0,0
2025-07-12,24,Current,26,0,26
2025-07-12,24,DPD15-29,66,52,14
2025-07-12,24,DPD3-14,67,51,16
2025-07-12,24,DPD30-59,48,45,3
2025-07-12,24,DPD60-89,0,0,0
2025-07-12,24,DPD90+,0,0,0
2025-07-12,26,Current,0,0,0
2025-07-12,26,DPD15-29,10,6,4
2025-07-12,26,DPD3-14,7,4,3
2025-07-12,26,DPD30-59,7,6,1
2025-07-12,26,DPD60-89,0,0,0
2025-07-12,26,DPD90+,0,0,0
2025-07-12,32,Current,0,0,0
2025-07-12,32,DPD15-29,82,67,15
2025-07-12,32,DPD3-14,49,37,12
2025-07-12,32,DPD30-59,54,49,5
2025-07-12,32,DPD60-89,0,0,0
2025-07-12,32,DPD90+,0,0,0
2025-07-12,34,Current,0,0,0
2025-07-12,34,DPD15-29,19,18,1
2025-07-12,34,DPD3-14,17,8,9
2025-07-12,34,DPD30-59,17,14,3
2025-07-12,34,DPD60-89,0,0,0
2025-07-12,34,DPD90+,0,0,0
2025-07-12,36,Current,0,0,0
2025-07-12,36,DPD15-29,14,13,1
2025-07-12,36,DPD3-14,12,8,4
2025-07-12,36,DPD30-59,7,7,0
2025-07-12,36,DPD60-89,0,0,0
2025-07-12,36,DPD90+,0,0,0
2025-07-12,38,Current,4,0,4
2025-07-12,38,DPD15-29,19,15,4
2025-07-12,38,DPD3-14,32,20,12
2025-07-12,38,DPD30-59,13,11,2
2025-07-12,38,DPD60-89,0,0,0
2025-07-12,38,DPD90+,0,0,0
2025-07-12,40,Current,0,0,0
2025-07-12,40,DPD15-29,9,9,0
2025-07-12,40,DPD3-14,10,9,1
2025-07-12,40,DPD30-59,6,5,1
2025-07-12,40,DPD60-89,0,0,0
2025-07-12,40,DPD90+,0,0,0
2025-07-12,42,Current,0,0,0
2025-07-12,42,DPD15-29,5,5,0
2025-07-12,42,DPD3-14,8,4,4
2025-07-12,42,DPD30-59,4,3,1
2025-07-12,42,DPD60-89,0,0,0
2025-07-12,42,DPD90+,0,0,0
2025-07-12,44,Current,1,1,0
2025-07-12,44,DPD15-29,15,14,1
2025-07-12,44,DPD3-14,19,14,5
2025-07-12,44,DPD30-59,17,16,1
2025-07-12,44,DPD60-89,0,0,0
2025-07-12,44,DPD90+,0,0,0
2025-07-12,46,Current,0,0,0
2025-07-12,46,DPD3-14,0,0,0
2025-07-12,48,Current,16,1,15
2025-07-12,48,DPD15-29,31,24,7
2025-07-12,48,DPD3-14,24,16,8
2025-07-12,48,DPD30-59,15,11,4
2025-07-12,48,DPD60-89,0,0,0
2025-07-12,48,DPD90+,0,0,0
2025-07-12,54,Current,17,0,17
2025-07-12,56,Current,0,0,0
2025-07-12,56,DPD15-29,0,0,0
2025-07-12,56,DPD3-14,2,2,0
2025-07-12,56,DPD60-89,0,0,0
2025-07-12,6,Current,0,0,0
2025-07-11,100,DPD3-14,0,0,0
2025-07-11,102,Current,0,0,0
2025-07-11,104,Current,0,0,0
2025-07-11,20,Current,0,0,0
2025-07-11,20,DPD15-29,162,138,24
2025-07-11,20,DPD3-14,54,33,21
2025-07-11,20,DPD30-59,70,64,6
2025-07-11,20,DPD60-89,0,0,0
2025-07-11,20,DPD90+,0,0,0
2025-07-11,22,Current,0,0,0
2025-07-11,24,Current,18,2,16
2025-07-11,24,DPD15-29,81,69,12
2025-07-11,24,DPD3-14,51,33,18
2025-07-11,24,DPD30-59,46,45,1
2025-07-11,24,DPD60-89,0,0,0
2025-07-11,24,DPD90+,0,0,0
2025-07-11,26,Current,0,0,0
2025-07-11,26,DPD15-29,11,11,0
2025-07-11,26,DPD3-14,6,4,2
2025-07-11,26,DPD30-59,1,1,0
2025-07-11,26,DPD60-89,0,0,0
2025-07-11,26,DPD90+,0,0,0
2025-07-11,32,Current,0,0,0
2025-07-11,32,DPD15-29,93,83,10
2025-07-11,32,DPD3-14,24,15,9
2025-07-11,32,DPD30-59,42,39,3
2025-07-11,32,DPD60-89,0,0,0
2025-07-11,32,DPD90+,0,0,0
2025-07-11,34,Current,0,0,0
2025-07-11,34,DPD15-29,28,22,6
2025-07-11,34,DPD3-14,12,9,3
2025-07-11,34,DPD30-59,20,16,4
2025-07-11,34,DPD60-89,0,0,0
2025-07-11,34,DPD90+,0,0,0
2025-07-11,36,Current,0,0,0
2025-07-11,36,DPD15-29,15,12,3
2025-07-11,36,DPD3-14,3,2,1
2025-07-11,36,DPD30-59,7,7,0
2025-07-11,36,DPD60-89,0,0,0
2025-07-11,36,DPD90+,0,0,0
2025-07-11,38,Current,6,0,6
2025-07-11,38,DPD15-29,14,14,0
2025-07-11,38,DPD3-14,21,14,7
2025-07-11,38,DPD30-59,13,11,2
2025-07-11,38,DPD60-89,0,0,0
2025-07-11,38,DPD90+,0,0,0
2025-07-11,40,Current,0,0,0
2025-07-11,40,DPD15-29,14,9,5
2025-07-11,40,DPD3-14,1,0,1
2025-07-11,40,DPD30-59,4,2,2
2025-07-11,40,DPD60-89,0,0,0
2025-07-11,40,DPD90+,0,0,0
2025-07-11,42,Current,0,0,0
2025-07-11,42,DPD15-29,6,5,1
2025-07-11,42,DPD3-14,5,2,3
2025-07-11,42,DPD30-59,2,2,0
2025-07-11,42,DPD60-89,0,0,0
2025-07-11,42,DPD90+,0,0,0
2025-07-11,44,Current,0,0,0
2025-07-11,44,DPD15-29,24,20,4
2025-07-11,44,DPD3-14,14,10,4
2025-07-11,44,DPD30-59,5,5,0
2025-07-11,44,DPD60-89,0,0,0
2025-07-11,44,DPD90+,0,0,0
2025-07-11,46,Current,0,0,0
2025-07-11,46,DPD3-14,1,1,0
2025-07-11,48,Current,22,0,22
2025-07-11,48,DPD15-29,17,16,1
2025-07-11,48,DPD3-14,27,19,8
2025-07-11,48,DPD30-59,15,11,4
2025-07-11,48,DPD60-89,0,0,0
2025-07-11,48,DPD90+,0,0,0
2025-07-11,54,Current,9,0,9
2025-07-11,56,Current,0,0,0
2025-07-11,56,DPD15-29,0,0,0
2025-07-11,56,DPD3-14,1,1,0
2025-07-11,56,DPD60-89,0,0,0
2025-07-11,6,Current,0,0,0
2025-07-10,100,DPD3-14,0,0,0
2025-07-10,102,Current,0,0,0
2025-07-10,104,Current,0,0,0
2025-07-10,20,Current,0,0,0
2025-07-10,20,DPD15-29,136,112,24
2025-07-10,20,DPD3-14,32,21,11
2025-07-10,20,DPD30-59,87,84,3
2025-07-10,20,DPD60-89,0,0,0
2025-07-10,20,DPD90+,0,0,0
2025-07-10,22,Current,0,0,0
2025-07-10,24,Current,3015,2294,721
2025-07-10,24,DPD15-29,75,59,16
2025-07-10,24,DPD3-14,42,32,10
2025-07-10,24,DPD30-59,43,42,1
2025-07-10,24,DPD60-89,0,0,0
2025-07-10,24,DPD90+,0,0,0
2025-07-10,26,Current,0,0,0
2025-07-10,26,DPD15-29,14,10,4
2025-07-10,26,DPD3-14,4,3,1
2025-07-10,26,DPD30-59,6,6,0
2025-07-10,26,DPD60-89,0,0,0
2025-07-10,26,DPD90+,0,0,0
2025-07-10,32,Current,0,0,0
2025-07-10,32,DPD15-29,81,68,13
2025-07-10,32,DPD3-14,17,10,7
2025-07-10,32,DPD30-59,54,50,4
2025-07-10,32,DPD60-89,0,0,0
2025-07-10,32,DPD90+,0,0,0
2025-07-10,34,Current,0,0,0
2025-07-10,34,DPD15-29,17,17,0
2025-07-10,34,DPD3-14,7,5,2
2025-07-10,34,DPD30-59,15,13,2
2025-07-10,34,DPD60-89,0,0,0
2025-07-10,34,DPD90+,0,0,0
2025-07-10,36,Current,0,0,0
2025-07-10,36,DPD15-29,15,14,1
2025-07-10,36,DPD3-14,8,6,2
2025-07-10,36,DPD30-59,8,8,0
2025-07-10,36,DPD60-89,0,0,0
2025-07-10,36,DPD90+,0,0,0
2025-07-10,38,Current,409,305,104
2025-07-10,38,DPD15-29,26,20,6
2025-07-10,38,DPD3-14,10,6,4
2025-07-10,38,DPD30-59,12,11,1
2025-07-10,38,DPD60-89,0,0,0
2025-07-10,38,DPD90+,0,0,0
2025-07-10,40,Current,0,0,0
2025-07-10,40,DPD15-29,10,10,0
2025-07-10,40,DPD3-14,3,3,0
2025-07-10,40,DPD30-59,6,6,0
2025-07-10,40,DPD60-89,0,0,0
2025-07-10,40,DPD90+,0,0,0
2025-07-10,42,Current,0,0,0
2025-07-10,42,DPD15-29,6,6,0
2025-07-10,42,DPD3-14,2,0,2
2025-07-10,42,DPD30-59,3,2,1
2025-07-10,42,DPD60-89,0,0,0
2025-07-10,42,DPD90+,0,0,0
2025-07-10,44,Current,932,700,232
2025-07-10,44,DPD15-29,16,15,1
2025-07-10,44,DPD3-14,13,7,6
2025-07-10,44,DPD30-59,14,13,1
2025-07-10,44,DPD60-89,0,0,0
2025-07-10,44,DPD90+,0,0,0
2025-07-10,46,Current,0,0,0
2025-07-10,46,DPD3-14,0,0,0
2025-07-10,48,Current,1032,755,277
2025-07-10,48,DPD15-29,36,29,7
2025-07-10,48,DPD3-14,15,9,6
2025-07-10,48,DPD30-59,14,12,2
2025-07-10,48,DPD60-89,0,0,0
2025-07-10,48,DPD90+,0,0,0
2025-07-10,54,Current,21,0,21
2025-07-10,56,Current,468,284,184
2025-07-10,56,DPD3-14,11,7,4
2025-07-10,56,DPD60-89,0,0,0
2025-07-10,6,Current,0,0,0
2025-07-09,100,DPD3-14,0,0,0
2025-07-09,102,Current,0,0,0
2025-07-09,104,Current,0,0,0
2025-07-09,20,Current,0,0,0
2025-07-09,20,DPD15-29,145,123,22
2025-07-09,20,DPD3-14,114,92,22
2025-07-09,20,DPD30-59,77,72,5
2025-07-09,20,DPD60-89,0,0,0
2025-07-09,20,DPD90+,0,0,0
2025-07-09,22,Current,0,0,0
2025-07-09,24,Current,32,7,25
2025-07-09,24,DPD15-29,81,69,12
2025-07-09,24,DPD3-14,91,70,21
2025-07-09,24,DPD30-59,48,47,1
2025-07-09,24,DPD60-89,0,0,0
2025-07-09,24,DPD90+,0,0,0
2025-07-09,26,Current,0,0,0
2025-07-09,26,DPD15-29,11,11,0
2025-07-09,26,DPD3-14,15,10,5
2025-07-09,26,DPD30-59,1,1,0
2025-07-09,26,DPD60-89,0,0,0
2025-07-09,26,DPD90+,0,0,0
2025-07-09,32,Current,0,0,0
2025-07-09,32,DPD15-29,94,83,11
2025-07-09,32,DPD3-14,53,38,15
2025-07-09,32,DPD30-59,41,38,3
2025-07-09,32,DPD60-89,0,0,0
2025-07-09,32,DPD90+,0,0,0
2025-07-09,34,Current,0,0,0
2025-07-09,34,DPD15-29,22,19,3
2025-07-09,34,DPD3-14,13,10,3
2025-07-09,34,DPD30-59,21,17,4
2025-07-09,34,DPD60-89,0,0,0
2025-07-09,34,DPD90+,0,0,0
2025-07-09,36,Current,0,0,0
2025-07-09,36,DPD15-29,15,13,2
2025-07-09,36,DPD3-14,14,11,3
2025-07-09,36,DPD30-59,7,7,0
2025-07-09,36,DPD60-89,0,0,0
2025-07-09,36,DPD90+,0,0,0
2025-07-09,38,Current,4,0,4
2025-07-09,38,DPD15-29,15,15,0
2025-07-09,38,DPD3-14,20,17,3
2025-07-09,38,DPD30-59,14,12,2
2025-07-09,38,DPD60-89,0,0,0
2025-07-09,38,DPD90+,0,0,0
2025-07-09,40,Current,0,0,0
2025-07-09,40,DPD15-29,12,8,4
2025-07-09,40,DPD3-14,5,5,0
2025-07-09,40,DPD30-59,5,3,2
2025-07-09,40,DPD60-89,0,0,0
2025-07-09,40,DPD90+,0,0,0
2025-07-09,42,Current,0,0,0
2025-07-09,42,DPD15-29,6,5,1
2025-07-09,42,DPD3-14,8,6,2
2025-07-09,42,DPD30-59,3,3,0
2025-07-09,42,DPD60-89,0,0,0
2025-07-09,42,DPD90+,0,0,0
2025-07-09,44,Current,0,0,0
2025-07-09,44,DPD15-29,23,19,4
2025-07-09,44,DPD3-14,16,10,6
2025-07-09,44,DPD30-59,7,7,0
2025-07-09,44,DPD60-89,0,0,0
2025-07-09,44,DPD90+,0,0,0
2025-07-09,46,Current,0,0,0
2025-07-09,46,DPD3-14,1,0,1
2025-07-09,48,Current,18,3,15
2025-07-09,48,DPD15-29,20,18,2
2025-07-09,48,DPD3-14,34,25,9
2025-07-09,48,DPD30-59,14,11,3
2025-07-09,48,DPD60-89,0,0,0
2025-07-09,48,DPD90+,0,0,0
2025-07-09,54,Current,19,0,19
2025-07-09,56,Current,0,0,0
2025-07-09,56,DPD3-14,0,0,0
2025-07-09,56,DPD60-89,0,0,0
2025-07-09,6,Current,0,0,0
2025-07-08,100,DPD3-14,0,0,0
2025-07-08,102,Current,0,0,0
2025-07-08,104,Current,0,0,0
2025-07-08,20,Current,5,1,4
2025-07-08,20,DPD15-29,135,112,23
2025-07-08,20,DPD3-14,67,50,17
2025-07-08,20,DPD30-59,96,93,3
2025-07-08,20,DPD60-89,0,0,0
2025-07-08,20,DPD90+,0,0,0
2025-07-08,22,Current,0,0,0
2025-07-08,24,Current,62,5,57
2025-07-08,24,DPD15-29,88,73,15
2025-07-08,24,DPD3-14,53,41,12
2025-07-08,24,DPD30-59,51,51,0
2025-07-08,24,DPD60-89,0,0,0
2025-07-08,24,DPD90+,0,0,0
2025-07-08,26,Current,1,0,1
2025-07-08,26,DPD15-29,12,9,3
2025-07-08,26,DPD3-14,2,1,1
2025-07-08,26,DPD30-59,6,6,0
2025-07-08,26,DPD60-89,0,0,0
2025-07-08,26,DPD90+,0,0,0
2025-07-08,32,Current,7,3,4
2025-07-08,32,DPD15-29,73,61,12
2025-07-08,32,DPD3-14,38,29,9
2025-07-08,32,DPD30-59,58,54,4
2025-07-08,32,DPD60-89,0,0,0
2025-07-08,32,DPD90+,0,0,0
2025-07-08,34,Current,0,0,0
2025-07-08,34,DPD15-29,13,13,0
2025-07-08,34,DPD3-14,15,12,3
2025-07-08,34,DPD30-59,15,13,2
2025-07-08,34,DPD60-89,0,0,0
2025-07-08,34,DPD90+,0,0,0
2025-07-08,36,Current,0,0,0
2025-07-08,36,DPD15-29,19,18,1
2025-07-08,36,DPD3-14,14,11,3
2025-07-08,36,DPD30-59,8,8,0
2025-07-08,36,DPD60-89,0,0,0
2025-07-08,36,DPD90+,0,0,0
2025-07-08,38,Current,9,1,8
2025-07-08,38,DPD15-29,22,18,4
2025-07-08,38,DPD3-14,10,8,2
2025-07-08,38,DPD30-59,14,13,1
2025-07-08,38,DPD60-89,0,0,0
2025-07-08,38,DPD90+,0,0,0
2025-07-08,40,Current,1,0,1
2025-07-08,40,DPD15-29,11,10,1
2025-07-08,40,DPD3-14,7,6,1
2025-07-08,40,DPD30-59,6,6,0
2025-07-08,40,DPD60-89,0,0,0
2025-07-08,40,DPD90+,0,0,0
2025-07-08,42,Current,0,0,0
2025-07-08,42,DPD15-29,4,4,0
2025-07-08,42,DPD3-14,2,2,0
2025-07-08,42,DPD30-59,4,3,1
2025-07-08,42,DPD60-89,0,0,0
2025-07-08,42,DPD90+,0,0,0
2025-07-08,44,Current,4,1,3
2025-07-08,44,DPD15-29,14,13,1
2025-07-08,44,DPD3-14,18,12,6
2025-07-08,44,DPD30-59,17,16,1
2025-07-08,44,DPD60-89,0,0,0
2025-07-08,44,DPD90+,0,0,0
2025-07-08,46,Current,0,0,0
2025-07-08,46,DPD3-14,0,0,0
2025-07-08,48,Current,30,7,23
2025-07-08,48,DPD15-29,38,31,7
2025-07-08,48,DPD3-14,16,11,5
2025-07-08,48,DPD30-59,17,15,2
2025-07-08,48,DPD60-89,0,0,0
2025-07-08,48,DPD90+,0,0,0
2025-07-08,54,Current,21,3,18
2025-07-08,56,Current,0,0,0
2025-07-08,56,DPD3-14,0,0,0
2025-07-08,56,DPD30-59,1,1,0
2025-07-08,6,Current,0,0,0
2025-07-07,100,DPD3-14,0,0,0
2025-07-07,102,Current,0,0,0
2025-07-07,104,Current,0,0,0
2025-07-07,20,Current,0,0,0
2025-07-07,20,DPD15-29,138,119,19
2025-07-07,20,DPD3-14,113,80,33
2025-07-07,20,DPD30-59,85,80,5
2025-07-07,20,DPD60-89,0,0,0
2025-07-07,20,DPD90+,0,0,0
2025-07-07,22,Current,0,0,0
2025-07-07,24,Current,128,10,118
2025-07-07,24,DPD15-29,75,65,10
2025-07-07,24,DPD3-14,84,55,29
2025-07-07,24,DPD30-59,56,54,2
2025-07-07,24,DPD60-89,0,0,0
2025-07-07,24,DPD90+,0,0,0
2025-07-07,26,Current,0,0,0
2025-07-07,26,DPD15-29,12,12,0
2025-07-07,26,DPD3-14,9,7,2
2025-07-07,26,DPD30-59,1,1,0
2025-07-07,26,DPD60-89,0,0,0
2025-07-07,26,DPD90+,0,0,0
2025-07-07,32,Current,0,0,0
2025-07-07,32,DPD15-29,72,64,8
2025-07-07,32,DPD3-14,60,40,20
2025-07-07,32,DPD30-59,47,44,3
2025-07-07,32,DPD60-89,0,0,0
2025-07-07,32,DPD90+,0,0,0
2025-07-07,34,Current,0,0,0
2025-07-07,34,DPD15-29,17,16,1
2025-07-07,34,DPD3-14,18,11,7
2025-07-07,34,DPD30-59,23,19,4
2025-07-07,34,DPD60-89,0,0,0
2025-07-07,34,DPD90+,0,0,0
2025-07-07,36,Current,0,0,0
2025-07-07,36,DPD15-29,14,12,2
2025-07-07,36,DPD3-14,16,10,6
2025-07-07,36,DPD30-59,7,7,0
2025-07-07,36,DPD60-89,0,0,0
2025-07-07,36,DPD90+,0,0,0
2025-07-07,38,Current,5,2,3
2025-07-07,38,DPD15-29,17,15,2
2025-07-07,38,DPD3-14,23,12,11
2025-07-07,38,DPD30-59,15,13,2
2025-07-07,38,DPD60-89,0,0,0
2025-07-07,38,DPD90+,0,0,0
2025-07-07,40,Current,0,0,0
2025-07-07,40,DPD15-29,10,7,3
2025-07-07,40,DPD3-14,7,5,2
2025-07-07,40,DPD30-59,6,4,2
2025-07-07,40,DPD60-89,0,0,0
2025-07-07,40,DPD90+,0,0,0
2025-07-07,42,Current,0,0,0
2025-07-07,42,DPD15-29,6,5,1
2025-07-07,42,DPD3-14,9,5,4
2025-07-07,42,DPD30-59,3,3,0
2025-07-07,42,DPD60-89,0,0,0
2025-07-07,42,DPD90+,0,0,0
2025-07-07,44,Current,0,0,0
2025-07-07,44,DPD15-29,24,20,4
2025-07-07,44,DPD3-14,13,11,2
2025-07-07,44,DPD30-59,8,8,0
2025-07-07,44,DPD60-89,0,0,0
2025-07-07,44,DPD90+,0,0,0
2025-07-07,46,Current,0,0,0
2025-07-07,48,Current,32,2,30
2025-07-07,48,DPD15-29,25,22,3
2025-07-07,48,DPD3-14,30,22,8
2025-07-07,48,DPD30-59,15,12,3
2025-07-07,48,DPD60-89,0,0,0
2025-07-07,48,DPD90+,0,0,0
2025-07-07,54,Current,19,0,19
2025-07-07,56,Current,16,1,15
2025-07-07,56,DPD15-29,0,0,0
2025-07-07,56,DPD3-14,1,1,0
2025-07-07,56,DPD30-59,0,0,0
2025-07-07,6,Current,0,0,0
2025-07-06,100,DPD3-14,0,0,0
2025-07-06,102,Current,0,0,0
2025-07-06,104,Current,0,0,0
2025-07-06,20,Current,0,0,0
2025-07-06,20,DPD15-29,131,108,23
2025-07-06,20,DPD3-14,66,53,13
2025-07-06,20,DPD30-59,79,78,1
2025-07-06,20,DPD60-89,0,0,0
2025-07-06,20,DPD90+,0,0,0
2025-07-06,22,Current,0,0,0
2025-07-06,24,Current,10,0,10
2025-07-06,24,DPD15-29,90,74,16
2025-07-06,24,DPD3-14,37,27,10
2025-07-06,24,DPD30-59,46,46,0
2025-07-06,24,DPD60-89,0,0,0
2025-07-06,24,DPD90+,0,0,0
2025-07-06,26,Current,0,0,0
2025-07-06,26,DPD15-29,14,10,4
2025-07-06,26,DPD3-14,2,1,1
2025-07-06,26,DPD30-59,4,4,0
2025-07-06,26,DPD60-89,0,0,0
2025-07-06,26,DPD90+,0,0,0
2025-07-06,32,Current,0,0,0
2025-07-06,32,DPD15-29,62,52,10
2025-07-06,32,DPD3-14,28,22,6
2025-07-06,32,DPD30-59,41,41,0
2025-07-06,32,DPD60-89,0,0,0
2025-07-06,32,DPD90+,0,0,0
2025-07-06,34,Current,0,0,0
2025-07-06,34,DPD15-29,14,14,0
2025-07-06,34,DPD3-14,8,5,3
2025-07-06,34,DPD30-59,9,8,1
2025-07-06,34,DPD60-89,0,0,0
2025-07-06,34,DPD90+,0,0,0
2025-07-06,36,Current,0,0,0
2025-07-06,36,DPD15-29,16,15,1
2025-07-06,36,DPD3-14,6,4,2
2025-07-06,36,DPD30-59,7,7,0
2025-07-06,36,DPD60-89,0,0,0
2025-07-06,36,DPD90+,0,0,0
2025-07-06,38,Current,2,0,2
2025-07-06,38,DPD15-29,22,18,4
2025-07-06,38,DPD3-14,10,6,4
2025-07-06,38,DPD30-59,10,10,0
2025-07-06,38,DPD60-89,0,0,0
2025-07-06,38,DPD90+,0,0,0
2025-07-06,40,Current,0,0,0
2025-07-06,40,DPD15-29,10,9,1
2025-07-06,40,DPD3-14,6,4,2
2025-07-06,40,DPD30-59,5,5,0
2025-07-06,40,DPD60-89,0,0,0
2025-07-06,40,DPD90+,0,0,0
2025-07-06,42,Current,0,0,0
2025-07-06,42,DPD15-29,3,3,0
2025-07-06,42,DPD3-14,1,1,0
2025-07-06,42,DPD30-59,3,3,0
2025-07-06,42,DPD60-89,0,0,0
2025-07-06,42,DPD90+,0,0,0
2025-07-06,44,Current,0,0,0
2025-07-06,44,DPD15-29,15,15,0
2025-07-06,44,DPD3-14,12,10,2
2025-07-06,44,DPD30-59,15,14,1
2025-07-06,44,DPD60-89,0,0,0
2025-07-06,44,DPD90+,0,0,0
2025-07-06,46,Current,0,0,0
2025-07-06,46,DPD15-29,1,1,0
2025-07-06,48,Current,3,0,3
2025-07-06,48,DPD15-29,34,28,6
2025-07-06,48,DPD3-14,11,9,2
2025-07-06,48,DPD30-59,19,17,2
2025-07-06,48,DPD60-89,0,0,0
2025-07-06,48,DPD90+,0,0,0
2025-07-06,54,Current,6,0,6
2025-07-06,56,Current,0,0,0
2025-07-06,56,DPD3-14,1,1,0
2025-07-06,56,DPD30-59,1,1,0
2025-07-06,6,Current,0,0,0
2025-07-05,100,Current,0,0,0
2025-07-05,102,Current,0,0,0
2025-07-05,104,Current,0,0,0
2025-07-05,20,Current,0,0,0
2025-07-05,20,DPD15-29,134,115,19
2025-07-05,20,DPD3-14,96,65,31
2025-07-05,20,DPD30-59,83,79,4
2025-07-05,20,DPD60-89,0,0,0
2025-07-05,20,DPD90+,0,0,0
2025-07-05,22,Current,0,0,0
2025-07-05,24,Current,41,3,38
2025-07-05,24,DPD15-29,68,59,9
2025-07-05,24,DPD3-14,69,38,31
2025-07-05,24,DPD30-59,53,51,2
2025-07-05,24,DPD60-89,0,0,0
2025-07-05,24,DPD90+,0,0,0
2025-07-05,26,Current,0,0,0
2025-07-05,26,DPD15-29,14,13,1
2025-07-05,26,DPD3-14,5,4,1
2025-07-05,26,DPD30-59,1,1,0
2025-07-05,26,DPD60-89,0,0,0
2025-07-05,26,DPD90+,0,0,0
2025-07-05,32,Current,0,0,0
2025-07-05,32,DPD15-29,57,51,6
2025-07-05,32,DPD3-14,57,40,17
2025-07-05,32,DPD30-59,42,40,2
2025-07-05,32,DPD60-89,0,0,0
2025-07-05,32,DPD90+,0,0,0
2025-07-05,34,Current,0,0,0
2025-07-05,34,DPD15-29,18,16,2
2025-07-05,34,DPD3-14,16,10,6
2025-07-05,34,DPD30-59,16,15,1
2025-07-05,34,DPD60-89,0,0,0
2025-07-05,34,DPD90+,0,0,0
2025-07-05,36,Current,0,0,0
2025-07-05,36,DPD15-29,16,13,3
2025-07-05,36,DPD3-14,15,12,3
2025-07-05,36,DPD30-59,7,7,0
2025-07-05,36,DPD60-89,0,0,0
2025-07-05,36,DPD90+,0,0,0
2025-07-05,38,Current,3,0,3
2025-07-05,38,DPD15-29,15,14,1
2025-07-05,38,DPD3-14,26,13,13
2025-07-05,38,DPD30-59,14,12,2
2025-07-05,38,DPD60-89,0,0,0
2025-07-05,38,DPD90+,0,0,0
2025-07-05,40,Current,0,0,0
2025-07-05,40,DPD15-29,9,6,3
2025-07-05,40,DPD3-14,8,7,1
2025-07-05,40,DPD30-59,6,5,1
2025-07-05,40,DPD60-89,0,0,0
2025-07-05,40,DPD90+,0,0,0
2025-07-05,42,Current,0,0,0
2025-07-05,42,DPD15-29,6,5,1
2025-07-05,42,DPD3-14,9,4,5
2025-07-05,42,DPD30-59,3,3,0
2025-07-05,42,DPD60-89,0,0,0
2025-07-05,42,DPD90+,0,0,0
2025-07-05,44,Current,0,0,0
2025-07-05,44,DPD15-29,22,18,4
2025-07-05,44,DPD3-14,11,9,2
2025-07-05,44,DPD30-59,8,8,0
2025-07-05,44,DPD60-89,0,0,0
2025-07-05,44,DPD90+,0,0,0
2025-07-05,46,Current,0,0,0
2025-07-05,46,DPD15-29,0,0,0
2025-07-05,48,Current,20,1,19
2025-07-05,48,DPD15-29,27,24,3
2025-07-05,48,DPD3-14,31,17,14
2025-07-05,48,DPD30-59,11,9,2
2025-07-05,48,DPD60-89,0,0,0
2025-07-05,48,DPD90+,0,0,0
2025-07-05,54,Current,0,0,0
2025-07-05,56,Current,10,0,10
2025-07-05,56,DPD3-14,0,0,0
2025-07-05,56,DPD30-59,0,0,0
2025-07-05,6,Current,0,0,0
2025-07-04,100,Current,0,0,0
2025-07-04,102,Current,0,0,0
2025-07-04,104,Current,0,0,0
2025-07-04,20,Current,0,0,0
2025-07-04,20,DPD15-29,104,83,21
2025-07-04,20,DPD3-14,105,85,20
2025-07-04,20,DPD30-59,75,75,0
2025-07-04,20,DPD60-89,0,0,0
2025-07-04,20,DPD90+,0,0,0
2025-07-04,22,Current,0,0,0
2025-07-04,24,Current,35,3,32
2025-07-04,24,DPD15-29,72,56,16
2025-07-04,24,DPD3-14,90,65,25
2025-07-04,24,DPD30-59,48,48,0
2025-07-04,24,DPD60-89,0,0,0
2025-07-04,24,DPD90+,0,0,0
2025-07-04,26,Current,0,0,0
2025-07-04,26,DPD15-29,9,6,3
2025-07-04,26,DPD3-14,8,5,3
2025-07-04,26,DPD30-59,4,4,0
2025-07-04,26,DPD60-89,0,0,0
2025-07-04,26,DPD90+,0,0,0
2025-07-04,32,Current,0,0,0
2025-07-04,32,DPD15-29,43,35,8
2025-07-04,32,DPD3-14,71,50,21
2025-07-04,32,DPD30-59,42,42,0
2025-07-04,32,DPD60-89,0,0,0
2025-07-04,32,DPD90+,0,0,0
2025-07-04,34,Current,0,0,0
2025-07-04,34,DPD15-29,14,14,0
2025-07-04,34,DPD3-14,17,14,3
2025-07-04,34,DPD30-59,10,9,1
2025-07-04,34,DPD60-89,0,0,0
2025-07-04,34,DPD90+,0,0,0
2025-07-04,36,Current,0,0,0
2025-07-04,36,DPD15-29,12,12,0
2025-07-04,36,DPD3-14,15,13,2
2025-07-04,36,DPD30-59,9,9,0
2025-07-04,36,DPD60-89,0,0,0
2025-07-04,36,DPD90+,0,0,0
2025-07-04,38,Current,4,1,3
2025-07-04,38,DPD15-29,16,14,2
2025-07-04,38,DPD3-14,24,19,5
2025-07-04,38,DPD30-59,9,9,0
2025-07-04,38,DPD60-89,0,0,0
2025-07-04,38,DPD90+,0,0,0
2025-07-04,40,Current,0,0,0
2025-07-04,40,DPD15-29,10,9,1
2025-07-04,40,DPD3-14,7,5,2
2025-07-04,40,DPD30-59,6,6,0
2025-07-04,40,DPD60-89,0,0,0
2025-07-04,40,DPD90+,0,0,0
2025-07-04,42,Current,0,0,0
2025-07-04,42,DPD15-29,3,3,0
2025-07-04,42,DPD3-14,5,4,1
2025-07-04,42,DPD30-59,3,3,0
2025-07-04,42,DPD60-89,0,0,0
2025-07-04,42,DPD90+,0,0,0
2025-07-04,44,Current,22,3,19
2025-07-04,44,DPD15-29,14,13,1
2025-07-04,44,DPD3-14,13,10,3
2025-07-04,44,DPD30-59,16,16,0
2025-07-04,44,DPD60-89,0,0,0
2025-07-04,44,DPD90+,0,0,0
2025-07-04,46,Current,0,0,0
2025-07-04,46,DPD15-29,1,1,0
2025-07-04,48,Current,11,1,10
2025-07-04,48,DPD15-29,23,19,4
2025-07-04,48,DPD3-14,19,14,5
2025-07-04,48,DPD30-59,17,15,2
2025-07-04,48,DPD60-89,0,0,0
2025-07-04,48,DPD90+,0,0,0
2025-07-04,54,Current,8,0,8
2025-07-04,56,Current,7,3,4
2025-07-04,56,DPD3-14,3,3,0
2025-07-04,56,DPD30-59,1,1,0
2025-07-04,6,Current,0,0,0
2025-07-03,100,Current,0,0,0
2025-07-03,102,Current,0,0,0
2025-07-03,104,Current,0,0,0
2025-07-03,20,Current,0,0,0
2025-07-03,20,DPD15-29,142,120,22
2025-07-03,20,DPD3-14,58,47,11
2025-07-03,20,DPD30-59,75,73,2
2025-07-03,20,DPD60-89,0,0,0
2025-07-03,20,DPD90+,0,0,0
2025-07-03,22,Current,0,0,0
2025-07-03,24,Current,63,5,58
2025-07-03,24,DPD15-29,65,55,10
2025-07-03,24,DPD3-14,46,38,8
2025-07-03,24,DPD30-59,51,51,0
2025-07-03,24,DPD60-89,0,0,0
2025-07-03,24,DPD90+,0,0,0
2025-07-03,26,Current,0,0,0
2025-07-03,26,DPD15-29,15,14,1
2025-07-03,26,DPD3-14,2,2,0
2025-07-03,26,DPD30-59,1,1,0
2025-07-03,26,DPD60-89,0,0,0
2025-07-03,26,DPD90+,0,0,0
2025-07-03,32,Current,1,1,0
2025-07-03,32,DPD15-29,60,52,8
2025-07-03,32,DPD3-14,35,30,5
2025-07-03,32,DPD30-59,41,40,1
2025-07-03,32,DPD60-89,0,0,0
2025-07-03,32,DPD90+,0,0,0
2025-07-03,34,Current,0,0,0
2025-07-03,34,DPD15-29,17,15,2
2025-07-03,34,DPD3-14,7,6,1
2025-07-03,34,DPD30-59,15,15,0
2025-07-03,34,DPD60-89,0,0,0
2025-07-03,34,DPD90+,0,0,0
2025-07-03,36,Current,0,0,0
2025-07-03,36,DPD15-29,15,12,3
2025-07-03,36,DPD3-14,7,6,1
2025-07-03,36,DPD30-59,5,5,0
2025-07-03,36,DPD60-89,0,0,0
2025-07-03,36,DPD90+,0,0,0
2025-07-03,38,Current,3,0,3
2025-07-03,38,DPD15-29,17,16,1
2025-07-03,38,DPD3-14,8,7,1
2025-07-03,38,DPD30-59,10,10,0
2025-07-03,38,DPD60-89,0,0,0
2025-07-03,38,DPD90+,0,0,0
2025-07-03,40,Current,0,0,0
2025-07-03,40,DPD15-29,9,6,3
2025-07-03,40,DPD3-14,8,6,2
2025-07-03,40,DPD30-59,5,5,0
2025-07-03,40,DPD60-89,0,0,0
2025-07-03,40,DPD90+,0,0,0
2025-07-03,42,Current,0,0,0
2025-07-03,42,DPD15-29,6,5,1
2025-07-03,42,DPD3-14,3,3,0
2025-07-03,42,DPD30-59,2,2,0
2025-07-03,42,DPD60-89,0,0,0
2025-07-03,42,DPD90+,0,0,0
2025-07-03,44,Current,29,3,26
2025-07-03,44,DPD15-29,18,15,3
2025-07-03,44,DPD3-14,14,10,4
2025-07-03,44,DPD30-59,7,7,0
2025-07-03,44,DPD60-89,0,0,0
2025-07-03,44,DPD90+,0,0,0
2025-07-03,46,Current,0,0,0
2025-07-03,46,DPD15-29,0,0,0
2025-07-03,48,Current,4,0,4
2025-07-03,48,DPD15-29,29,24,5
2025-07-03,48,DPD3-14,13,10,3
2025-07-03,48,DPD30-59,14,12,2
2025-07-03,48,DPD60-89,0,0,0
2025-07-03,48,DPD90+,0,0,0
2025-07-03,54,Current,3,0,3
2025-07-03,56,Current,19,2,17
2025-07-03,56,DPD3-14,0,0,0
2025-07-03,56,DPD30-59,0,0,0
2025-07-03,6,Current,0,0,0
2025-07-02,100,Current,0,0,0
2025-07-02,102,Current,0,0,0
2025-07-02,104,Current,0,0,0
2025-07-02,20,Current,5,1,4
2025-07-02,20,DPD15-29,101,83,18
2025-07-02,20,DPD3-14,145,111,34
2025-07-02,20,DPD30-59,72,72,0
2025-07-02,20,DPD60-89,0,0,0
2025-07-02,20,DPD90+,0,0,0
2025-07-02,22,Current,0,0,0
2025-07-02,24,Current,50,11,39
2025-07-02,24,DPD15-29,74,59,15
2025-07-02,24,DPD3-14,107,87,20
2025-07-02,24,DPD30-59,51,51,0
2025-07-02,24,DPD60-89,0,0,0
2025-07-02,24,DPD90+,0,0,0
2025-07-02,26,Current,1,0,1
2025-07-02,26,DPD15-29,9,6,3
2025-07-02,26,DPD3-14,11,6,5
2025-07-02,26,DPD30-59,4,4,0
2025-07-02,26,DPD60-89,0,0,0
2025-07-02,26,DPD90+,0,0,0
2025-07-02,32,Current,8,3,5
2025-07-02,32,DPD15-29,44,38,6
2025-07-02,32,DPD3-14,90,68,22
2025-07-02,32,DPD30-59,40,39,1
2025-07-02,32,DPD60-89,0,0,0
2025-07-02,32,DPD90+,0,0,0
2025-07-02,34,Current,0,0,0
2025-07-02,34,DPD15-29,14,14,0
2025-07-02,34,DPD3-14,21,18,3
2025-07-02,34,DPD30-59,11,11,0
2025-07-02,34,DPD60-89,0,0,0
2025-07-02,34,DPD90+,0,0,0
2025-07-02,36,Current,0,0,0
2025-07-02,36,DPD15-29,16,16,0
2025-07-02,36,DPD3-14,16,13,3
2025-07-02,36,DPD30-59,11,11,0
2025-07-02,36,DPD60-89,0,0,0
2025-07-02,36,DPD90+,0,0,0
2025-07-02,38,Current,4,1,3
2025-07-02,38,DPD15-29,16,15,1
2025-07-02,38,DPD3-14,24,18,6
2025-07-02,38,DPD30-59,9,9,0
2025-07-02,38,DPD60-89,0,0,0
2025-07-02,38,DPD90+,0,0,0
2025-07-02,40,Current,1,0,1
2025-07-02,40,DPD15-29,12,11,1
2025-07-02,40,DPD3-14,10,7,3
2025-07-02,40,DPD30-59,6,6,0
2025-07-02,40,DPD60-89,0,0,0
2025-07-02,40,DPD90+,0,0,0
2025-07-02,42,Current,0,0,0
2025-07-02,42,DPD15-29,2,2,0
2025-07-02,42,DPD3-14,7,6,1
2025-07-02,42,DPD30-59,4,4,0
2025-07-02,42,DPD60-89,0,0,0
2025-07-02,42,DPD90+,0,0,0
2025-07-02,44,Current,4,1,3
2025-07-02,44,DPD15-29,10,9,1
2025-07-02,44,DPD3-14,19,17,2
2025-07-02,44,DPD30-59,17,17,0
2025-07-02,44,DPD60-89,0,0,0
2025-07-02,44,DPD90+,0,0,0
2025-07-02,46,Current,0,0,0
2025-07-02,46,DPD15-29,1,1,0
2025-07-02,48,Current,20,7,13
2025-07-02,48,DPD15-29,23,19,4
2025-07-02,48,DPD3-14,25,17,8
2025-07-02,48,DPD30-59,16,16,0
2025-07-02,48,DPD60-89,0,0,0
2025-07-02,48,DPD90+,0,0,0
2025-07-02,54,Current,8,0,8
2025-07-02,56,Current,0,0,0
2025-07-02,56,DPD3-14,1,1,0
2025-07-02,56,DPD30-59,1,1,0
2025-07-02,6,Current,0,0,0
2025-07-01,100,Current,0,0,0
2025-07-01,102,Current,0,0,0
2025-07-01,104,Current,0,0,0
2025-07-01,20,Current,0,0,0
2025-07-01,20,DPD15-29,141,116,25
2025-07-01,20,DPD3-14,128,115,13
2025-07-01,20,DPD30-59,74,73,1
2025-07-01,20,DPD60-89,0,0,0
2025-07-01,20,DPD90+,0,0,0
2025-07-01,22,Current,0,0,0
2025-07-01,24,Current,38,11,27
2025-07-01,24,DPD15-29,79,69,10
2025-07-01,24,DPD3-14,79,66,13
2025-07-01,24,DPD30-59,50,50,0
2025-07-01,24,DPD60-89,0,0,0
2025-07-01,24,DPD90+,0,0,0
2025-07-01,26,Current,0,0,0
2025-07-01,26,DPD15-29,14,12,2
2025-07-01,26,DPD3-14,8,7,1
2025-07-01,26,DPD30-59,1,1,0
2025-07-01,26,DPD60-89,0,0,0
2025-07-01,26,DPD90+,0,0,0
2025-07-01,32,Current,0,0,0
2025-07-01,32,DPD15-29,70,59,11
2025-07-01,32,DPD3-14,66,58,8
2025-07-01,32,DPD30-59,40,40,0
2025-07-01,32,DPD60-89,0,0,0
2025-07-01,32,DPD90+,0,0,0
2025-07-01,34,Current,0,0,0
2025-07-01,34,DPD15-29,15,12,3
2025-07-01,34,DPD3-14,23,18,5
2025-07-01,34,DPD30-59,14,14,0
2025-07-01,34,DPD60-89,0,0,0
2025-07-01,34,DPD90+,0,0,0
2025-07-01,36,Current,0,0,0
2025-07-01,36,DPD15-29,14,11,3
2025-07-01,36,DPD3-14,17,12,5
2025-07-01,36,DPD30-59,6,6,0
2025-07-01,36,DPD60-89,0,0,0
2025-07-01,36,DPD90+,0,0,0
2025-07-01,38,Current,11,1,10
2025-07-01,38,DPD15-29,23,19,4
2025-07-01,38,DPD3-14,17,13,4
2025-07-01,38,DPD30-59,12,12,0
2025-07-01,38,DPD60-89,0,0,0
2025-07-01,38,DPD90+,0,0,0
2025-07-01,40,Current,0,0,0
2025-07-01,40,DPD15-29,11,7,4
2025-07-01,40,DPD3-14,20,13,7
2025-07-01,40,DPD30-59,6,6,0
2025-07-01,40,DPD60-89,0,0,0
2025-07-01,40,DPD90+,0,0,0
2025-07-01,42,Current,0,0,0
2025-07-01,42,DPD15-29,10,9,1
2025-07-01,42,DPD3-14,3,3,0
2025-07-01,42,DPD30-59,2,2,0
2025-07-01,42,DPD60-89,0,0,0
2025-07-01,42,DPD90+,0,0,0
2025-07-01,44,Current,1,1,0
2025-07-01,44,DPD15-29,20,16,4
2025-07-01,44,DPD3-14,16,14,2
2025-07-01,44,DPD30-59,6,6,0
2025-07-01,44,DPD60-89,0,0,0
2025-07-01,44,DPD90+,0,0,0
2025-07-01,46,Current,0,0,0
2025-07-01,46,DPD15-29,1,1,0
2025-07-01,48,Current,42,3,39
2025-07-01,48,DPD15-29,26,20,6
2025-07-01,48,DPD3-14,32,23,9
2025-07-01,48,DPD30-59,11,11,0
2025-07-01,48,DPD60-89,0,0,0
2025-07-01,48,DPD90+,0,0,0
2025-07-01,54,Current,17,0,17
2025-07-01,56,Current,0,0,0
2025-07-01,56,DPD3-14,0,0,0
2025-07-01,56,DPD30-59,0,0,0
2025-07-01,6,Current,0,0,0
2025-06-30,100,Current,0,0,0
2025-06-30,102,Current,0,0,0
2025-06-30,104,Current,0,0,0
2025-06-30,20,Current,0,0,0
2025-06-30,20,DPD15-29,83,67,16
2025-06-30,20,DPD3-14,82,58,24
2025-06-30,20,DPD30-59,72,71,1
2025-06-30,20,DPD60-89,0,0,0
2025-06-30,20,DPD90+,0,0,0
2025-06-30,22,Current,0,0,0
2025-06-30,24,Current,93,6,87
2025-06-30,24,DPD15-29,65,50,15
2025-06-30,24,DPD3-14,53,40,13
2025-06-30,24,DPD30-59,51,51,0
2025-06-30,24,DPD60-89,0,0,0
2025-06-30,24,DPD90+,0,0,0
2025-06-30,26,Current,0,0,0
2025-06-30,26,DPD15-29,7,6,1
2025-06-30,26,DPD3-14,7,5,2
2025-06-30,26,DPD30-59,4,4,0
2025-06-30,26,DPD60-89,0,0,0
2025-06-30,26,DPD90+,0,0,0
2025-06-30,32,Current,0,0,0
2025-06-30,32,DPD15-29,37,32,5
2025-06-30,32,DPD3-14,43,33,10
2025-06-30,32,DPD30-59,37,37,0
2025-06-30,32,DPD60-89,0,0,0
2025-06-30,32,DPD90+,0,0,0
2025-06-30,34,Current,0,0,0
2025-06-30,34,DPD15-29,17,15,2
2025-06-30,34,DPD3-14,18,16,2
2025-06-30,34,DPD30-59,9,9,0
2025-06-30,34,DPD60-89,0,0,0
2025-06-30,34,DPD90+,0,0,0
2025-06-30,36,Current,0,0,0
2025-06-30,36,DPD15-29,10,10,0
2025-06-30,36,DPD3-14,7,7,0
2025-06-30,36,DPD30-59,12,12,0
2025-06-30,36,DPD60-89,0,0,0
2025-06-30,36,DPD90+,0,0,0
2025-06-30,38,Current,10,1,9
2025-06-30,38,DPD15-29,17,16,1
2025-06-30,38,DPD3-14,19,12,7
2025-06-30,38,DPD30-59,8,8,0
2025-06-30,38,DPD60-89,0,0,0
2025-06-30,38,DPD90+,0,0,0
2025-06-30,40,Current,0,0,0
2025-06-30,40,DPD15-29,10,9,1
2025-06-30,40,DPD3-14,6,5,1
2025-06-30,40,DPD30-59,4,4,0
2025-06-30,40,DPD60-89,0,0,0
2025-06-30,40,DPD90+,0,0,0
2025-06-30,42,Current,0,0,0
2025-06-30,42,DPD15-29,2,2,0
2025-06-30,42,DPD3-14,7,5,2
2025-06-30,42,DPD30-59,4,4,0
2025-06-30,42,DPD60-89,0,0,0
2025-06-30,42,DPD90+,0,0,0
2025-06-30,44,Current,0,0,0
2025-06-30,44,DPD15-29,3,2,1
2025-06-30,44,DPD3-14,13,11,2
2025-06-30,44,DPD30-59,20,20,0
2025-06-30,44,DPD60-89,0,0,0
2025-06-30,44,DPD90+,0,0,0
2025-06-30,46,Current,0,0,0
2025-06-30,46,DPD15-29,1,1,0
2025-06-30,48,Current,63,8,55
2025-06-30,48,DPD15-29,22,16,6
2025-06-30,48,DPD3-14,20,15,5
2025-06-30,48,DPD30-59,16,16,0
2025-06-30,48,DPD60-89,0,0,0
2025-06-30,48,DPD90+,0,0,0
2025-06-30,54,Current,36,4,32
2025-06-30,56,Current,0,0,0
2025-06-30,56,DPD3-14,1,1,0
2025-06-30,56,DPD30-59,1,1,0
2025-06-30,6,Current,0,0,0
2025-06-29,100,Current,0,0,0
2025-06-29,102,Current,0,0,0
2025-06-29,104,Current,0,0,0
2025-06-29,104,DPD3-14,1,0,1
2025-06-29,20,Current,0,0,0
2025-06-29,20,DPD15-29,95,73,22
2025-06-29,20,DPD3-14,101,82,19
2025-06-29,20,DPD30-59,79,78,1
2025-06-29,20,DPD60-89,0,0,0
2025-06-29,20,DPD90+,0,0,0
2025-06-29,22,Current,0,0,0
2025-06-29,24,Current,50,3,47
2025-06-29,24,DPD15-29,51,42,9
2025-06-29,24,DPD3-14,59,43,16
2025-06-29,24,DPD30-59,50,50,0
2025-06-29,24,DPD60-89,0,0,0
2025-06-29,24,DPD90+,0,0,0
2025-06-29,26,Current,0,0,0
2025-06-29,26,DPD15-29,11,9,2
2025-06-29,26,DPD3-14,3,2,1
2025-06-29,26,DPD30-59,2,2,0
2025-06-29,26,DPD60-89,0,0,0
2025-06-29,26,DPD90+,0,0,0
2025-06-29,32,Current,0,0,0
2025-06-29,32,DPD15-29,42,35,7
2025-06-29,32,DPD3-14,65,50,15
2025-06-29,32,DPD30-59,41,41,0
2025-06-29,32,DPD60-89,0,0,0
2025-06-29,32,DPD90+,0,0,0
2025-06-29,34,Current,0,0,0
2025-06-29,34,DPD15-29,10,8,2
2025-06-29,34,DPD3-14,21,15,6
2025-06-29,34,DPD30-59,13,13,0
2025-06-29,34,DPD60-89,0,0,0
2025-06-29,34,DPD90+,0,0,0
2025-06-29,36,Current,0,0,0
2025-06-29,36,DPD15-29,6,3,3
2025-06-29,36,DPD3-14,8,5,3
2025-06-29,36,DPD30-59,5,5,0
2025-06-29,36,DPD60-89,0,0,0
2025-06-29,36,DPD90+,0,0,0
2025-06-29,38,Current,1,0,1
2025-06-29,38,DPD15-29,13,10,3
2025-06-29,38,DPD3-14,23,15,8
2025-06-29,38,DPD30-59,10,10,0
2025-06-29,38,DPD60-89,0,0,0
2025-06-29,38,DPD90+,0,0,0
2025-06-29,40,Current,0,0,0
2025-06-29,40,DPD15-29,6,5,1
2025-06-29,40,DPD3-14,11,6,5
2025-06-29,40,DPD30-59,7,7,0
2025-06-29,40,DPD60-89,0,0,0
2025-06-29,40,DPD90+,0,0,0
2025-06-29,42,Current,0,0,0
2025-06-29,42,DPD15-29,6,5,1
2025-06-29,42,DPD3-14,4,3,1
2025-06-29,42,DPD30-59,4,4,0
2025-06-29,42,DPD60-89,0,0,0
2025-06-29,42,DPD90+,0,0,0
2025-06-29,44,Current,1,1,0
2025-06-29,44,DPD15-29,9,7,2
2025-06-29,44,DPD3-14,19,16,3
2025-06-29,44,DPD30-59,9,9,0
2025-06-29,44,DPD60-89,0,0,0
2025-06-29,44,DPD90+,0,0,0
2025-06-29,46,Current,0,0,0
2025-06-29,46,DPD15-29,1,1,0
2025-06-29,48,Current,19,1,18
2025-06-29,48,DPD15-29,22,15,7
2025-06-29,48,DPD3-14,15,13,2
2025-06-29,48,DPD30-59,13,13,0
2025-06-29,48,DPD60-89,0,0,0
2025-06-29,48,DPD90+,0,0,0
2025-06-29,54,Current,9,0,9
2025-06-29,56,Current,0,0,0
2025-06-29,56,DPD15-29,0,0,0
2025-06-29,56,DPD3-14,0,0,0
2025-06-29,56,DPD30-59,0,0,0
2025-06-29,6,Current,0,0,0
2025-06-28,100,Current,0,0,0
2025-06-28,102,Current,0,0,0
2025-06-28,104,Current,0,0,0
2025-06-28,104,DPD3-14,0,0,0
2025-06-28,20,Current,0,0,0
2025-06-28,20,DPD15-29,74,61,13
2025-06-28,20,DPD3-14,80,67,13
2025-06-28,20,DPD30-59,51,51,0
2025-06-28,20,DPD60-89,0,0,0
2025-06-28,20,DPD90+,0,0,0
2025-06-28,22,Current,0,0,0
2025-06-28,24,Current,28,5,23
2025-06-28,24,DPD15-29,52,38,14
2025-06-28,24,DPD3-14,49,36,13
2025-06-28,24,DPD30-59,41,41,0
2025-06-28,24,DPD60-89,0,0,0
2025-06-28,24,DPD90+,0,0,0
2025-06-28,26,Current,0,0,0
2025-06-28,26,DPD15-29,6,5,1
2025-06-28,26,DPD3-14,8,7,1
2025-06-28,26,DPD30-59,2,2,0
2025-06-28,26,DPD60-89,0,0,0
2025-06-28,26,DPD90+,0,0,0
2025-06-28,32,Current,0,0,0
2025-06-28,32,DPD15-29,27,24,3
2025-06-28,32,DPD3-14,52,41,11
2025-06-28,32,DPD30-59,29,29,0
2025-06-28,32,DPD60-89,0,0,0
2025-06-28,32,DPD90+,0,0,0
2025-06-28,34,Current,0,0,0
2025-06-28,34,DPD15-29,16,14,2
2025-06-28,34,DPD3-14,12,10,2
2025-06-28,34,DPD30-59,8,8,0
2025-06-28,34,DPD60-89,0,0,0
2025-06-28,34,DPD90+,0,0,0
2025-06-28,36,Current,0,0,0
2025-06-28,36,DPD15-29,12,12,0
2025-06-28,36,DPD3-14,7,5,2
2025-06-28,36,DPD30-59,8,8,0
2025-06-28,36,DPD60-89,0,0,0
2025-06-28,36,DPD90+,0,0,0
2025-06-28,38,Current,1,0,1
2025-06-28,38,DPD15-29,15,14,1
2025-06-28,38,DPD3-14,16,11,5
2025-06-28,38,DPD30-59,4,4,0
2025-06-28,38,DPD60-89,0,0,0
2025-06-28,38,DPD90+,0,0,0
2025-06-28,40,Current,0,0,0
2025-06-28,40,DPD15-29,9,8,1
2025-06-28,40,DPD3-14,7,4,3
2025-06-28,40,DPD30-59,4,4,0
2025-06-28,40,DPD60-89,0,0,0
2025-06-28,40,DPD90+,0,0,0
2025-06-28,42,Current,0,0,0
2025-06-28,42,DPD15-29,2,2,0
2025-06-28,42,DPD3-14,4,3,1
2025-06-28,42,DPD30-59,2,2,0
2025-06-28,42,DPD60-89,0,0,0
2025-06-28,42,DPD90+,0,0,0
2025-06-28,44,Current,3,3,0
2025-06-28,44,DPD15-29,3,2,1
2025-06-28,44,DPD3-14,8,5,3
2025-06-28,44,DPD30-59,12,12,0
2025-06-28,44,DPD60-89,0,0,0
2025-06-28,44,DPD90+,0,0,0
2025-06-28,46,Current,0,0,0
2025-06-28,46,DPD15-29,0,0,0
2025-06-28,48,Current,31,2,29
2025-06-28,48,DPD15-29,17,11,6
2025-06-28,48,DPD3-14,22,15,7
2025-06-28,48,DPD30-59,12,12,0
2025-06-28,48,DPD60-89,0,0,0
2025-06-28,48,DPD90+,0,0,0
2025-06-28,54,Current,19,4,15
2025-06-28,56,Current,0,0,0
2025-06-28,56,DPD3-14,0,0,0
2025-06-28,56,DPD30-59,0,0,0
2025-06-28,6,Current,0,0,0
2025-06-27,100,Current,0,0,0
2025-06-27,102,Current,0,0,0
2025-06-27,104,Current,0,0,0
2025-06-27,20,Current,0,0,0
2025-06-27,20,DPD15-29,129,105,24
2025-06-27,20,DPD3-14,96,76,20
2025-06-27,20,DPD30-59,81,80,1
2025-06-27,20,DPD60-89,0,0,0
2025-06-27,20,DPD90+,0,0,0
2025-06-27,22,Current,0,0,0
2025-06-27,24,Current,83,10,73
2025-06-27,24,DPD15-29,68,56,12
2025-06-27,24,DPD3-14,71,56,15
2025-06-27,24,DPD30-59,50,49,1
2025-06-27,24,DPD60-89,0,0,0
2025-06-27,24,DPD90+,0,0,0
2025-06-27,26,Current,0,0,0
2025-06-27,26,DPD15-29,12,10,2
2025-06-27,26,DPD3-14,8,3,5
2025-06-27,26,DPD30-59,1,1,0
2025-06-27,26,DPD60-89,0,0,0
2025-06-27,26,DPD90+,0,0,0
2025-06-27,32,Current,0,0,0
2025-06-27,32,DPD15-29,61,50,11
2025-06-27,32,DPD3-14,78,63,15
2025-06-27,32,DPD30-59,37,37,0
2025-06-27,32,DPD60-89,0,0,0
2025-06-27,32,DPD90+,0,0,0
2025-06-27,34,Current,0,0,0
2025-06-27,34,DPD15-29,16,13,3
2025-06-27,34,DPD3-14,21,19,2
2025-06-27,34,DPD30-59,12,12,0
2025-06-27,34,DPD60-89,0,0,0
2025-06-27,34,DPD90+,0,0,0
2025-06-27,36,Current,0,0,0
2025-06-27,36,DPD15-29,8,5,3
2025-06-27,36,DPD3-14,9,9,0
2025-06-27,36,DPD30-59,3,3,0
2025-06-27,36,DPD60-89,0,0,0
2025-06-27,36,DPD90+,0,0,0
2025-06-27,38,Current,3,0,3
2025-06-27,38,DPD15-29,23,18,5
2025-06-27,38,DPD3-14,23,15,8
2025-06-27,38,DPD30-59,8,8,0
2025-06-27,38,DPD60-89,0,0,0
2025-06-27,38,DPD90+,0,0,0
2025-06-27,40,Current,0,0,0
2025-06-27,40,DPD15-29,7,5,2
2025-06-27,40,DPD3-14,7,4,3
2025-06-27,40,DPD30-59,8,8,0
2025-06-27,40,DPD60-89,0,0,0
2025-06-27,40,DPD90+,0,0,0
2025-06-27,42,Current,0,0,0
2025-06-27,42,DPD15-29,4,3,1
2025-06-27,42,DPD3-14,4,3,1
2025-06-27,42,DPD30-59,4,4,0
2025-06-27,42,DPD60-89,0,0,0
2025-06-27,42,DPD90+,0,0,0
2025-06-27,44,Current,0,0,0
2025-06-27,44,DPD15-29,13,9,4
2025-06-27,44,DPD3-14,15,14,1
2025-06-27,44,DPD30-59,10,10,0
2025-06-27,44,DPD60-89,0,0,0
2025-06-27,44,DPD90+,0,0,0
2025-06-27,46,Current,0,0,0
2025-06-27,46,DPD15-29,2,2,0
2025-06-27,48,Current,19,2,17
2025-06-27,48,DPD15-29,22,15,7
2025-06-27,48,DPD3-14,20,18,2
2025-06-27,48,DPD30-59,15,15,0
2025-06-27,48,DPD60-89,0,0,0
2025-06-27,48,DPD90+,0,0,0
2025-06-27,54,Current,28,1,27
2025-06-27,56,Current,0,0,0
2025-06-27,56,DPD15-29,1,1,0
2025-06-27,56,DPD3-14,1,1,0
2025-06-27,56,DPD30-59,0,0,0
2025-06-27,6,Current,0,0,0
2025-06-26,100,Current,0,0,0
2025-06-26,100,DPD15-29,0,0,0
2025-06-26,102,Current,0,0,0
2025-06-26,104,Current,0,0,0
2025-06-26,20,Current,0,0,0
2025-06-26,20,DPD15-29,79,66,13
2025-06-26,20,DPD3-14,180,155,25
2025-06-26,20,DPD30-59,66,66,0
2025-06-26,20,DPD60-89,0,0,0
2025-06-26,20,DPD90+,0,0,0
2025-06-26,22,Current,0,0,0
2025-06-26,24,Current,43,5,38
2025-06-26,24,DPD15-29,59,44,15
2025-06-26,24,DPD3-14,119,107,12
2025-06-26,24,DPD30-59,44,44,0
2025-06-26,24,DPD60-89,0,0,0
2025-06-26,24,DPD90+,0,0,0
2025-06-26,26,Current,0,0,0
2025-06-26,26,DPD15-29,8,7,1
2025-06-26,26,DPD3-14,13,12,1
2025-06-26,26,DPD30-59,1,1,0
2025-06-26,26,DPD60-89,0,0,0
2025-06-26,26,DPD90+,0,0,0
2025-06-26,32,Current,0,0,0
2025-06-26,32,DPD15-29,45,41,4
2025-06-26,32,DPD3-14,97,85,12
2025-06-26,32,DPD30-59,40,40,0
2025-06-26,32,DPD60-89,0,0,0
2025-06-26,32,DPD90+,0,0,0
2025-06-26,34,Current,0,0,0
2025-06-26,34,DPD15-29,18,14,4
2025-06-26,34,DPD3-14,25,18,7
2025-06-26,34,DPD30-59,9,9,0
2025-06-26,34,DPD60-89,0,0,0
2025-06-26,34,DPD90+,0,0,0
2025-06-26,36,Current,0,0,0
2025-06-26,36,DPD15-29,14,13,1
2025-06-26,36,DPD3-14,24,19,5
2025-06-26,36,DPD30-59,9,9,0
2025-06-26,36,DPD60-89,0,0,0
2025-06-26,36,DPD90+,0,0,0
2025-06-26,38,Current,2,0,2
2025-06-26,38,DPD15-29,14,13,1
2025-06-26,38,DPD3-14,29,25,4
2025-06-26,38,DPD30-59,9,9,0
2025-06-26,38,DPD60-89,0,0,0
2025-06-26,38,DPD90+,0,0,0
2025-06-26,40,Current,0,0,0
2025-06-26,40,DPD15-29,13,11,2
2025-06-26,40,DPD3-14,20,16,4
2025-06-26,40,DPD30-59,5,5,0
2025-06-26,40,DPD60-89,0,0,0
2025-06-26,40,DPD90+,0,0,0
2025-06-26,42,Current,0,0,0
2025-06-26,42,DPD15-29,3,3,0
2025-06-26,42,DPD3-14,10,10,0
2025-06-26,42,DPD30-59,2,2,0
2025-06-26,42,DPD60-89,0,0,0
2025-06-26,42,DPD90+,0,0,0
2025-06-26,44,Current,0,0,0
2025-06-26,44,DPD15-29,7,5,2
2025-06-26,44,DPD3-14,24,19,5
2025-06-26,44,DPD30-59,14,14,0
2025-06-26,44,DPD60-89,0,0,0
2025-06-26,44,DPD90+,0,0,0
2025-06-26,46,Current,0,0,0
2025-06-26,46,DPD15-29,0,0,0
2025-06-26,48,Current,15,3,12
2025-06-26,48,DPD15-29,17,12,5
2025-06-26,48,DPD3-14,41,33,8
2025-06-26,48,DPD30-59,15,15,0
2025-06-26,48,DPD60-89,0,0,0
2025-06-26,48,DPD90+,0,0,0
2025-06-26,54,Current,0,0,0
2025-06-26,56,Current,17,2,15
2025-06-26,56,DPD15-29,0,0,0
2025-06-26,56,DPD3-14,1,1,0
2025-06-26,56,DPD30-59,1,1,0
2025-06-26,6,Current,0,0,0
2025-06-25,100,Current,0,0,0
2025-06-25,100,DPD15-29,0,0,0
2025-06-25,102,Current,0,0,0
2025-06-25,104,Current,0,0,0
2025-06-25,20,Current,0,0,0
2025-06-25,20,DPD15-29,141,118,23
2025-06-25,20,DPD3-14,79,65,14
2025-06-25,20,DPD30-59,79,78,1
2025-06-25,20,DPD60-89,0,0,0
2025-06-25,20,DPD90+,0,0,0
2025-06-25,22,Current,0,0,0
2025-06-25,24,Current,37,3,34
2025-06-25,24,DPD15-29,84,71,13
2025-06-25,24,DPD3-14,53,47,6
2025-06-25,24,DPD30-59,49,48,1
2025-06-25,24,DPD60-89,0,0,0
2025-06-25,24,DPD90+,0,0,0
2025-06-25,26,Current,0,0,0
2025-06-25,26,DPD15-29,18,15,3
2025-06-25,26,DPD3-14,8,6,2
2025-06-25,26,DPD30-59,2,2,0
2025-06-25,26,DPD60-89,0,0,0
2025-06-25,26,DPD90+,0,0,0
2025-06-25,32,Current,0,0,0
2025-06-25,32,DPD15-29,73,63,10
2025-06-25,32,DPD3-14,47,41,6
2025-06-25,32,DPD30-59,37,37,0
2025-06-25,32,DPD60-89,0,0,0
2025-06-25,32,DPD90+,0,0,0
2025-06-25,34,Current,0,0,0
2025-06-25,34,DPD15-29,18,15,3
2025-06-25,34,DPD3-14,17,17,0
2025-06-25,34,DPD30-59,14,14,0
2025-06-25,34,DPD60-89,0,0,0
2025-06-25,34,DPD90+,0,0,0
2025-06-25,36,Current,0,0,0
2025-06-25,36,DPD15-29,9,5,4
2025-06-25,36,DPD3-14,6,6,0
2025-06-25,36,DPD30-59,4,4,0
2025-06-25,36,DPD60-89,0,0,0
2025-06-25,36,DPD90+,0,0,0
2025-06-25,38,Current,3,0,3
2025-06-25,38,DPD15-29,28,22,6
2025-06-25,38,DPD3-14,25,20,5
2025-06-25,38,DPD30-59,8,8,0
2025-06-25,38,DPD60-89,0,0,0
2025-06-25,38,DPD90+,0,0,0
2025-06-25,40,Current,0,0,0
2025-06-25,40,DPD15-29,8,6,2
2025-06-25,40,DPD3-14,9,6,3
2025-06-25,40,DPD30-59,6,6,0
2025-06-25,40,DPD60-89,0,0,0
2025-06-25,40,DPD90+,0,0,0
2025-06-25,42,Current,0,0,0
2025-06-25,42,DPD15-29,6,5,1
2025-06-25,42,DPD3-14,0,0,0
2025-06-25,42,DPD30-59,4,4,0
2025-06-25,42,DPD60-89,0,0,0
2025-06-25,42,DPD90+,0,0,0
2025-06-25,44,Current,0,0,0
2025-06-25,44,DPD15-29,13,8,5
2025-06-25,44,DPD3-14,15,14,1
2025-06-25,44,DPD30-59,10,10,0
2025-06-25,44,DPD60-89,0,0,0
2025-06-25,44,DPD90+,0,0,0
2025-06-25,46,Current,0,0,0
2025-06-25,46,DPD15-29,2,2,0
2025-06-25,48,Current,32,2,30
2025-06-25,48,DPD15-29,24,14,10
2025-06-25,48,DPD3-14,21,15,6
2025-06-25,48,DPD30-59,20,20,0
2025-06-25,48,DPD60-89,0,0,0
2025-06-25,48,DPD90+,0,0,0
2025-06-25,54,Current,14,0,14
2025-06-25,56,Current,0,0,0
2025-06-25,56,DPD15-29,1,1,0
2025-06-25,56,DPD3-14,1,1,0
2025-06-25,56,DPD30-59,0,0,0
2025-06-25,6,Current,0,0,0
2025-06-24,100,Current,0,0,0
2025-06-24,100,DPD15-29,0,0,0
2025-06-24,102,Current,0,0,0
2025-06-24,104,Current,0,0,0
2025-06-24,20,Current,0,0,0
2025-06-24,20,DPD15-29,82,71,11
2025-06-24,20,DPD3-14,114,94,20
2025-06-24,20,DPD30-59,62,62,0
2025-06-24,20,DPD60-89,0,0,0
2025-06-24,20,DPD90+,0,0,0
2025-06-24,22,Current,0,0,0
2025-06-24,24,Current,25,10,15
2025-06-24,24,DPD15-29,53,41,12
2025-06-24,24,DPD3-14,92,79,13
2025-06-24,24,DPD30-59,45,45,0
2025-06-24,24,DPD60-89,0,0,0
2025-06-24,24,DPD90+,0,0,0
2025-06-24,26,Current,0,0,0
2025-06-24,26,DPD15-29,7,6,1
2025-06-24,26,DPD3-14,11,9,2
2025-06-24,26,DPD30-59,2,2,0
2025-06-24,26,DPD60-89,0,0,0
2025-06-24,26,DPD90+,0,0,0
2025-06-24,32,Current,1,1,0
2025-06-24,32,DPD15-29,53,48,5
2025-06-24,32,DPD3-14,57,47,10
2025-06-24,32,DPD30-59,38,38,0
2025-06-24,32,DPD60-89,0,0,0
2025-06-24,32,DPD90+,0,0,0
2025-06-24,34,Current,0,0,0
2025-06-24,34,DPD15-29,21,15,6
2025-06-24,34,DPD3-14,14,12,2
2025-06-24,34,DPD30-59,11,11,0
2025-06-24,34,DPD60-89,0,0,0
2025-06-24,34,DPD90+,0,0,0
2025-06-24,36,Current,0,0,0
2025-06-24,36,DPD15-29,15,14,1
2025-06-24,36,DPD3-14,11,9,2
2025-06-24,36,DPD30-59,8,8,0
2025-06-24,36,DPD60-89,0,0,0
2025-06-24,36,DPD90+,0,0,0
2025-06-24,38,Current,2,1,1
2025-06-24,38,DPD15-29,18,15,3
2025-06-24,38,DPD3-14,12,8,4
2025-06-24,38,DPD30-59,7,7,0
2025-06-24,38,DPD60-89,0,0,0
2025-06-24,38,DPD90+,0,0,0
2025-06-24,40,Current,0,0,0
2025-06-24,40,DPD15-29,11,7,4
2025-06-24,40,DPD3-14,10,10,0
2025-06-24,40,DPD30-59,6,6,0
2025-06-24,40,DPD60-89,0,0,0
2025-06-24,40,DPD90+,0,0,0
2025-06-24,42,Current,0,0,0
2025-06-24,42,DPD15-29,2,2,0
2025-06-24,42,DPD3-14,7,5,2
2025-06-24,42,DPD30-59,1,1,0
2025-06-24,42,DPD60-89,0,0,0
2025-06-24,42,DPD90+,0,0,0
2025-06-24,44,Current,2,2,0
2025-06-24,44,DPD15-29,8,6,2
2025-06-24,44,DPD3-14,14,13,1
2025-06-24,44,DPD30-59,14,14,0
2025-06-24,44,DPD60-89,0,0,0
2025-06-24,44,DPD90+,0,0,0
2025-06-24,46,Current,0,0,0
2025-06-24,46,DPD15-29,0,0,0
2025-06-24,48,Current,32,4,28
2025-06-24,48,DPD15-29,15,11,4
2025-06-24,48,DPD3-14,32,25,7
2025-06-24,48,DPD30-59,13,13,0
2025-06-24,48,DPD60-89,0,0,0
2025-06-24,48,DPD90+,0,0,0
2025-06-24,54,Current,9,4,5
2025-06-24,56,Current,2,2,0
2025-06-24,56,DPD15-29,0,0,0
2025-06-24,56,DPD3-14,2,2,0
2025-06-24,56,DPD30-59,1,1,0
2025-06-24,6,Current,0,0,0
2025-06-23,100,Current,0,0,0
2025-06-23,100,DPD15-29,0,0,0
2025-06-23,102,Current,0,0,0
2025-06-23,104,Current,0,0,0
2025-06-23,20,Current,0,0,0
2025-06-23,20,DPD15-29,146,121,25
2025-06-23,20,DPD3-14,91,78,13
2025-06-23,20,DPD30-59,68,67,1
2025-06-23,20,DPD60-89,0,0,0
2025-06-23,20,DPD90+,0,0,0
2025-06-23,22,Current,0,0,0
2025-06-23,24,Current,69,2,67
2025-06-23,24,DPD15-29,84,70,14
2025-06-23,24,DPD3-14,67,53,14
2025-06-23,24,DPD30-59,40,39,1
2025-06-23,24,DPD60-89,0,0,0
2025-06-23,24,DPD90+,0,0,0
2025-06-23,26,Current,0,0,0
2025-06-23,26,DPD15-29,15,12,3
2025-06-23,26,DPD3-14,10,10,0
2025-06-23,26,DPD30-59,1,1,0
2025-06-23,26,DPD60-89,0,0,0
2025-06-23,26,DPD90+,0,0,0
2025-06-23,32,Current,0,0,0
2025-06-23,32,DPD15-29,80,69,11
2025-06-23,32,DPD3-14,32,28,4
2025-06-23,32,DPD30-59,32,32,0
2025-06-23,32,DPD60-89,0,0,0
2025-06-23,32,DPD90+,0,0,0
2025-06-23,34,Current,0,0,0
2025-06-23,34,DPD15-29,21,17,4
2025-06-23,34,DPD3-14,16,16,0
2025-06-23,34,DPD30-59,14,14,0
2025-06-23,34,DPD60-89,0,0,0
2025-06-23,34,DPD90+,0,0,0
2025-06-23,36,Current,0,0,0
2025-06-23,36,DPD15-29,9,6,3
2025-06-23,36,DPD3-14,4,4,0
2025-06-23,36,DPD30-59,4,4,0
2025-06-23,36,DPD60-89,0,0,0
2025-06-23,36,DPD90+,0,0,0
2025-06-23,38,Current,7,1,6
2025-06-23,38,DPD15-29,27,21,6
2025-06-23,38,DPD3-14,16,13,3
2025-06-23,38,DPD30-59,5,5,0
2025-06-23,38,DPD60-89,0,0,0
2025-06-23,38,DPD90+,0,0,0
2025-06-23,40,Current,0,0,0
2025-06-23,40,DPD15-29,11,8,3
2025-06-23,40,DPD3-14,3,2,1
2025-06-23,40,DPD30-59,7,7,0
2025-06-23,40,DPD60-89,0,0,0
2025-06-23,40,DPD90+,0,0,0
2025-06-23,42,Current,0,0,0
2025-06-23,42,DPD15-29,8,7,1
2025-06-23,42,DPD3-14,1,1,0
2025-06-23,42,DPD30-59,2,2,0
2025-06-23,42,DPD60-89,0,0,0
2025-06-23,42,DPD90+,0,0,0
2025-06-23,44,Current,0,0,0
2025-06-23,44,DPD15-29,13,8,5
2025-06-23,44,DPD3-14,14,11,3
2025-06-23,44,DPD30-59,10,10,0
2025-06-23,44,DPD60-89,0,0,0
2025-06-23,44,DPD90+,0,0,0
2025-06-23,46,Current,0,0,0
2025-06-23,46,DPD15-29,2,2,0
2025-06-23,48,Current,82,9,73
2025-06-23,48,DPD15-29,28,16,12
2025-06-23,48,DPD3-14,29,18,11
2025-06-23,48,DPD30-59,18,18,0
2025-06-23,48,DPD60-89,0,0,0
2025-06-23,48,DPD90+,0,0,0
2025-06-23,54,Current,28,2,26
2025-06-23,56,Current,14,0,14
2025-06-23,56,DPD15-29,1,1,0
2025-06-23,56,DPD3-14,0,0,0
2025-06-23,56,DPD30-59,0,0,0
2025-06-23,6,Current,0,0,0
2025-06-22,100,Current,0,0,0
2025-06-22,100,DPD15-29,0,0,0
2025-06-22,102,Current,0,0,0
2025-06-22,104,Current,0,0,0
2025-06-22,20,Current,0,0,0
2025-06-22,20,DPD15-29,82,70,12
2025-06-22,20,DPD3-14,93,79,14
2025-06-22,20,DPD30-59,64,63,1
2025-06-22,20,DPD60-89,0,0,0
2025-06-22,20,DPD90+,0,0,0
2025-06-22,22,Current,0,0,0
2025-06-22,24,Current,12,2,10
2025-06-22,24,DPD15-29,46,37,9
2025-06-22,24,DPD3-14,59,49,10
2025-06-22,24,DPD30-59,43,43,0
2025-06-22,24,DPD60-89,0,0,0
2025-06-22,24,DPD90+,0,0,0
2025-06-22,26,Current,0,0,0
2025-06-22,26,DPD15-29,6,5,1
2025-06-22,26,DPD3-14,8,5,3
2025-06-22,26,DPD30-59,1,1,0
2025-06-22,26,DPD60-89,0,0,0
2025-06-22,26,DPD90+,0,0,0
2025-06-22,32,Current,0,0,0
2025-06-22,32,DPD15-29,47,40,7
2025-06-22,32,DPD3-14,39,33,6
2025-06-22,32,DPD30-59,36,36,0
2025-06-22,32,DPD60-89,0,0,0
2025-06-22,32,DPD90+,0,0,0
2025-06-22,34,Current,0,0,0
2025-06-22,34,DPD15-29,22,16,6
2025-06-22,34,DPD3-14,14,13,1
2025-06-22,34,DPD30-59,13,13,0
2025-06-22,34,DPD60-89,0,0,0
2025-06-22,34,DPD90+,0,0,0
2025-06-22,36,Current,0,0,0
2025-06-22,36,DPD15-29,14,13,1
2025-06-22,36,DPD3-14,11,9,2
2025-06-22,36,DPD30-59,8,8,0
2025-06-22,36,DPD60-89,0,0,0
2025-06-22,36,DPD90+,0,0,0
2025-06-22,38,Current,6,1,5
2025-06-22,38,DPD15-29,15,10,5
2025-06-22,38,DPD3-14,11,7,4
2025-06-22,38,DPD30-59,11,11,0
2025-06-22,38,DPD60-89,0,0,0
2025-06-22,38,DPD90+,0,0,0
2025-06-22,40,Current,0,0,0
2025-06-22,40,DPD15-29,9,6,3
2025-06-22,40,DPD3-14,11,9,2
2025-06-22,40,DPD30-59,6,6,0
2025-06-22,40,DPD60-89,0,0,0
2025-06-22,40,DPD90+,0,0,0
2025-06-22,42,Current,0,0,0
2025-06-22,42,DPD15-29,2,2,0
2025-06-22,42,DPD3-14,2,2,0
2025-06-22,42,DPD30-59,1,1,0
2025-06-22,42,DPD60-89,0,0,0
2025-06-22,42,DPD90+,0,0,0
2025-06-22,44,Current,0,0,0
2025-06-22,44,DPD15-29,9,7,2
2025-06-22,44,DPD3-14,21,19,2
2025-06-22,44,DPD30-59,11,11,0
2025-06-22,44,DPD60-89,0,0,0
2025-06-22,44,DPD90+,0,0,0
2025-06-22,46,Current,0,0,0
2025-06-22,46,DPD15-29,0,0,0
2025-06-22,48,Current,29,1,28
2025-06-22,48,DPD15-29,16,11,5
2025-06-22,48,DPD3-14,30,23,7
2025-06-22,48,DPD30-59,13,13,0
2025-06-22,48,DPD60-89,0,0,0
2025-06-22,48,DPD90+,0,0,0
2025-06-22,54,Current,3,0,3
2025-06-22,56,Current,16,3,13
2025-06-22,56,DPD15-29,0,0,0
2025-06-22,56,DPD30-59,1,1,0
2025-06-22,6,Current,0,0,0
2025-06-21,100,Current,0,0,0
2025-06-21,100,DPD15-29,0,0,0
2025-06-21,102,Current,0,0,0
2025-06-21,104,Current,0,0,0
2025-06-21,20,Current,0,0,0
2025-06-21,20,DPD15-29,157,135,22
2025-06-21,20,DPD3-14,159,136,23
2025-06-21,20,DPD30-59,71,70,1
2025-06-21,20,DPD60-89,0,0,0
2025-06-21,20,DPD90+,0,0,0
2025-06-21,22,Current,0,0,0
2025-06-21,24,Current,15,3,12
2025-06-21,24,DPD15-29,88,73,15
2025-06-21,24,DPD3-14,97,72,25
2025-06-21,24,DPD30-59,41,40,1
2025-06-21,24,DPD60-89,0,0,0
2025-06-21,24,DPD90+,0,0,0
2025-06-21,26,Current,0,0,0
2025-06-21,26,DPD15-29,15,12,3
2025-06-21,26,DPD3-14,12,12,0
2025-06-21,26,DPD30-59,1,1,0
2025-06-21,26,DPD60-89,0,0,0
2025-06-21,26,DPD90+,0,0,0
2025-06-21,32,Current,0,0,0
2025-06-21,32,DPD15-29,85,74,11
2025-06-21,32,DPD3-14,77,63,14
2025-06-21,32,DPD30-59,35,35,0
2025-06-21,32,DPD60-89,0,0,0
2025-06-21,32,DPD90+,0,0,0
2025-06-21,34,Current,0,0,0
2025-06-21,34,DPD15-29,23,19,4
2025-06-21,34,DPD3-14,26,22,4
2025-06-21,34,DPD30-59,14,14,0
2025-06-21,34,DPD60-89,0,0,0
2025-06-21,34,DPD90+,0,0,0
2025-06-21,36,Current,0,0,0
2025-06-21,36,DPD15-29,9,6,3
2025-06-21,36,DPD3-14,15,13,2
2025-06-21,36,DPD30-59,5,5,0
2025-06-21,36,DPD60-89,0,0,0
2025-06-21,36,DPD90+,0,0,0
2025-06-21,38,Current,6,1,5
2025-06-21,38,DPD15-29,29,24,5
2025-06-21,38,DPD3-14,21,18,3
2025-06-21,38,DPD30-59,5,5,0
2025-06-21,38,DPD60-89,0,0,0
2025-06-21,38,DPD90+,0,0,0
2025-06-21,40,Current,0,0,0
2025-06-21,40,DPD15-29,12,9,3
2025-06-21,40,DPD3-14,17,14,3
2025-06-21,40,DPD30-59,7,7,0
2025-06-21,40,DPD60-89,0,0,0
2025-06-21,40,DPD90+,0,0,0
2025-06-21,42,Current,0,0,0
2025-06-21,42,DPD15-29,7,6,1
2025-06-21,42,DPD3-14,10,10,0
2025-06-21,42,DPD30-59,2,2,0
2025-06-21,42,DPD60-89,0,0,0
2025-06-21,42,DPD90+,0,0,0
2025-06-21,44,Current,0,0,0
2025-06-21,44,DPD15-29,13,9,4
2025-06-21,44,DPD3-14,26,21,5
2025-06-21,44,DPD30-59,9,9,0
2025-06-21,44,DPD60-89,0,0,0
2025-06-21,44,DPD90+,0,0,0
2025-06-21,46,Current,0,0,0
2025-06-21,46,DPD3-14,1,0,1
2025-06-21,48,Current,36,3,33
2025-06-21,48,DPD15-29,27,16,11
2025-06-21,48,DPD3-14,30,23,7
2025-06-21,48,DPD30-59,16,16,0
2025-06-21,48,DPD60-89,0,0,0
2025-06-21,48,DPD90+,0,0,0
2025-06-21,54,Current,1,0,1
2025-06-21,56,Current,7,0,7
2025-06-21,56,DPD15-29,1,1,0
2025-06-21,56,DPD30-59,0,0,0
2025-06-21,6,Current,0,0,0
2025-06-20,100,Current,0,0,0
2025-06-20,100,DPD15-29,0,0,0
2025-06-20,102,Current,0,0,0
2025-06-20,104,Current,0,0,0
2025-06-20,20,Current,0,0,0
2025-06-20,20,DPD15-29,87,78,9
2025-06-20,20,DPD3-14,96,77,19
2025-06-20,20,DPD30-59,74,73,1
2025-06-20,20,DPD60-89,0,0,0
2025-06-20,20,DPD90+,0,0,0
2025-06-20,22,Current,0,0,0
2025-06-20,24,Current,32,4,28
2025-06-20,24,DPD15-29,53,48,5
2025-06-20,24,DPD3-14,54,47,7
2025-06-20,24,DPD30-59,47,47,0
2025-06-20,24,DPD60-89,0,0,0
2025-06-20,24,DPD90+,0,0,0
2025-06-20,26,Current,0,0,0
2025-06-20,26,DPD15-29,3,2,1
2025-06-20,26,DPD3-14,8,6,2
2025-06-20,26,DPD30-59,2,2,0
2025-06-20,26,DPD60-89,0,0,0
2025-06-20,26,DPD90+,0,0,0
2025-06-20,32,Current,0,0,0
2025-06-20,32,DPD15-29,58,52,6
2025-06-20,32,DPD3-14,47,41,6
2025-06-20,32,DPD30-59,36,36,0
2025-06-20,32,DPD60-89,0,0,0
2025-06-20,32,DPD90+,0,0,0
2025-06-20,34,Current,0,0,0
2025-06-20,34,DPD15-29,22,16,6
2025-06-20,34,DPD3-14,17,15,2
2025-06-20,34,DPD30-59,17,17,0
2025-06-20,34,DPD60-89,0,0,0
2025-06-20,34,DPD90+,0,0,0
2025-06-20,36,Current,0,0,0
2025-06-20,36,DPD15-29,14,13,1
2025-06-20,36,DPD3-14,10,7,3
2025-06-20,36,DPD30-59,7,7,0
2025-06-20,36,DPD60-89,0,0,0
2025-06-20,36,DPD90+,0,0,0
2025-06-20,38,Current,7,1,6
2025-06-20,38,DPD15-29,14,9,5
2025-06-20,38,DPD3-14,12,9,3
2025-06-20,38,DPD30-59,12,12,0
2025-06-20,38,DPD60-89,0,0,0
2025-06-20,38,DPD90+,0,0,0
2025-06-20,40,Current,0,0,0
2025-06-20,40,DPD15-29,10,7,3
2025-06-20,40,DPD3-14,11,11,0
2025-06-20,40,DPD30-59,7,7,0
2025-06-20,40,DPD60-89,0,0,0
2025-06-20,40,DPD90+,0,0,0
2025-06-20,42,Current,0,0,0
2025-06-20,42,DPD15-29,3,3,0
2025-06-20,42,DPD3-14,2,2,0
2025-06-20,42,DPD30-59,2,2,0
2025-06-20,42,DPD60-89,0,0,0
2025-06-20,42,DPD90+,0,0,0
2025-06-20,44,Current,0,0,0
2025-06-20,44,DPD15-29,12,10,2
2025-06-20,44,DPD3-14,22,19,3
2025-06-20,44,DPD30-59,12,12,0
2025-06-20,44,DPD60-89,0,0,0
2025-06-20,44,DPD90+,0,0,0
2025-06-20,46,Current,0,0,0
2025-06-20,46,DPD3-14,0,0,0
2025-06-20,48,Current,46,3,43
2025-06-20,48,DPD15-29,21,15,6
2025-06-20,48,DPD3-14,25,22,3
2025-06-20,48,DPD30-59,13,13,0
2025-06-20,48,DPD60-89,0,0,0
2025-06-20,48,DPD90+,0,0,0
2025-06-20,54,Current,9,3,6
2025-06-20,56,Current,3,1,2
2025-06-20,56,DPD15-29,0,0,0
2025-06-20,56,DPD3-14,3,3,0
2025-06-20,56,DPD30-59,1,1,0
2025-06-20,6,Current,0,0,0
2025-06-19,100,Current,0,0,0
2025-06-19,100,DPD15-29,0,0,0
2025-06-19,102,Current,0,0,0
2025-06-19,104,Current,0,0,0
2025-06-19,20,Current,0,0,0
2025-06-19,20,DPD15-29,171,151,20
2025-06-19,20,DPD3-14,164,131,33
2025-06-19,20,DPD30-59,74,73,1
2025-06-19,20,DPD60-89,0,0,0
2025-06-19,20,DPD90+,0,0,0
2025-06-19,22,Current,0,0,0
2025-06-19,24,Current,54,10,44
2025-06-19,24,DPD15-29,100,82,18
2025-06-19,24,DPD3-14,109,87,22
2025-06-19,24,DPD30-59,44,43,1
2025-06-19,24,DPD60-89,0,0,0
2025-06-19,24,DPD90+,0,0,0
2025-06-19,26,Current,0,0,0
2025-06-19,26,DPD15-29,16,14,2
2025-06-19,26,DPD3-14,12,12,0
2025-06-19,26,DPD30-59,2,2,0
2025-06-19,26,DPD60-89,0,0,0
2025-06-19,26,DPD90+,0,0,0
2025-06-19,32,Current,0,0,0
2025-06-19,32,DPD15-29,111,98,13
2025-06-19,32,DPD3-14,88,73,15
2025-06-19,32,DPD30-59,38,38,0
2025-06-19,32,DPD60-89,0,0,0
2025-06-19,32,DPD90+,1,1,0
2025-06-19,34,Current,0,0,0
2025-06-19,34,DPD15-29,25,22,3
2025-06-19,34,DPD3-14,25,16,9
2025-06-19,34,DPD30-59,14,14,0
2025-06-19,34,DPD60-89,0,0,0
2025-06-19,34,DPD90+,0,0,0
2025-06-19,36,Current,0,0,0
2025-06-19,36,DPD15-29,15,12,3
2025-06-19,36,DPD3-14,18,15,3
2025-06-19,36,DPD30-59,5,5,0
2025-06-19,36,DPD60-89,0,0,0
2025-06-19,36,DPD90+,0,0,0
2025-06-19,38,Current,4,0,4
2025-06-19,38,DPD15-29,33,27,6
2025-06-19,38,DPD3-14,31,27,4
2025-06-19,38,DPD30-59,6,5,1
2025-06-19,38,DPD60-89,0,0,0
2025-06-19,38,DPD90+,0,0,0
2025-06-19,40,Current,0,0,0
2025-06-19,40,DPD15-29,15,11,4
2025-06-19,40,DPD3-14,19,15,4
2025-06-19,40,DPD30-59,6,6,0
2025-06-19,40,DPD60-89,0,0,0
2025-06-19,40,DPD90+,0,0,0
2025-06-19,42,Current,0,0,0
2025-06-19,42,DPD15-29,12,11,1
2025-06-19,42,DPD3-14,15,13,2
2025-06-19,42,DPD30-59,2,2,0
2025-06-19,42,DPD60-89,0,0,0
2025-06-19,42,DPD90+,0,0,0
2025-06-19,44,Current,0,0,0
2025-06-19,44,DPD15-29,20,17,3
2025-06-19,44,DPD3-14,29,23,6
2025-06-19,44,DPD30-59,13,13,0
2025-06-19,44,DPD60-89,0,0,0
2025-06-19,44,DPD90+,0,0,0
2025-06-19,46,Current,0,0,0
2025-06-19,46,DPD3-14,1,0,1
2025-06-19,48,Current,46,14,32
2025-06-19,48,DPD15-29,31,21,10
2025-06-19,48,DPD3-14,29,25,4
2025-06-19,48,DPD30-59,17,17,0
2025-06-19,48,DPD60-89,0,0,0
2025-06-19,48,DPD90+,0,0,0
2025-06-19,54,Current,3,0,3
2025-06-19,56,Current,15,4,11
2025-06-19,56,DPD15-29,1,1,0
2025-06-19,56,DPD3-14,2,2,0
2025-06-19,56,DPD30-59,0,0,0
2025-06-19,6,Current,0,0,0
2025-06-18,100,Current,0,0,0
2025-06-18,100,DPD15-29,0,0,0
2025-06-18,102,Current,0,0,0
2025-06-18,104,Current,0,0,0
2025-06-18,20,Current,3,3,0
2025-06-18,20,DPD15-29,100,90,10
2025-06-18,20,DPD3-14,71,58,13
2025-06-18,20,DPD30-59,83,83,0
2025-06-18,20,DPD60-89,0,0,0
2025-06-18,20,DPD90+,0,0,0
2025-06-18,22,Current,0,0,0
2025-06-18,24,Current,29,15,14
2025-06-18,24,DPD15-29,64,59,5
2025-06-18,24,DPD3-14,42,33,9
2025-06-18,24,DPD30-59,38,38,0
2025-06-18,24,DPD60-89,0,0,0
2025-06-18,24,DPD90+,0,0,0
2025-06-18,26,Current,0,0,0
2025-06-18,26,DPD15-29,4,4,0
2025-06-18,26,DPD3-14,6,6,0
2025-06-18,26,DPD30-59,3,3,0
2025-06-18,26,DPD60-89,0,0,0
2025-06-18,26,DPD90+,0,0,0
2025-06-18,32,Current,2,2,0
2025-06-18,32,DPD15-29,62,55,7
2025-06-18,32,DPD3-14,23,20,3
2025-06-18,32,DPD30-59,37,37,0
2025-06-18,32,DPD60-89,0,0,0
2025-06-18,32,DPD90+,0,0,0
2025-06-18,34,Current,8,8,0
2025-06-18,34,DPD15-29,24,17,7
2025-06-18,34,DPD3-14,11,10,1
2025-06-18,34,DPD30-59,21,21,0
2025-06-18,34,DPD60-89,0,0,0
2025-06-18,34,DPD90+,1,1,0
2025-06-18,36,Current,1,1,0
2025-06-18,36,DPD15-29,17,16,1
2025-06-18,36,DPD3-14,4,3,1
2025-06-18,36,DPD30-59,10,10,0
2025-06-18,36,DPD60-89,0,0,0
2025-06-18,36,DPD90+,0,0,0
2025-06-18,38,Current,1,1,0
2025-06-18,38,DPD15-29,17,11,6
2025-06-18,38,DPD3-14,15,11,4
2025-06-18,38,DPD30-59,15,15,0
2025-06-18,38,DPD60-89,0,0,0
2025-06-18,38,DPD90+,0,0,0
2025-06-18,40,Current,1,1,0
2025-06-18,40,DPD15-29,8,6,2
2025-06-18,40,DPD3-14,9,8,1
2025-06-18,40,DPD30-59,7,7,0
2025-06-18,40,DPD60-89,0,0,0
2025-06-18,40,DPD90+,0,0,0
2025-06-18,42,Current,0,0,0
2025-06-18,42,DPD15-29,3,3,0
2025-06-18,42,DPD3-14,3,2,1
2025-06-18,42,DPD30-59,1,1,0
2025-06-18,42,DPD60-89,0,0,0
2025-06-18,42,DPD90+,0,0,0
2025-06-18,44,Current,0,0,0
2025-06-18,44,DPD15-29,16,15,1
2025-06-18,44,DPD3-14,14,12,2
2025-06-18,44,DPD30-59,10,10,0
2025-06-18,44,DPD60-89,0,0,0
2025-06-18,44,DPD90+,0,0,0
2025-06-18,46,Current,0,0,0
2025-06-18,46,DPD3-14,2,2,0
2025-06-18,48,Current,36,2,34
2025-06-18,48,DPD15-29,17,13,4
2025-06-18,48,DPD3-14,21,15,6
2025-06-18,48,DPD30-59,15,15,0
2025-06-18,48,DPD60-89,0,0,0
2025-06-18,48,DPD90+,0,0,0
2025-06-18,54,Current,24,6,18
2025-06-18,56,Current,1,1,0
2025-06-18,56,DPD15-29,0,0,0
2025-06-18,56,DPD3-14,2,2,0
2025-06-18,56,DPD30-59,0,0,0
2025-06-18,6,Current,0,0,0
2025-06-17,100,Current,0,0,0
2025-06-17,100,DPD3-14,0,0,0
2025-06-17,102,Current,0,0,0
2025-06-17,104,Current,0,0,0
2025-06-17,20,Current,5,1,4
2025-06-17,20,DPD15-29,180,164,16
2025-06-17,20,DPD3-14,72,55,17
2025-06-17,20,DPD30-59,71,70,1
2025-06-17,20,DPD60-89,0,0,0
2025-06-17,20,DPD90+,0,0,0
2025-06-17,22,Current,0,0,0
2025-06-17,24,Current,85,34,51
2025-06-17,24,DPD15-29,105,90,15
2025-06-17,24,DPD3-14,45,32,13
2025-06-17,24,DPD30-59,44,43,1
2025-06-17,24,DPD60-89,0,0,0
2025-06-17,24,DPD90+,0,0,0
2025-06-17,26,Current,1,0,1
2025-06-17,26,DPD15-29,13,12,1
2025-06-17,26,DPD3-14,8,6,2
2025-06-17,26,DPD30-59,3,3,0
2025-06-17,26,DPD60-89,0,0,0
2025-06-17,26,DPD90+,0,0,0
2025-06-17,32,Current,8,3,5
2025-06-17,32,DPD15-29,129,111,18
2025-06-17,32,DPD3-14,31,20,11
2025-06-17,32,DPD30-59,41,41,0
2025-06-17,32,DPD60-89,0,0,0
2025-06-17,32,DPD90+,0,0,0
2025-06-17,34,Current,0,0,0
2025-06-17,34,DPD15-29,29,26,3
2025-06-17,34,DPD3-14,9,7,2
2025-06-17,34,DPD30-59,14,14,0
2025-06-17,34,DPD60-89,0,0,0
2025-06-17,34,DPD90+,0,0,0
2025-06-17,36,Current,1,1,0
2025-06-17,36,DPD15-29,18,14,4
2025-06-17,36,DPD3-14,4,3,1
2025-06-17,36,DPD30-59,6,6,0
2025-06-17,36,DPD60-89,0,0,0
2025-06-17,36,DPD90+,0,0,0
2025-06-17,38,Current,6,4,2
2025-06-17,38,DPD15-29,34,28,6
2025-06-17,38,DPD3-14,11,9,2
2025-06-17,38,DPD30-59,5,4,1
2025-06-17,38,DPD60-89,0,0,0
2025-06-17,38,DPD90+,0,0,0
2025-06-17,40,Current,1,0,1
2025-06-17,40,DPD15-29,19,16,3
2025-06-17,40,DPD3-14,4,2,2
2025-06-17,40,DPD30-59,4,4,0
2025-06-17,40,DPD60-89,0,0,0
2025-06-17,40,DPD90+,0,0,0
2025-06-17,42,Current,0,0,0
2025-06-17,42,DPD15-29,12,11,1
2025-06-17,42,DPD3-14,6,4,2
2025-06-17,42,DPD30-59,1,1,0
2025-06-17,42,DPD60-89,0,0,0
2025-06-17,42,DPD90+,0,0,0
2025-06-17,44,Current,19,15,4
2025-06-17,44,DPD15-29,23,20,3
2025-06-17,44,DPD3-14,13,9,4
2025-06-17,44,DPD30-59,14,14,0
2025-06-17,44,DPD60-89,0,0,0
2025-06-17,44,DPD90+,0,0,0
2025-06-17,46,Current,0,0,0
2025-06-17,46,DPD15-29,1,1,0
2025-06-17,46,DPD3-14,0,0,0
2025-06-17,48,Current,36,17,19
2025-06-17,48,DPD15-29,27,20,7
2025-06-17,48,DPD3-14,21,18,3
2025-06-17,48,DPD30-59,16,16,0
2025-06-17,48,DPD60-89,0,0,0
2025-06-17,48,DPD90+,0,0,0
2025-06-17,54,Current,18,0,18
2025-06-17,56,Current,8,8,0
2025-06-17,56,DPD15-29,1,1,0
2025-06-17,56,DPD3-14,1,1,0
2025-06-17,56,DPD30-59,0,0,0
2025-06-17,6,Current,0,0,0
2025-06-16,100,Current,0,0,0
2025-06-16,100,DPD3-14,0,0,0
2025-06-16,102,Current,0,0,0
2025-06-16,104,Current,0,0,0
2025-06-16,20,Current,0,0,0
2025-06-16,20,DPD15-29,109,100,9
2025-06-16,20,DPD3-14,95,75,20
2025-06-16,20,DPD30-59,87,87,0
2025-06-16,20,DPD60-89,0,0,0
2025-06-16,20,DPD90+,0,0,0
2025-06-16,22,Current,0,0,0
2025-06-16,24,Current,86,17,69
2025-06-16,24,DPD15-29,70,65,5
2025-06-16,24,DPD3-14,63,47,16
2025-06-16,24,DPD30-59,42,42,0
2025-06-16,24,DPD60-89,0,0,0
2025-06-16,24,DPD90+,0,0,0
2025-06-16,26,Current,0,0,0
2025-06-16,26,DPD15-29,5,5,0
2025-06-16,26,DPD3-14,9,8,1
2025-06-16,26,DPD30-59,3,3,0
2025-06-16,26,DPD60-89,0,0,0
2025-06-16,26,DPD90+,0,0,0
2025-06-16,32,Current,0,0,0
2025-06-16,32,DPD15-29,66,60,6
2025-06-16,32,DPD3-14,28,20,8
2025-06-16,32,DPD30-59,40,40,0
2025-06-16,32,DPD60-89,0,0,0
2025-06-16,32,DPD90+,0,0,0
2025-06-16,34,Current,0,0,0
2025-06-16,34,DPD15-29,25,18,7
2025-06-16,34,DPD3-14,11,8,3
2025-06-16,34,DPD30-59,20,20,0
2025-06-16,34,DPD60-89,0,0,0
2025-06-16,34,DPD90+,0,0,0
2025-06-16,36,Current,0,0,0
2025-06-16,36,DPD15-29,14,13,1
2025-06-16,36,DPD3-14,6,5,1
2025-06-16,36,DPD30-59,11,11,0
2025-06-16,36,DPD60-89,0,0,0
2025-06-16,36,DPD90+,0,0,0
2025-06-16,38,Current,3,0,3
2025-06-16,38,DPD15-29,16,12,4
2025-06-16,38,DPD3-14,14,11,3
2025-06-16,38,DPD30-59,15,15,0
2025-06-16,38,DPD60-89,0,0,0
2025-06-16,38,DPD90+,0,0,0
2025-06-16,40,Current,0,0,0
2025-06-16,40,DPD15-29,9,7,2
2025-06-16,40,DPD3-14,6,6,0
2025-06-16,40,DPD30-59,7,7,0
2025-06-16,40,DPD60-89,0,0,0
2025-06-16,40,DPD90+,0,0,0
2025-06-16,42,Current,0,0,0
2025-06-16,42,DPD15-29,3,3,0
2025-06-16,42,DPD3-14,1,1,0
2025-06-16,42,DPD30-59,1,1,0
2025-06-16,42,DPD60-89,0,0,0
2025-06-16,42,DPD90+,0,0,0
2025-06-16,44,Current,0,0,0
2025-06-16,44,DPD15-29,15,15,0
2025-06-16,44,DPD3-14,10,9,1
2025-06-16,44,DPD30-59,12,12,0
2025-06-16,44,DPD60-89,0,0,0
2025-06-16,44,DPD90+,0,0,0
2025-06-16,46,Current,0,0,0
2025-06-16,46,DPD15-29,0,0,0
2025-06-16,46,DPD3-14,0,0,0
2025-06-16,48,Current,27,4,23
2025-06-16,48,DPD15-29,19,14,5
2025-06-16,48,DPD3-14,25,19,6
2025-06-16,48,DPD30-59,17,17,0
2025-06-16,48,DPD60-89,0,0,0
2025-06-16,48,DPD90+,0,0,0
2025-06-16,54,Current,28,4,24
2025-06-16,56,Current,0,0,0
2025-06-16,56,DPD15-29,0,0,0
2025-06-16,56,DPD3-14,1,1,0
2025-06-16,56,DPD30-59,0,0,0
2025-06-16,6,Current,0,0,0
2025-06-15,100,Current,0,0,0
2025-06-15,100,DPD3-14,0,0,0
2025-06-15,102,Current,0,0,0
2025-06-15,104,Current,0,0,0
2025-06-15,20,Current,0,0,0
2025-06-15,20,DPD15-29,170,160,10
2025-06-15,20,DPD3-14,64,54,10
2025-06-15,20,DPD30-59,77,76,1
2025-06-15,20,DPD60-89,0,0,0
2025-06-15,20,DPD90+,0,0,0
2025-06-15,22,Current,0,0,0
2025-06-15,24,Current,22,14,8
2025-06-15,24,DPD15-29,97,85,12
2025-06-15,24,DPD3-14,43,37,6
2025-06-15,24,DPD30-59,45,44,1
2025-06-15,24,DPD60-89,0,0,0
2025-06-15,24,DPD90+,0,0,0
2025-06-15,26,Current,0,0,0
2025-06-15,26,DPD15-29,14,14,0
2025-06-15,26,DPD3-14,1,1,0
2025-06-15,26,DPD30-59,3,3,0
2025-06-15,26,DPD60-89,0,0,0
2025-06-15,26,DPD90+,0,0,0
2025-06-15,32,Current,0,0,0
2025-06-15,32,DPD15-29,113,100,13
2025-06-15,32,DPD3-14,18,14,4
2025-06-15,32,DPD30-59,39,39,0
2025-06-15,32,DPD60-89,0,0,0
2025-06-15,32,DPD90+,0,0,0
2025-06-15,34,Current,0,0,0
2025-06-15,34,DPD15-29,33,31,2
2025-06-15,34,DPD3-14,8,8,0
2025-06-15,34,DPD30-59,14,14,0
2025-06-15,34,DPD60-89,0,0,0
2025-06-15,34,DPD90+,0,0,0
2025-06-15,36,Current,0,0,0
2025-06-15,36,DPD15-29,16,14,2
2025-06-15,36,DPD3-14,4,2,2
2025-06-15,36,DPD30-59,7,7,0
2025-06-15,36,DPD60-89,0,0,0
2025-06-15,36,DPD90+,0,0,0
2025-06-15,38,Current,2,0,2
2025-06-15,38,DPD15-29,27,24,3
2025-06-15,38,DPD3-14,2,2,0
2025-06-15,38,DPD30-59,7,6,1
2025-06-15,38,DPD60-89,0,0,0
2025-06-15,38,DPD90+,0,0,0
2025-06-15,40,Current,0,0,0
2025-06-15,40,DPD15-29,17,13,4
2025-06-15,40,DPD3-14,6,3,3
2025-06-15,40,DPD30-59,4,4,0
2025-06-15,40,DPD60-89,0,0,0
2025-06-15,40,DPD90+,0,0,0
2025-06-15,42,Current,0,0,0
2025-06-15,42,DPD15-29,9,8,1
2025-06-15,42,DPD3-14,0,0,0
2025-06-15,42,DPD30-59,5,5,0
2025-06-15,42,DPD60-89,0,0,0
2025-06-15,42,DPD90+,0,0,0
2025-06-15,44,Current,0,0,0
2025-06-15,44,DPD15-29,20,18,2
2025-06-15,44,DPD3-14,8,5,3
2025-06-15,44,DPD30-59,16,16,0
2025-06-15,44,DPD60-89,0,0,0
2025-06-15,44,DPD90+,0,0,0
2025-06-15,46,Current,0,0,0
2025-06-15,46,DPD3-14,0,0,0
2025-06-15,48,Current,38,11,27
2025-06-15,48,DPD15-29,21,19,2
2025-06-15,48,DPD3-14,15,12,3
2025-06-15,48,DPD30-59,18,18,0
2025-06-15,48,DPD60-89,0,0,0
2025-06-15,48,DPD90+,0,0,0
2025-06-15,54,Current,11,1,10
2025-06-15,56,Current,0,0,0
2025-06-15,56,DPD15-29,1,1,0
2025-06-15,56,DPD3-14,0,0,0
2025-06-15,56,DPD30-59,0,0,0
2025-06-15,6,Current,0,0,0
2025-06-14,100,Current,0,0,0
2025-06-14,100,DPD3-14,0,0,0
2025-06-14,102,Current,0,0,0
2025-06-14,104,Current,0,0,0
2025-06-14,20,Current,0,0,0
2025-06-14,20,DPD15-29,140,132,8
2025-06-14,20,DPD3-14,79,54,25
2025-06-14,20,DPD30-59,95,95,0
2025-06-14,20,DPD60-89,0,0,0
2025-06-14,20,DPD90+,0,0,0
2025-06-14,22,Current,0,0,0
2025-06-14,24,Current,29,22,7
2025-06-14,24,DPD15-29,89,84,5
2025-06-14,24,DPD3-14,72,52,20
2025-06-14,24,DPD30-59,42,42,0
2025-06-14,24,DPD60-89,0,0,0
2025-06-14,24,DPD90+,0,0,0
2025-06-14,26,Current,0,0,0
2025-06-14,26,DPD15-29,5,5,0
2025-06-14,26,DPD3-14,7,6,1
2025-06-14,26,DPD30-59,5,5,0
2025-06-14,26,DPD60-89,0,0,0
2025-06-14,26,DPD90+,0,0,0
2025-06-14,32,Current,0,0,0
2025-06-14,32,DPD15-29,80,74,6
2025-06-14,32,DPD3-14,28,21,7
2025-06-14,32,DPD30-59,47,47,0
2025-06-14,32,DPD60-89,0,0,0
2025-06-14,32,DPD90+,0,0,0
2025-06-14,34,Current,0,0,0
2025-06-14,34,DPD15-29,30,24,6
2025-06-14,34,DPD3-14,8,5,3
2025-06-14,34,DPD30-59,23,23,0
2025-06-14,34,DPD60-89,0,0,0
2025-06-14,34,DPD90+,0,0,0
2025-06-14,36,Current,0,0,0
2025-06-14,36,DPD15-29,17,16,1
2025-06-14,36,DPD3-14,8,7,1
2025-06-14,36,DPD30-59,15,15,0
2025-06-14,36,DPD60-89,0,0,0
2025-06-14,36,DPD90+,0,0,0
2025-06-14,38,Current,3,1,2
2025-06-14,38,DPD15-29,19,14,5
2025-06-14,38,DPD3-14,13,12,1
2025-06-14,38,DPD30-59,15,15,0
2025-06-14,38,DPD60-89,0,0,0
2025-06-14,38,DPD90+,0,0,0
2025-06-14,40,Current,0,0,0
2025-06-14,40,DPD15-29,12,10,2
2025-06-14,40,DPD3-14,10,8,2
2025-06-14,40,DPD30-59,7,7,0
2025-06-14,40,DPD60-89,0,0,0
2025-06-14,40,DPD90+,0,0,0
2025-06-14,42,Current,0,0,0
2025-06-14,42,DPD15-29,6,6,0
2025-06-14,42,DPD3-14,3,3,0
2025-06-14,42,DPD30-59,1,1,0
2025-06-14,42,DPD60-89,0,0,0
2025-06-14,42,DPD90+,0,0,0
2025-06-14,44,Current,0,0,0
2025-06-14,44,DPD15-29,18,18,0
2025-06-14,44,DPD3-14,16,12,4
2025-06-14,44,DPD30-59,10,10,0
2025-06-14,44,DPD60-89,0,0,0
2025-06-14,44,DPD90+,0,0,0
2025-06-14,46,Current,0,0,0
2025-06-14,46,DPD3-14,0,0,0
2025-06-14,48,Current,31,12,19
2025-06-14,48,DPD15-29,23,19,4
2025-06-14,48,DPD3-14,20,16,4
2025-06-14,48,DPD30-59,19,19,0
2025-06-14,48,DPD60-89,0,0,0
2025-06-14,48,DPD90+,0,0,0
2025-06-14,54,Current,14,4,10
2025-06-14,56,Current,0,0,0
2025-06-14,56,DPD15-29,0,0,0
2025-06-14,56,DPD3-14,0,0,0
2025-06-14,56,DPD30-59,0,0,0
2025-06-14,6,Current,0,0,0
2025-06-13,100,Current,0,0,0
2025-06-13,100,DPD3-14,0,0,0
2025-06-13,102,Current,0,0,0
2025-06-13,104,Current,0,0,0
2025-06-13,20,Current,0,0,0
2025-06-13,20,DPD15-29,207,192,15
2025-06-13,20,DPD3-14,61,53,8
2025-06-13,20,DPD30-59,90,89,1
2025-06-13,20,DPD60-89,0,0,0
2025-06-13,20,DPD90+,0,0,0
2025-06-13,22,Current,0,0,0
2025-06-13,24,Current,51,50,1
2025-06-13,24,DPD15-29,124,114,10
2025-06-13,24,DPD3-14,47,41,6
2025-06-13,24,DPD30-59,54,53,1
2025-06-13,24,DPD60-89,0,0,0
2025-06-13,24,DPD90+,0,0,0
2025-06-13,26,Current,0,0,0
2025-06-13,26,DPD15-29,13,13,0
2025-06-13,26,DPD3-14,3,2,1
2025-06-13,26,DPD30-59,4,4,0
2025-06-13,26,DPD60-89,0,0,0
2025-06-13,26,DPD90+,0,0,0
2025-06-13,32,Current,0,0,0
2025-06-13,32,DPD15-29,138,124,14
2025-06-13,32,DPD3-14,27,24,3
2025-06-13,32,DPD30-59,50,50,0
2025-06-13,32,DPD60-89,0,0,0
2025-06-13,32,DPD90+,0,0,0
2025-06-13,34,Current,0,0,0
2025-06-13,34,DPD15-29,36,34,2
2025-06-13,34,DPD3-14,8,7,1
2025-06-13,34,DPD30-59,17,17,0
2025-06-13,34,DPD60-89,0,0,0
2025-06-13,34,DPD90+,0,0,0
2025-06-13,36,Current,0,0,0
2025-06-13,36,DPD15-29,20,17,3
2025-06-13,36,DPD3-14,8,5,3
2025-06-13,36,DPD30-59,11,11,0
2025-06-13,36,DPD60-89,0,0,0
2025-06-13,36,DPD90+,0,0,0
2025-06-13,38,Current,3,1,2
2025-06-13,38,DPD15-29,34,31,3
2025-06-13,38,DPD3-14,10,5,5
2025-06-13,38,DPD30-59,6,5,1
2025-06-13,38,DPD60-89,0,0,0
2025-06-13,38,DPD90+,0,0,0
2025-06-13,40,Current,0,0,0
2025-06-13,40,DPD15-29,18,14,4
2025-06-13,40,DPD3-14,7,5,2
2025-06-13,40,DPD30-59,4,4,0
2025-06-13,40,DPD60-89,0,0,0
2025-06-13,40,DPD90+,0,0,0
2025-06-13,42,Current,0,0,0
2025-06-13,42,DPD15-29,11,10,1
2025-06-13,42,DPD3-14,3,3,0
2025-06-13,42,DPD30-59,6,6,0
2025-06-13,42,DPD60-89,0,0,0
2025-06-13,42,DPD90+,0,0,0
2025-06-13,44,Current,0,0,0
2025-06-13,44,DPD15-29,24,22,2
2025-06-13,44,DPD3-14,9,6,3
2025-06-13,44,DPD30-59,18,18,0
2025-06-13,44,DPD60-89,0,0,0
2025-06-13,44,DPD90+,0,0,0
2025-06-13,46,Current,0,0,0
2025-06-13,46,DPD3-14,2,2,0
2025-06-13,48,Current,57,28,29
2025-06-13,48,DPD15-29,27,24,3
2025-06-13,48,DPD3-14,23,16,7
2025-06-13,48,DPD30-59,22,22,0
2025-06-13,48,DPD60-89,0,0,0
2025-06-13,48,DPD90+,0,0,0
2025-06-13,54,Current,31,17,14
2025-06-13,56,Current,0,0,0
2025-06-13,56,DPD3-14,1,1,0
2025-06-13,56,DPD30-59,0,0,0
2025-06-13,6,Current,0,0,0
2025-06-12,100,Current,0,0,0
2025-06-12,100,DPD3-14,0,0,0
2025-06-12,102,Current,0,0,0
2025-06-12,104,Current,0,0,0
2025-06-12,20,Current,5,1,4
2025-06-12,20,DPD15-29,184,174,10
2025-06-12,20,DPD3-14,100,76,24
2025-06-12,20,DPD30-59,94,94,0
2025-06-12,20,DPD60-89,0,0,0
2025-06-12,20,DPD90+,0,0,0
2025-06-12,22,Current,0,0,0
2025-06-12,24,Current,43,28,15
2025-06-12,24,DPD15-29,115,106,9
2025-06-12,24,DPD3-14,76,57,19
2025-06-12,24,DPD30-59,47,47,0
2025-06-12,24,DPD60-89,0,0,0
2025-06-12,24,DPD90+,0,0,0
2025-06-12,26,Current,1,0,1
2025-06-12,26,DPD15-29,10,10,0
2025-06-12,26,DPD3-14,8,5,3
2025-06-12,26,DPD30-59,6,6,0
2025-06-12,26,DPD60-89,0,0,0
2025-06-12,26,DPD90+,0,0,0
2025-06-12,32,Current,8,3,5
2025-06-12,32,DPD15-29,107,101,6
2025-06-12,32,DPD3-14,59,48,11
2025-06-12,32,DPD30-59,47,47,0
2025-06-12,32,DPD60-89,0,0,0
2025-06-12,32,DPD90+,0,0,0
2025-06-12,34,Current,0,0,0
2025-06-12,34,DPD15-29,35,29,6
2025-06-12,34,DPD3-14,13,8,5
2025-06-12,34,DPD30-59,22,22,0
2025-06-12,34,DPD60-89,0,0,0
2025-06-12,34,DPD90+,0,0,0
2025-06-12,36,Current,0,0,0
2025-06-12,36,DPD15-29,20,19,1
2025-06-12,36,DPD3-14,16,14,2
2025-06-12,36,DPD30-59,16,16,0
2025-06-12,36,DPD60-89,0,0,0
2025-06-12,36,DPD90+,0,0,0
2025-06-12,38,Current,11,5,6
2025-06-12,38,DPD15-29,23,18,5
2025-06-12,38,DPD3-14,33,24,9
2025-06-12,38,DPD30-59,17,17,0
2025-06-12,38,DPD60-89,0,0,0
2025-06-12,38,DPD90+,0,0,0
2025-06-12,40,Current,1,0,1
2025-06-12,40,DPD15-29,16,14,2
2025-06-12,40,DPD3-14,17,11,6
2025-06-12,40,DPD30-59,9,9,0
2025-06-12,40,DPD60-89,0,0,0
2025-06-12,40,DPD90+,0,0,0
2025-06-12,42,Current,0,0,0
2025-06-12,42,DPD15-29,9,9,0
2025-06-12,42,DPD3-14,4,3,1
2025-06-12,42,DPD30-59,2,2,0
2025-06-12,42,DPD60-89,0,0,0
2025-06-12,42,DPD90+,0,0,0
2025-06-12,44,Current,19,15,4
2025-06-12,44,DPD15-29,21,21,0
2025-06-12,44,DPD3-14,21,15,6
2025-06-12,44,DPD30-59,12,12,0
2025-06-12,44,DPD60-89,0,0,0
2025-06-12,44,DPD90+,0,0,0
2025-06-12,46,Current,0,0,0
2025-06-12,46,DPD3-14,1,1,0
2025-06-12,48,Current,43,16,27
2025-06-12,48,DPD15-29,26,22,4
2025-06-12,48,DPD3-14,19,12,7
2025-06-12,48,DPD30-59,20,20,0
2025-06-12,48,DPD60-89,0,0,0
2025-06-12,48,DPD90+,0,0,0
2025-06-12,54,Current,16,3,13
2025-06-12,56,Current,9,9,0
2025-06-12,56,DPD3-14,0,0,0
2025-06-12,56,DPD30-59,0,0,0
2025-06-12,6,Current,0,0,0
2025-06-11,100,Current,0,0,0
2025-06-11,100,DPD3-14,0,0,0
2025-06-11,102,Current,0,0,0
2025-06-11,104,Current,0,0,0
2025-06-11,20,Current,0,0,0
2025-06-11,20,DPD15-29,150,143,7
2025-06-11,20,DPD3-14,42,36,6
2025-06-11,20,DPD30-59,95,94,1
2025-06-11,20,DPD60-89,0,0,0
2025-06-11,20,DPD90+,0,0,0
2025-06-11,22,Current,0,0,0
2025-06-11,24,Current,10,6,4
2025-06-11,24,DPD15-29,98,92,6
2025-06-11,24,DPD3-14,38,30,8
2025-06-11,24,DPD30-59,55,55,0
2025-06-11,24,DPD60-89,0,0,0
2025-06-11,24,DPD90+,0,0,0
2025-06-11,26,Current,0,0,0
2025-06-11,26,DPD15-29,10,10,0
2025-06-11,26,DPD3-14,9,6,3
2025-06-11,26,DPD30-59,3,3,0
2025-06-11,26,DPD60-89,0,0,0
2025-06-11,26,DPD90+,0,0,0
2025-06-11,32,Current,0,0,0
2025-06-11,32,DPD15-29,98,95,3
2025-06-11,32,DPD3-14,22,20,2
2025-06-11,32,DPD30-59,50,50,0
2025-06-11,32,DPD60-89,0,0,0
2025-06-11,32,DPD90+,0,0,0
2025-06-11,34,Current,0,0,0
2025-06-11,34,DPD15-29,26,25,1
2025-06-11,34,DPD3-14,7,4,3
2025-06-11,34,DPD30-59,18,18,0
2025-06-11,34,DPD60-89,0,0,0
2025-06-11,34,DPD90+,0,0,0
2025-06-11,36,Current,0,0,0
2025-06-11,36,DPD15-29,10,10,0
2025-06-11,36,DPD3-14,5,2,3
2025-06-11,36,DPD30-59,11,11,0
2025-06-11,36,DPD60-89,0,0,0
2025-06-11,36,DPD90+,0,0,0
2025-06-11,38,Current,9,1,8
2025-06-11,38,DPD15-29,25,23,2
2025-06-11,38,DPD3-14,12,8,4
2025-06-11,38,DPD30-59,6,5,1
2025-06-11,38,DPD60-89,0,0,0
2025-06-11,38,DPD90+,0,0,0
2025-06-11,40,Current,0,0,0
2025-06-11,40,DPD15-29,14,13,1
2025-06-11,40,DPD3-14,6,5,1
2025-06-11,40,DPD30-59,3,3,0
2025-06-11,40,DPD60-89,0,0,0
2025-06-11,40,DPD90+,0,0,0
2025-06-11,42,Current,0,0,0
2025-06-11,42,DPD15-29,9,9,0
2025-06-11,42,DPD3-14,1,1,0
2025-06-11,42,DPD30-59,6,6,0
2025-06-11,42,DPD60-89,0,0,0
2025-06-11,42,DPD90+,0,0,0
2025-06-11,44,Current,0,0,0
2025-06-11,44,DPD15-29,20,18,2
2025-06-11,44,DPD3-14,11,8,3
2025-06-11,44,DPD30-59,16,16,0
2025-06-11,44,DPD60-89,0,0,0
2025-06-11,44,DPD90+,0,0,0
2025-06-11,46,Current,0,0,0
2025-06-11,46,DPD3-14,1,1,0
2025-06-11,48,Current,48,4,44
2025-06-11,48,DPD15-29,32,29,3
2025-06-11,48,DPD3-14,25,18,7
2025-06-11,48,DPD30-59,20,20,0
2025-06-11,48,DPD60-89,0,0,0
2025-06-11,48,DPD90+,0,0,0
2025-06-11,54,Current,11,0,11
2025-06-11,56,Current,0,0,0
2025-06-11,56,DPD3-14,0,0,0
2025-06-11,56,DPD30-59,0,0,0
2025-06-11,6,Current,0,0,0
2025-06-10,100,Current,0,0,0
2025-06-10,100,DPD3-14,0,0,0
2025-06-10,102,Current,0,0,0
2025-06-10,104,Current,0,0,0
2025-06-10,20,Current,7,3,4
2025-06-10,20,DPD15-29,176,167,9
2025-06-10,20,DPD3-14,43,32,11
2025-06-10,20,DPD30-59,95,95,0
2025-06-10,20,DPD60-89,0,0,0
2025-06-10,20,DPD90+,0,0,0
2025-06-10,22,Current,0,0,0
2025-06-10,24,Current,40,19,21
2025-06-10,24,DPD15-29,98,93,5
2025-06-10,24,DPD3-14,42,28,14
2025-06-10,24,DPD30-59,51,49,2
2025-06-10,24,DPD60-89,0,0,0
2025-06-10,24,DPD90+,0,0,0
2025-06-10,26,Current,1,0,1
2025-06-10,26,DPD15-29,10,10,0
2025-06-10,26,DPD3-14,4,4,0
2025-06-10,26,DPD30-59,6,6,0
2025-06-10,26,DPD60-89,0,0,0
2025-06-10,26,DPD90+,0,0,0
2025-06-10,32,Current,9,4,5
2025-06-10,32,DPD15-29,90,86,4
2025-06-10,32,DPD3-14,16,14,2
2025-06-10,32,DPD30-59,48,48,0
2025-06-10,32,DPD60-89,0,0,0
2025-06-10,32,DPD90+,0,0,0
2025-06-10,34,Current,7,7,0
2025-06-10,34,DPD15-29,31,27,4
2025-06-10,34,DPD3-14,12,8,4
2025-06-10,34,DPD30-59,23,23,0
2025-06-10,34,DPD60-89,0,0,0
2025-06-10,34,DPD90+,1,1,0
2025-06-10,36,Current,1,1,0
2025-06-10,36,DPD15-29,14,14,0
2025-06-10,36,DPD3-14,8,7,1
2025-06-10,36,DPD30-59,15,15,0
2025-06-10,36,DPD60-89,0,0,0
2025-06-10,36,DPD90+,0,0,0
2025-06-10,38,Current,9,3,6
2025-06-10,38,DPD15-29,27,24,3
2025-06-10,38,DPD3-14,7,6,1
2025-06-10,38,DPD30-59,17,17,0
2025-06-10,38,DPD60-89,0,0,0
2025-06-10,38,DPD90+,0,0,0
2025-06-10,40,Current,2,1,1
2025-06-10,40,DPD15-29,15,14,1
2025-06-10,40,DPD3-14,5,4,1
2025-06-10,40,DPD30-59,10,10,0
2025-06-10,40,DPD60-89,0,0,0
2025-06-10,40,DPD90+,0,0,0
2025-06-10,42,Current,0,0,0
2025-06-10,42,DPD15-29,8,8,0
2025-06-10,42,DPD3-14,1,1,0
2025-06-10,42,DPD30-59,2,2,0
2025-06-10,42,DPD60-89,0,0,0
2025-06-10,42,DPD90+,0,0,0
2025-06-10,44,Current,5,1,4
2025-06-10,44,DPD15-29,20,20,0
2025-06-10,44,DPD3-14,8,5,3
2025-06-10,44,DPD30-59,9,9,0
2025-06-10,44,DPD60-89,0,0,0
2025-06-10,44,DPD90+,0,0,0
2025-06-10,46,Current,0,0,0
2025-06-10,46,DPD3-14,0,0,0
2025-06-10,48,Current,50,7,43
2025-06-10,48,DPD15-29,27,24,3
2025-06-10,48,DPD3-14,11,7,4
2025-06-10,48,DPD30-59,24,23,1
2025-06-10,48,DPD60-89,0,0,0
2025-06-10,48,DPD90+,0,0,0
2025-06-10,54,Current,6,1,5
2025-06-10,56,Current,1,1,0
2025-06-10,56,DPD3-14,0,0,0
2025-06-10,56,DPD30-59,0,0,0
2025-06-10,6,Current,0,0,0
2025-06-09,100,Current,0,0,0
2025-06-09,100,DPD3-14,0,0,0
2025-06-09,102,Current,0,0,0
2025-06-09,104,Current,0,0,0
2025-06-09,20,Current,0,0,0
2025-06-09,20,DPD15-29,144,142,2
2025-06-09,20,DPD3-14,55,41,14
2025-06-09,20,DPD30-59,92,92,0
2025-06-09,20,DPD60-89,0,0,0
2025-06-09,20,DPD90+,0,0,0
2025-06-09,22,Current,0,0,0
2025-06-09,24,Current,73,32,41
2025-06-09,24,DPD15-29,96,92,4
2025-06-09,24,DPD3-14,49,35,14
2025-06-09,24,DPD30-59,56,56,0
2025-06-09,24,DPD60-89,0,0,0
2025-06-09,24,DPD90+,0,0,0
2025-06-09,26,Current,0,0,0
2025-06-09,26,DPD15-29,10,10,0
2025-06-09,26,DPD3-14,14,10,4
2025-06-09,26,DPD30-59,5,4,1
2025-06-09,26,DPD60-89,0,0,0
2025-06-09,26,DPD90+,0,0,0
2025-06-09,32,Current,0,0,0
2025-06-09,32,DPD15-29,93,91,2
2025-06-09,32,DPD3-14,15,12,3
2025-06-09,32,DPD30-59,43,43,0
2025-06-09,32,DPD60-89,0,0,0
2025-06-09,32,DPD90+,0,0,0
2025-06-09,34,Current,0,0,0
2025-06-09,34,DPD15-29,23,22,1
2025-06-09,34,DPD3-14,4,4,0
2025-06-09,34,DPD30-59,16,16,0
2025-06-09,34,DPD60-89,0,0,0
2025-06-09,34,DPD90+,0,0,0
2025-06-09,36,Current,0,0,0
2025-06-09,36,DPD15-29,11,11,0
2025-06-09,36,DPD3-14,4,3,1
2025-06-09,36,DPD30-59,12,12,0
2025-06-09,36,DPD60-89,0,0,0
2025-06-09,36,DPD90+,0,0,0
2025-06-09,38,Current,8,4,4
2025-06-09,38,DPD15-29,25,24,1
2025-06-09,38,DPD3-14,13,12,1
2025-06-09,38,DPD30-59,6,6,0
2025-06-09,38,DPD60-89,0,0,0
2025-06-09,38,DPD90+,0,0,0
2025-06-09,40,Current,0,0,0
2025-06-09,40,DPD15-29,13,13,0
2025-06-09,40,DPD3-14,1,1,0
2025-06-09,40,DPD30-59,4,4,0
2025-06-09,40,DPD60-89,0,0,0
2025-06-09,40,DPD90+,0,0,0
2025-06-09,42,Current,0,0,0
2025-06-09,42,DPD15-29,8,8,0
2025-06-09,42,DPD3-14,1,1,0
2025-06-09,42,DPD30-59,2,2,0
2025-06-09,42,DPD60-89,0,0,0
2025-06-09,42,DPD90+,0,0,0
2025-06-09,44,Current,0,0,0
2025-06-09,44,DPD15-29,24,24,0
2025-06-09,44,DPD3-14,5,3,2
2025-06-09,44,DPD30-59,13,13,0
2025-06-09,44,DPD60-89,0,0,0
2025-06-09,44,DPD90+,0,0,0
2025-06-09,46,Current,0,0,0
2025-06-09,46,DPD3-14,0,0,0
2025-06-09,48,Current,55,28,27
2025-06-09,48,DPD15-29,31,28,3
2025-06-09,48,DPD3-14,19,15,4
2025-06-09,48,DPD30-59,18,18,0
2025-06-09,48,DPD60-89,0,0,0
2025-06-09,48,DPD90+,0,0,0
2025-06-09,54,Current,25,7,18
2025-06-09,56,Current,8,8,0
2025-06-09,56,DPD3-14,0,0,0
2025-06-09,56,DPD30-59,0,0,0
2025-06-09,6,Current,0,0,0
2025-06-08,100,Current,0,0,0
2025-06-08,100,DPD3-14,0,0,0
2025-06-08,102,Current,0,0,0
2025-06-08,104,Current,0,0,0
2025-06-08,20,Current,0,0,0
2025-06-08,20,DPD15-29,163,158,5
2025-06-08,20,DPD3-14,119,107,12
2025-06-08,20,DPD30-59,104,104,0
2025-06-08,20,DPD60-89,0,0,0
2025-06-08,20,DPD90+,0,0,0
2025-06-08,22,Current,0,0,0
2025-06-08,24,Current,32,27,5
2025-06-08,24,DPD15-29,86,85,1
2025-06-08,24,DPD3-14,79,66,13
2025-06-08,24,DPD30-59,48,47,1
2025-06-08,24,DPD60-89,0,0,0
2025-06-08,24,DPD90+,0,0,0
2025-06-08,26,Current,0,0,0
2025-06-08,26,DPD15-29,10,10,0
2025-06-08,26,DPD3-14,8,6,2
2025-06-08,26,DPD30-59,6,6,0
2025-06-08,26,DPD60-89,0,0,0
2025-06-08,26,DPD90+,0,0,0
2025-06-08,32,Current,0,0,0
2025-06-08,32,DPD15-29,83,81,2
2025-06-08,32,DPD3-14,66,53,13
2025-06-08,32,DPD30-59,49,49,0
2025-06-08,32,DPD60-89,0,0,0
2025-06-08,32,DPD90+,0,0,0
2025-06-08,34,Current,0,0,0
2025-06-08,34,DPD15-29,31,29,2
2025-06-08,34,DPD3-14,26,24,2
2025-06-08,34,DPD30-59,24,24,0
2025-06-08,34,DPD60-89,0,0,0
2025-06-08,34,DPD90+,0,0,0
2025-06-08,36,Current,0,0,0
2025-06-08,36,DPD15-29,10,10,0
2025-06-08,36,DPD3-14,21,19,2
2025-06-08,36,DPD30-59,17,17,0
2025-06-08,36,DPD60-89,0,0,0
2025-06-08,36,DPD90+,0,0,0
2025-06-08,38,Current,4,4,0
2025-06-08,38,DPD15-29,21,21,0
2025-06-08,38,DPD3-14,20,15,5
2025-06-08,38,DPD30-59,20,20,0
2025-06-08,38,DPD60-89,0,0,0
2025-06-08,38,DPD90+,0,0,0
2025-06-08,40,Current,0,0,0
2025-06-08,40,DPD15-29,14,14,0
2025-06-08,40,DPD3-14,10,7,3
2025-06-08,40,DPD30-59,11,11,0
2025-06-08,40,DPD60-89,0,0,0
2025-06-08,40,DPD90+,0,0,0
2025-06-08,42,Current,0,0,0
2025-06-08,42,DPD15-29,8,8,0
2025-06-08,42,DPD3-14,5,4,1
2025-06-08,42,DPD30-59,2,2,0
2025-06-08,42,DPD60-89,0,0,0
2025-06-08,42,DPD90+,0,0,0
2025-06-08,44,Current,0,0,0
2025-06-08,44,DPD15-29,19,19,0
2025-06-08,44,DPD3-14,14,9,5
2025-06-08,44,DPD30-59,10,10,0
2025-06-08,44,DPD60-89,0,0,0
2025-06-08,44,DPD90+,0,0,0
2025-06-08,46,Current,0,0,0
2025-06-08,46,DPD3-14,0,0,0
2025-06-08,48,Current,14,13,1
2025-06-08,48,DPD15-29,24,22,2
2025-06-08,48,DPD3-14,8,5,3
2025-06-08,48,DPD30-59,23,22,1
2025-06-08,48,DPD60-89,0,0,0
2025-06-08,48,DPD90+,0,0,0
2025-06-08,54,Current,1,0,1
2025-06-08,56,Current,5,5,0
2025-06-08,56,DPD15-29,0,0,0
2025-06-08,6,Current,0,0,0
2025-06-07,100,Current,0,0,0
2025-06-07,100,DPD3-14,0,0,0
2025-06-07,102,Current,0,0,0
2025-06-07,104,Current,0,0,0
2025-06-07,20,Current,0,0,0
2025-06-07,20,DPD15-29,142,140,2
2025-06-07,20,DPD3-14,106,83,23
2025-06-07,20,DPD30-59,101,101,0
2025-06-07,20,DPD60-89,0,0,0
2025-06-07,20,DPD90+,0,0,0
2025-06-07,22,Current,0,0,0
2025-06-07,24,Current,45,42,3
2025-06-07,24,DPD15-29,102,99,3
2025-06-07,24,DPD3-14,83,63,20
2025-06-07,24,DPD30-59,61,61,0
2025-06-07,24,DPD60-89,0,0,0
2025-06-07,24,DPD90+,0,0,0
2025-06-07,26,Current,0,0,0
2025-06-07,26,DPD15-29,9,9,0
2025-06-07,26,DPD3-14,11,8,3
2025-06-07,26,DPD30-59,6,5,1
2025-06-07,26,DPD60-89,0,0,0
2025-06-07,26,DPD90+,0,0,0
2025-06-07,32,Current,0,0,0
2025-06-07,32,DPD15-29,79,79,0
2025-06-07,32,DPD3-14,65,53,12
2025-06-07,32,DPD30-59,46,46,0
2025-06-07,32,DPD60-89,0,0,0
2025-06-07,32,DPD90+,0,0,0
2025-06-07,34,Current,0,0,0
2025-06-07,34,DPD15-29,21,21,0
2025-06-07,34,DPD3-14,20,16,4
2025-06-07,34,DPD30-59,18,18,0
2025-06-07,34,DPD60-89,0,0,0
2025-06-07,34,DPD90+,0,0,0
2025-06-07,36,Current,0,0,0
2025-06-07,36,DPD15-29,10,10,0
2025-06-07,36,DPD3-14,19,16,3
2025-06-07,36,DPD30-59,13,13,0
2025-06-07,36,DPD60-89,0,0,0
2025-06-07,36,DPD90+,0,0,0
2025-06-07,38,Current,7,6,1
2025-06-07,38,DPD15-29,23,22,1
2025-06-07,38,DPD3-14,24,17,7
2025-06-07,38,DPD30-59,7,7,0
2025-06-07,38,DPD60-89,0,0,0
2025-06-07,38,DPD90+,0,0,0
2025-06-07,40,Current,0,0,0
2025-06-07,40,DPD15-29,12,12,0
2025-06-07,40,DPD3-14,14,10,4
2025-06-07,40,DPD30-59,5,5,0
2025-06-07,40,DPD60-89,0,0,0
2025-06-07,40,DPD90+,0,0,0
2025-06-07,42,Current,0,0,0
2025-06-07,42,DPD15-29,6,6,0
2025-06-07,42,DPD3-14,7,6,1
2025-06-07,42,DPD30-59,2,2,0
2025-06-07,42,DPD60-89,0,0,0
2025-06-07,42,DPD90+,0,0,0
2025-06-07,44,Current,0,0,0
2025-06-07,44,DPD15-29,26,26,0
2025-06-07,44,DPD3-14,24,18,6
2025-06-07,44,DPD30-59,12,12,0
2025-06-07,44,DPD60-89,0,0,0
2025-06-07,44,DPD90+,0,0,0
2025-06-07,46,Current,0,0,0
2025-06-07,46,DPD3-14,1,1,0
2025-06-07,48,Current,32,26,6
2025-06-07,48,DPD15-29,28,28,0
2025-06-07,48,DPD3-14,21,14,7
2025-06-07,48,DPD30-59,20,20,0
2025-06-07,48,DPD60-89,0,0,0
2025-06-07,48,DPD90+,0,0,0
2025-06-07,54,Current,3,1,2
2025-06-07,56,Current,11,11,0
2025-06-07,56,DPD15-29,1,1,0
2025-06-07,6,Current,0,0,0
2025-06-06,100,Current,0,0,0
2025-06-06,100,DPD3-14,0,0,0
2025-06-06,102,Current,0,0,0
2025-06-06,104,Current,0,0,0
2025-06-06,20,Current,0,0,0
2025-06-06,20,DPD15-29,170,170,0
2025-06-06,20,DPD3-14,43,36,7
2025-06-06,20,DPD30-59,86,85,1
2025-06-06,20,DPD60-89,0,0,0
2025-06-06,20,DPD90+,0,0,0
2025-06-06,22,Current,0,0,0
2025-06-06,24,Current,32,23,9
2025-06-06,24,DPD15-29,87,87,0
2025-06-06,24,DPD3-14,39,31,8
2025-06-06,24,DPD30-59,43,43,0
2025-06-06,24,DPD60-89,0,0,0
2025-06-06,24,DPD90+,0,0,0
2025-06-06,26,Current,0,0,0
2025-06-06,26,DPD15-29,12,12,0
2025-06-06,26,DPD3-14,3,2,1
2025-06-06,26,DPD30-59,5,5,0
2025-06-06,26,DPD60-89,0,0,0
2025-06-06,26,DPD90+,0,0,0
2025-06-06,32,Current,0,0,0
2025-06-06,32,DPD15-29,84,84,0
2025-06-06,32,DPD3-14,27,23,4
2025-06-06,32,DPD30-59,35,35,0
2025-06-06,32,DPD60-89,0,0,0
2025-06-06,32,DPD90+,0,0,0
2025-06-06,34,Current,0,0,0
2025-06-06,34,DPD15-29,28,28,0
2025-06-06,34,DPD3-14,9,8,1
2025-06-06,34,DPD30-59,21,21,0
2025-06-06,34,DPD60-89,0,0,0
2025-06-06,34,DPD90+,0,0,0
2025-06-06,36,Current,0,0,0
2025-06-06,36,DPD15-29,9,9,0
2025-06-06,36,DPD3-14,7,7,0
2025-06-06,36,DPD30-59,15,15,0
2025-06-06,36,DPD60-89,0,0,0
2025-06-06,36,DPD90+,0,0,0
2025-06-06,38,Current,5,5,0
2025-06-06,38,DPD15-29,20,20,0
2025-06-06,38,DPD3-14,11,5,6
2025-06-06,38,DPD30-59,18,18,0
2025-06-06,38,DPD60-89,0,0,0
2025-06-06,38,DPD90+,0,0,0
2025-06-06,40,Current,0,0,0
2025-06-06,40,DPD15-29,15,15,0
2025-06-06,40,DPD3-14,5,4,1
2025-06-06,40,DPD30-59,10,10,0
2025-06-06,40,DPD60-89,0,0,0
2025-06-06,40,DPD90+,0,0,0
2025-06-06,42,Current,0,0,0
2025-06-06,42,DPD15-29,9,9,0
2025-06-06,42,DPD3-14,2,1,1
2025-06-06,42,DPD30-59,1,1,0
2025-06-06,42,DPD60-89,0,0,0
2025-06-06,42,DPD90+,0,0,0
2025-06-06,44,Current,0,0,0
2025-06-06,44,DPD15-29,19,19,0
2025-06-06,44,DPD3-14,6,2,4
2025-06-06,44,DPD30-59,7,7,0
2025-06-06,44,DPD60-89,0,0,0
2025-06-06,44,DPD90+,0,0,0
2025-06-06,46,Current,0,0,0
2025-06-06,46,DPD3-14,0,0,0
2025-06-06,48,Current,21,16,5
2025-06-06,48,DPD15-29,23,23,0
2025-06-06,48,DPD3-14,15,11,4
2025-06-06,48,DPD30-59,18,17,1
2025-06-06,48,DPD60-89,0,0,0
2025-06-06,48,DPD90+,0,0,0
2025-06-06,54,Current,6,2,4
2025-06-06,56,Current,2,2,0
2025-06-06,56,DPD15-29,0,0,0
2025-06-06,56,DPD3-14,0,0,0
2025-06-06,6,Current,0,0,0
2025-06-05,100,Current,0,0,0
2025-06-05,102,Current,0,0,0
2025-06-05,104,Current,0,0,0
2025-06-05,20,Current,0,0,0
2025-06-05,20,DPD15-29,152,151,1
2025-06-05,20,DPD3-14,114,93,21
2025-06-05,20,DPD30-59,92,92,0
2025-06-05,20,DPD60-89,0,0,0
2025-06-05,20,DPD90+,0,0,0
2025-06-05,22,Current,0,0,0
2025-06-05,24,Current,75,65,10
2025-06-05,24,DPD15-29,102,102,0
2025-06-05,24,DPD3-14,74,60,14
2025-06-05,24,DPD30-59,59,59,0
2025-06-05,24,DPD60-89,0,0,0
2025-06-05,24,DPD90+,0,0,0
2025-06-05,26,Current,0,0,0
2025-06-05,26,DPD15-29,12,12,0
2025-06-05,26,DPD3-14,6,4,2
2025-06-05,26,DPD30-59,4,4,0
2025-06-05,26,DPD60-89,0,0,0
2025-06-05,26,DPD90+,0,0,0
2025-06-05,32,Current,0,0,0
2025-06-05,32,DPD15-29,79,79,0
2025-06-05,32,DPD3-14,58,46,12
2025-06-05,32,DPD30-59,46,46,0
2025-06-05,32,DPD60-89,0,0,0
2025-06-05,32,DPD90+,0,0,0
2025-06-05,34,Current,2,2,0
2025-06-05,34,DPD15-29,25,25,0
2025-06-05,34,DPD3-14,16,11,5
2025-06-05,34,DPD30-59,17,17,0
2025-06-05,34,DPD60-89,0,0,0
2025-06-05,34,DPD90+,0,0,0
2025-06-05,36,Current,0,0,0
2025-06-05,36,DPD15-29,15,15,0
2025-06-05,36,DPD3-14,19,15,4
2025-06-05,36,DPD30-59,12,12,0
2025-06-05,36,DPD60-89,0,0,0
2025-06-05,36,DPD90+,0,0,0
2025-06-05,38,Current,9,8,1
2025-06-05,38,DPD15-29,23,22,1
2025-06-05,38,DPD3-14,26,15,11
2025-06-05,38,DPD30-59,7,7,0
2025-06-05,38,DPD60-89,0,0,0
2025-06-05,38,DPD90+,0,0,0
2025-06-05,40,Current,0,0,0
2025-06-05,40,DPD15-29,15,15,0
2025-06-05,40,DPD3-14,15,10,5
2025-06-05,40,DPD30-59,5,5,0
2025-06-05,40,DPD60-89,0,0,0
2025-06-05,40,DPD90+,0,0,0
2025-06-05,42,Current,0,0,0
2025-06-05,42,DPD15-29,5,5,0
2025-06-05,42,DPD3-14,8,4,4
2025-06-05,42,DPD30-59,2,2,0
2025-06-05,42,DPD60-89,0,0,0
2025-06-05,42,DPD90+,0,0,0
2025-06-05,44,Current,15,15,0
2025-06-05,44,DPD15-29,28,28,0
2025-06-05,44,DPD3-14,22,17,5
2025-06-05,44,DPD30-59,12,12,0
2025-06-05,44,DPD60-89,0,0,0
2025-06-05,44,DPD90+,0,0,0
2025-06-05,46,Current,0,0,0
2025-06-05,46,DPD3-14,1,1,0
2025-06-05,48,Current,46,34,12
2025-06-05,48,DPD15-29,28,28,0
2025-06-05,48,DPD3-14,22,14,8
2025-06-05,48,DPD30-59,14,14,0
2025-06-05,48,DPD60-89,0,0,0
2025-06-05,48,DPD90+,0,0,0
2025-06-05,54,Current,5,1,4
2025-06-05,56,Current,18,18,0
2025-06-05,56,DPD15-29,1,1,0
2025-06-05,56,DPD3-14,2,2,0
2025-06-05,6,Current,0,0,0
2025-06-04,100,Current,0,0,0
2025-06-04,102,Current,0,0,0
2025-06-04,104,Current,0,0,0
2025-06-04,20,Current,0,0,0
2025-06-04,20,DPD15-29,168,168,0
2025-06-04,20,DPD3-14,23,18,5
2025-06-04,20,DPD30-59,82,81,1
2025-06-04,20,DPD60-89,0,0,0
2025-06-04,20,DPD90+,0,0,0
2025-06-04,22,Current,0,0,0
2025-06-04,24,Current,40,32,8
2025-06-04,24,DPD15-29,85,84,1
2025-06-04,24,DPD3-14,9,6,3
2025-06-04,24,DPD30-59,43,43,0
2025-06-04,24,DPD60-89,0,0,0
2025-06-04,24,DPD90+,0,0,0
2025-06-04,26,Current,0,0,0
2025-06-04,26,DPD15-29,13,13,0
2025-06-04,26,DPD3-14,2,2,0
2025-06-04,26,DPD30-59,4,4,0
2025-06-04,26,DPD60-89,0,0,0
2025-06-04,26,DPD90+,0,0,0
2025-06-04,32,Current,0,0,0
2025-06-04,32,DPD15-29,66,66,0
2025-06-04,32,DPD3-14,17,15,2
2025-06-04,32,DPD30-59,34,34,0
2025-06-04,32,DPD60-89,1,1,0
2025-06-04,32,DPD90+,0,0,0
2025-06-04,34,Current,0,0,0
2025-06-04,34,DPD15-29,28,28,0
2025-06-04,34,DPD3-14,6,4,2
2025-06-04,34,DPD30-59,19,19,0
2025-06-04,34,DPD60-89,0,0,0
2025-06-04,34,DPD90+,0,0,0
2025-06-04,36,Current,0,0,0
2025-06-04,36,DPD15-29,10,10,0
2025-06-04,36,DPD3-14,3,3,0
2025-06-04,36,DPD30-59,16,16,0
2025-06-04,36,DPD60-89,0,0,0
2025-06-04,36,DPD90+,0,0,0
2025-06-04,38,Current,0,0,0
2025-06-04,38,DPD15-29,21,21,0
2025-06-04,38,DPD3-14,5,5,0
2025-06-04,38,DPD30-59,17,17,0
2025-06-04,38,DPD60-89,0,0,0
2025-06-04,38,DPD90+,0,0,0
2025-06-04,40,Current,0,0,0
2025-06-04,40,DPD15-29,13,13,0
2025-06-04,40,DPD3-14,3,3,0
2025-06-04,40,DPD30-59,10,10,0
2025-06-04,40,DPD60-89,0,0,0
2025-06-04,40,DPD90+,0,0,0
2025-06-04,42,Current,0,0,0
2025-06-04,42,DPD15-29,9,9,0
2025-06-04,42,DPD3-14,2,2,0
2025-06-04,42,DPD30-59,1,1,0
2025-06-04,42,DPD60-89,0,0,0
2025-06-04,42,DPD90+,0,0,0
2025-06-04,44,Current,0,0,0
2025-06-04,44,DPD15-29,19,19,0
2025-06-04,44,DPD3-14,2,2,0
2025-06-04,44,DPD30-59,5,5,0
2025-06-04,44,DPD60-89,0,0,0
2025-06-04,44,DPD90+,0,0,0
2025-06-04,46,Current,0,0,0
2025-06-04,46,DPD3-14,0,0,0
2025-06-04,48,Current,23,17,6
2025-06-04,48,DPD15-29,27,26,1
2025-06-04,48,DPD3-14,9,4,5
2025-06-04,48,DPD30-59,17,16,1
2025-06-04,48,DPD60-89,0,0,0
2025-06-04,48,DPD90+,0,0,0
2025-06-04,54,Current,10,6,4
2025-06-04,56,Current,0,0,0
2025-06-04,56,DPD15-29,0,0,0
2025-06-04,56,DPD3-14,0,0,0
2025-06-04,6,Current,0,0,0
2025-06-03,100,Current,0,0,0
2025-06-03,102,Current,0,0,0
2025-06-03,104,Current,0,0,0
2025-06-03,20,Current,0,0,0
2025-06-03,20,DPD15-29,120,120,0
2025-06-03,20,DPD3-14,131,112,19
2025-06-03,20,DPD30-59,98,98,0
2025-06-03,20,DPD60-89,0,0,0
2025-06-03,20,DPD90+,0,0,0
2025-06-03,22,Current,0,0,0
2025-06-03,24,Current,80,78,2
2025-06-03,24,DPD15-29,88,88,0
2025-06-03,24,DPD3-14,77,67,10
2025-06-03,24,DPD30-59,60,60,0
2025-06-03,24,DPD60-89,0,0,0
2025-06-03,24,DPD90+,0,0,0
2025-06-03,26,Current,0,0,0
2025-06-03,26,DPD15-29,10,10,0
2025-06-03,26,DPD3-14,6,5,1
2025-06-03,26,DPD30-59,4,4,0
2025-06-03,26,DPD60-89,0,0,0
2025-06-03,26,DPD90+,0,0,0
2025-06-03,32,Current,0,0,0
2025-06-03,32,DPD15-29,61,61,0
2025-06-03,32,DPD3-14,80,63,17
2025-06-03,32,DPD30-59,45,45,0
2025-06-03,32,DPD60-89,0,0,0
2025-06-03,32,DPD90+,0,0,0
2025-06-03,34,Current,0,0,0
2025-06-03,34,DPD15-29,25,25,0
2025-06-03,34,DPD3-14,28,23,5
2025-06-03,34,DPD30-59,15,15,0
2025-06-03,34,DPD60-89,0,0,0
2025-06-03,34,DPD90+,0,0,0
2025-06-03,36,Current,0,0,0
2025-06-03,36,DPD15-29,12,12,0
2025-06-03,36,DPD3-14,15,14,1
2025-06-03,36,DPD30-59,11,11,0
2025-06-03,36,DPD60-89,0,0,0
2025-06-03,36,DPD90+,0,0,0
2025-06-03,38,Current,0,0,0
2025-06-03,38,DPD15-29,14,14,0
2025-06-03,38,DPD3-14,19,17,2
2025-06-03,38,DPD30-59,7,7,0
2025-06-03,38,DPD60-89,0,0,0
2025-06-03,38,DPD90+,0,0,0
2025-06-03,40,Current,0,0,0
2025-06-03,40,DPD15-29,14,14,0
2025-06-03,40,DPD3-14,7,4,3
2025-06-03,40,DPD30-59,3,3,0
2025-06-03,40,DPD60-89,0,0,0
2025-06-03,40,DPD90+,0,0,0
2025-06-03,42,Current,0,0,0
2025-06-03,42,DPD15-29,3,3,0
2025-06-03,42,DPD3-14,7,6,1
2025-06-03,42,DPD30-59,2,2,0
2025-06-03,42,DPD60-89,0,0,0
2025-06-03,42,DPD90+,0,0,0
2025-06-03,44,Current,3,3,0
2025-06-03,44,DPD15-29,23,23,0
2025-06-03,44,DPD3-14,21,18,3
2025-06-03,44,DPD30-59,9,9,0
2025-06-03,44,DPD60-89,0,0,0
2025-06-03,44,DPD90+,0,0,0
2025-06-03,46,Current,0,0,0
2025-06-03,48,Current,39,36,3
2025-06-03,48,DPD15-29,20,20,0
2025-06-03,48,DPD3-14,13,9,4
2025-06-03,48,DPD30-59,18,18,0
2025-06-03,48,DPD60-89,0,0,0
2025-06-03,48,DPD90+,0,0,0
2025-06-03,54,Current,26,26,0
2025-06-03,56,Current,0,0,0
2025-06-03,56,DPD15-29,1,1,0
2025-06-03,56,DPD3-14,2,2,0
2025-06-03,6,Current,0,0,0
2025-06-02,100,Current,0,0,0
2025-06-02,102,Current,0,0,0
2025-06-02,104,Current,0,0,0
2025-06-02,20,Current,0,0,0
2025-06-02,20,DPD15-29,174,174,0
2025-06-02,20,DPD3-14,61,55,6
2025-06-02,20,DPD30-59,78,77,1
2025-06-02,20,DPD60-89,0,0,0
2025-06-02,20,DPD90+,0,0,0
2025-06-02,22,Current,0,0,0
2025-06-02,24,Current,35,35,0
2025-06-02,24,DPD15-29,85,83,2
2025-06-02,24,DPD3-14,59,47,12
2025-06-02,24,DPD30-59,45,45,0
2025-06-02,24,DPD60-89,0,0,0
2025-06-02,24,DPD90+,0,0,0
2025-06-02,26,Current,0,0,0
2025-06-02,26,DPD15-29,13,13,0
2025-06-02,26,DPD3-14,2,2,0
2025-06-02,26,DPD30-59,5,5,0
2025-06-02,26,DPD60-89,0,0,0
2025-06-02,26,DPD90+,0,0,0
2025-06-02,32,Current,0,0,0
2025-06-02,32,DPD15-29,75,75,0
2025-06-02,32,DPD3-14,47,44,3
2025-06-02,32,DPD30-59,33,33,0
2025-06-02,32,DPD60-89,0,0,0
2025-06-02,32,DPD90+,0,0,0
2025-06-02,34,Current,0,0,0
2025-06-02,34,DPD15-29,27,27,0
2025-06-02,34,DPD3-14,14,11,3
2025-06-02,34,DPD30-59,15,15,0
2025-06-02,34,DPD60-89,0,0,0
2025-06-02,34,DPD90+,0,0,0
2025-06-02,36,Current,0,0,0
2025-06-02,36,DPD15-29,8,8,0
2025-06-02,36,DPD3-14,10,9,1
2025-06-02,36,DPD30-59,16,16,0
2025-06-02,36,DPD60-89,0,0,0
2025-06-02,36,DPD90+,0,0,0
2025-06-02,38,Current,4,4,0
2025-06-02,38,DPD15-29,21,21,0
2025-06-02,38,DPD3-14,11,7,4
2025-06-02,38,DPD30-59,14,14,0
2025-06-02,38,DPD60-89,0,0,0
2025-06-02,38,DPD90+,0,0,0
2025-06-02,40,Current,0,0,0
2025-06-02,40,DPD15-29,13,13,0
2025-06-02,40,DPD3-14,7,6,1
2025-06-02,40,DPD30-59,9,9,0
2025-06-02,40,DPD60-89,0,0,0
2025-06-02,40,DPD90+,0,0,0
2025-06-02,42,Current,0,0,0
2025-06-02,42,DPD15-29,9,9,0
2025-06-02,42,DPD3-14,3,3,0
2025-06-02,42,DPD30-59,1,1,0
2025-06-02,42,DPD60-89,0,0,0
2025-06-02,42,DPD90+,0,0,0
2025-06-02,44,Current,7,7,0
2025-06-02,44,DPD15-29,14,14,0
2025-06-02,44,DPD3-14,11,10,1
2025-06-02,44,DPD30-59,6,6,0
2025-06-02,44,DPD60-89,0,0,0
2025-06-02,44,DPD90+,0,0,0
2025-06-02,46,Current,0,0,0
2025-06-02,48,Current,11,11,0
2025-06-02,48,DPD15-29,26,25,1
2025-06-02,48,DPD3-14,14,13,1
2025-06-02,48,DPD30-59,18,17,1
2025-06-02,48,DPD60-89,0,0,0
2025-06-02,48,DPD90+,0,0,0
2025-06-02,54,Current,12,12,0
2025-06-02,56,Current,0,0,0
2025-06-02,56,DPD15-29,0,0,0
2025-06-02,56,DPD3-14,0,0,0
2025-06-02,6,Current,0,0,0
2025-06-01,100,Current,0,0,0
2025-06-01,102,Current,0,0,0
2025-06-01,104,Current,0,0,0
2025-06-01,20,Current,0,0,0
2025-06-01,20,DPD15-29,110,110,0
2025-06-01,20,DPD3-14,174,147,27
2025-06-01,20,DPD30-59,92,92,0
2025-06-01,20,DPD60-89,0,0,0
2025-06-01,20,DPD90+,0,0,0
2025-06-01,22,Current,0,0,0
2025-06-01,24,Current,34,34,0
2025-06-01,24,DPD15-29,77,77,0
2025-06-01,24,DPD3-14,120,106,14
2025-06-01,24,DPD30-59,56,56,0
2025-06-01,24,DPD60-89,0,0,0
2025-06-01,24,DPD90+,0,0,0
2025-06-01,26,Current,0,0,0
2025-06-01,26,DPD15-29,10,10,0
2025-06-01,26,DPD3-14,9,7,2
2025-06-01,26,DPD30-59,3,3,0
2025-06-01,26,DPD60-89,0,0,0
2025-06-01,26,DPD90+,0,0,0
2025-06-01,32,Current,0,0,0
2025-06-01,32,DPD15-29,60,60,0
2025-06-01,32,DPD3-14,113,92,21
2025-06-01,32,DPD30-59,42,42,0
2025-06-01,32,DPD60-89,0,0,0
2025-06-01,32,DPD90+,0,0,0
2025-06-01,34,Current,0,0,0
2025-06-01,34,DPD15-29,27,27,0
2025-06-01,34,DPD3-14,31,26,5
2025-06-01,34,DPD30-59,14,14,0
2025-06-01,34,DPD60-89,0,0,0
2025-06-01,34,DPD90+,0,0,0
2025-06-01,36,Current,0,0,0
2025-06-01,36,DPD15-29,15,15,0
2025-06-01,36,DPD3-14,21,18,3
2025-06-01,36,DPD30-59,12,12,0
2025-06-01,36,DPD60-89,0,0,0
2025-06-01,36,DPD90+,0,0,0
2025-06-01,38,Current,3,3,0
2025-06-01,38,DPD15-29,13,13,0
2025-06-01,38,DPD3-14,28,25,3
2025-06-01,38,DPD30-59,7,7,0
2025-06-01,38,DPD60-89,0,0,0
2025-06-01,38,DPD90+,0,0,0
2025-06-01,40,Current,0,0,0
2025-06-01,40,DPD15-29,8,8,0
2025-06-01,40,DPD3-14,14,9,5
2025-06-01,40,DPD30-59,3,3,0
2025-06-01,40,DPD60-89,0,0,0
2025-06-01,40,DPD90+,0,0,0
2025-06-01,42,Current,0,0,0
2025-06-01,42,DPD15-29,3,3,0
2025-06-01,42,DPD3-14,8,7,1
2025-06-01,42,DPD30-59,2,2,0
2025-06-01,42,DPD60-89,0,0,0
2025-06-01,42,DPD90+,0,0,0
2025-06-01,44,Current,0,0,0
2025-06-01,44,DPD15-29,22,22,0
2025-06-01,44,DPD3-14,24,19,5
2025-06-01,44,DPD30-59,9,9,0
2025-06-01,44,DPD60-89,0,0,0
2025-06-01,44,DPD90+,0,0,0
2025-06-01,46,Current,0,0,0
2025-06-01,48,Current,23,23,0
2025-06-01,48,DPD15-29,18,18,0
2025-06-01,48,DPD3-14,19,15,4
2025-06-01,48,DPD30-59,21,21,0
2025-06-01,48,DPD60-89,0,0,0
2025-06-01,48,DPD90+,0,0,0
2025-06-01,54,Current,9,9,0
2025-06-01,56,Current,0,0,0
2025-06-01,56,DPD15-29,1,1,0
2025-06-01,6,Current,0,0,0
2025-05-31,100,Current,0,0,0
2025-05-31,100,DPD3-14,0,0,0
2025-05-31,102,Current,0,0,0
2025-05-31,104,Current,0,0,0
2025-05-31,20,Current,0,0,0
2025-05-31,20,DPD15-29,157,157,0
2025-05-31,20,DPD3-14,148,132,16
2025-05-31,20,DPD30-59,76,75,1
2025-05-31,20,DPD60-89,0,0,0
2025-05-31,20,DPD90+,0,0,0
2025-05-31,22,Current,0,0,0
2025-05-31,24,Current,26,26,0
2025-05-31,24,DPD15-29,78,77,1
2025-05-31,24,DPD3-14,97,79,18
2025-05-31,24,DPD30-59,45,45,0
2025-05-31,24,DPD60-89,0,0,0
2025-05-31,24,DPD90+,0,0,0
2025-05-31,26,Current,0,0,0
2025-05-31,26,DPD15-29,11,11,0
2025-05-31,26,DPD3-14,6,6,0
2025-05-31,26,DPD30-59,5,5,0
2025-05-31,26,DPD60-89,0,0,0
2025-05-31,26,DPD90+,0,0,0
2025-05-31,32,Current,0,0,0
2025-05-31,32,DPD15-29,77,77,0
2025-05-31,32,DPD3-14,85,79,6
2025-05-31,32,DPD30-59,32,32,0
2025-05-31,32,DPD60-89,0,0,0
2025-05-31,32,DPD90+,0,0,0
2025-05-31,34,Current,0,0,0
2025-05-31,34,DPD15-29,26,26,0
2025-05-31,34,DPD3-14,24,19,5
2025-05-31,34,DPD30-59,13,13,0
2025-05-31,34,DPD60-89,0,0,0
2025-05-31,34,DPD90+,0,0,0
2025-05-31,36,Current,0,0,0
2025-05-31,36,DPD15-29,10,10,0
2025-05-31,36,DPD3-14,18,15,3
2025-05-31,36,DPD30-59,17,17,0
2025-05-31,36,DPD60-89,0,0,0
2025-05-31,36,DPD90+,0,0,0
2025-05-31,38,Current,3,3,0
2025-05-31,38,DPD15-29,26,25,1
2025-05-31,38,DPD3-14,23,15,8
2025-05-31,38,DPD30-59,13,13,0
2025-05-31,38,DPD60-89,0,0,0
2025-05-31,38,DPD90+,0,0,0
2025-05-31,40,Current,0,0,0
2025-05-31,40,DPD15-29,14,14,0
2025-05-31,40,DPD3-14,16,14,2
2025-05-31,40,DPD30-59,6,6,0
2025-05-31,40,DPD60-89,0,0,0
2025-05-31,40,DPD90+,0,0,0
2025-05-31,42,Current,0,0,0
2025-05-31,42,DPD15-29,13,13,0
2025-05-31,42,DPD3-14,6,6,0
2025-05-31,42,DPD30-59,0,0,0
2025-05-31,42,DPD60-89,0,0,0
2025-05-31,42,DPD90+,0,0,0
2025-05-31,44,Current,0,0,0
2025-05-31,44,DPD15-29,19,19,0
2025-05-31,44,DPD3-14,21,18,3
2025-05-31,44,DPD30-59,7,6,1
2025-05-31,44,DPD60-89,0,0,0
2025-05-31,44,DPD90+,0,0,0
2025-05-31,46,Current,0,0,0
2025-05-31,48,Current,15,15,0
2025-05-31,48,DPD15-29,26,25,1
2025-05-31,48,DPD3-14,31,27,4
2025-05-31,48,DPD30-59,18,17,1
2025-05-31,48,DPD60-89,0,0,0
2025-05-31,48,DPD90+,0,0,0
2025-05-31,54,Current,12,12,0
2025-05-31,56,Current,0,0,0
2025-05-31,56,DPD15-29,0,0,0
2025-05-31,6,Current,0,0,0
2025-05-30,100,Current,0,0,0
2025-05-30,100,DPD3-14,1,1,0
2025-05-30,102,Current,0,0,0
2025-05-30,104,Current,0,0,0
2025-05-30,20,Current,0,0,0
2025-05-30,20,DPD15-29,99,99,0
2025-05-30,20,DPD3-14,91,74,17
2025-05-30,20,DPD30-59,95,95,0
2025-05-30,20,DPD60-89,0,0,0
2025-05-30,20,DPD90+,0,0,0
2025-05-30,22,Current,0,0,0
2025-05-30,24,Current,37,37,0
2025-05-30,24,DPD15-29,69,69,0
2025-05-30,24,DPD3-14,58,50,8
2025-05-30,24,DPD30-59,61,61,0
2025-05-30,24,DPD60-89,0,0,0
2025-05-30,24,DPD90+,0,0,0
2025-05-30,26,Current,0,0,0
2025-05-30,26,DPD15-29,10,10,0
2025-05-30,26,DPD3-14,9,8,1
2025-05-30,26,DPD30-59,6,6,0
2025-05-30,26,DPD60-89,0,0,0
2025-05-30,26,DPD90+,0,0,0
2025-05-30,32,Current,0,0,0
2025-05-30,32,DPD15-29,51,51,0
2025-05-30,32,DPD3-14,53,44,9
2025-05-30,32,DPD30-59,47,47,0
2025-05-30,32,DPD60-89,0,0,0
2025-05-30,32,DPD90+,0,0,0
2025-05-30,34,Current,0,0,0
2025-05-30,34,DPD15-29,21,21,0
2025-05-30,34,DPD3-14,18,15,3
2025-05-30,34,DPD30-59,17,17,0
2025-05-30,34,DPD60-89,0,0,0
2025-05-30,34,DPD90+,0,0,0
2025-05-30,36,Current,0,0,0
2025-05-30,36,DPD15-29,13,13,0
2025-05-30,36,DPD3-14,10,9,1
2025-05-30,36,DPD30-59,11,11,0
2025-05-30,36,DPD60-89,0,0,0
2025-05-30,36,DPD90+,0,0,0
2025-05-30,38,Current,7,7,0
2025-05-30,38,DPD15-29,12,12,0
2025-05-30,38,DPD3-14,15,14,1
2025-05-30,38,DPD30-59,6,6,0
2025-05-30,38,DPD60-89,0,0,0
2025-05-30,38,DPD90+,0,0,0
2025-05-30,40,Current,0,0,0
2025-05-30,40,DPD15-29,7,7,0
2025-05-30,40,DPD3-14,10,7,3
2025-05-30,40,DPD30-59,3,3,0
2025-05-30,40,DPD60-89,0,0,0
2025-05-30,40,DPD90+,0,0,0
2025-05-30,42,Current,0,0,0
2025-05-30,42,DPD15-29,4,4,0
2025-05-30,42,DPD3-14,5,4,1
2025-05-30,42,DPD30-59,2,2,0
2025-05-30,42,DPD60-89,0,0,0
2025-05-30,42,DPD90+,0,0,0
2025-05-30,44,Current,0,0,0
2025-05-30,44,DPD15-29,21,21,0
2025-05-30,44,DPD3-14,14,11,3
2025-05-30,44,DPD30-59,11,11,0
2025-05-30,44,DPD60-89,0,0,0
2025-05-30,44,DPD90+,0,0,0
2025-05-30,46,Current,0,0,0
2025-05-30,48,Current,31,31,0
2025-05-30,48,DPD15-29,18,18,0
2025-05-30,48,DPD3-14,22,14,8
2025-05-30,48,DPD30-59,20,20,0
2025-05-30,48,DPD60-89,0,0,0
2025-05-30,48,DPD90+,0,0,0
2025-05-30,54,Current,14,14,0
2025-05-30,56,Current,0,0,0
2025-05-30,56,DPD15-29,1,1,0
2025-05-30,6,Current,0,0,0
2025-05-29,100,DPD15-29,0,0,0
2025-05-29,100,DPD3-14,0,0,0
2025-05-29,102,Current,0,0,0
2025-05-29,104,Current,0,0,0
2025-05-29,20,Current,1,1,0
2025-05-29,20,DPD15-29,106,106,0
2025-05-29,20,DPD3-14,111,94,17
2025-05-29,20,DPD30-59,57,57,0
2025-05-29,20,DPD60-89,0,0,0
2025-05-29,20,DPD90+,0,0,0
2025-05-29,22,Current,0,0,0
2025-05-29,24,Current,63,63,0
2025-05-29,24,DPD15-29,59,59,0
2025-05-29,24,DPD3-14,76,65,11
2025-05-29,24,DPD30-59,39,39,0
2025-05-29,24,DPD60-89,0,0,0
2025-05-29,24,DPD90+,0,0,0
2025-05-29,26,Current,0,0,0
2025-05-29,26,DPD15-29,7,7,0
2025-05-29,26,DPD3-14,3,3,0
2025-05-29,26,DPD30-59,5,5,0
2025-05-29,26,DPD60-89,0,0,0
2025-05-29,26,DPD90+,0,0,0
2025-05-29,32,Current,0,0,0
2025-05-29,32,DPD15-29,52,52,0
2025-05-29,32,DPD3-14,49,43,6
2025-05-29,32,DPD30-59,26,26,0
2025-05-29,32,DPD60-89,0,0,0
2025-05-29,32,DPD90+,0,0,0
2025-05-29,34,Current,0,0,0
2025-05-29,34,DPD15-29,20,20,0
2025-05-29,34,DPD3-14,21,17,4
2025-05-29,34,DPD30-59,7,7,0
2025-05-29,34,DPD60-89,0,0,0
2025-05-29,34,DPD90+,0,0,0
2025-05-29,36,Current,0,0,0
2025-05-29,36,DPD15-29,9,9,0
2025-05-29,36,DPD3-14,11,8,3
2025-05-29,36,DPD30-59,12,12,0
2025-05-29,36,DPD60-89,0,0,0
2025-05-29,36,DPD90+,0,0,0
2025-05-29,38,Current,8,8,0
2025-05-29,38,DPD15-29,20,20,0
2025-05-29,38,DPD3-14,14,12,2
2025-05-29,38,DPD30-59,8,8,0
2025-05-29,38,DPD60-89,0,0,0
2025-05-29,38,DPD90+,0,0,0
2025-05-29,40,Current,0,0,0
2025-05-29,40,DPD15-29,6,6,0
2025-05-29,40,DPD3-14,15,14,1
2025-05-29,40,DPD30-59,7,7,0
2025-05-29,40,DPD60-89,0,0,0
2025-05-29,40,DPD90+,0,0,0
2025-05-29,42,Current,0,0,0
2025-05-29,42,DPD15-29,10,10,0
2025-05-29,42,DPD3-14,2,2,0
2025-05-29,42,DPD30-59,0,0,0
2025-05-29,42,DPD60-89,0,0,0
2025-05-29,42,DPD90+,0,0,0
2025-05-29,44,Current,0,0,0
2025-05-29,44,DPD15-29,15,15,0
2025-05-29,44,DPD3-14,15,13,2
2025-05-29,44,DPD30-59,7,7,0
2025-05-29,44,DPD60-89,0,0,0
2025-05-29,44,DPD90+,0,0,0
2025-05-29,46,Current,0,0,0
2025-05-29,48,Current,40,40,0
2025-05-29,48,DPD15-29,26,25,1
2025-05-29,48,DPD3-14,25,22,3
2025-05-29,48,DPD30-59,12,12,0
2025-05-29,48,DPD60-89,0,0,0
2025-05-29,48,DPD90+,0,0,0
2025-05-29,54,Current,5,5,0
2025-05-29,56,Current,16,16,0
2025-05-29,56,DPD15-29,0,0,0
2025-05-29,6,Current,0,0,0
2025-05-28,100,Current,0,0,0
2025-05-28,100,DPD15-29,0,0,0
2025-05-28,102,Current,0,0,0
2025-05-28,104,Current,0,0,0
2025-05-28,20,Current,0,0,0
2025-05-28,20,DPD15-29,134,134,0
2025-05-28,20,DPD3-14,109,98,11
2025-05-28,20,DPD30-59,94,94,0
2025-05-28,20,DPD60-89,0,0,0
2025-05-28,20,DPD90+,0,0,0
2025-05-28,22,Current,0,0,0
2025-05-28,24,Current,58,58,0
2025-05-28,24,DPD15-29,83,83,0
2025-05-28,24,DPD3-14,65,58,7
2025-05-28,24,DPD30-59,61,61,0
2025-05-28,24,DPD60-89,0,0,0
2025-05-28,24,DPD90+,0,0,0
2025-05-28,26,Current,0,0,0
2025-05-28,26,DPD15-29,10,10,0
2025-05-28,26,DPD3-14,7,6,1
2025-05-28,26,DPD30-59,6,6,0
2025-05-28,26,DPD60-89,0,0,0
2025-05-28,26,DPD90+,0,0,0
2025-05-28,32,Current,0,0,0
2025-05-28,32,DPD15-29,66,66,0
2025-05-28,32,DPD3-14,59,56,3
2025-05-28,32,DPD30-59,43,43,0
2025-05-28,32,DPD60-89,0,0,0
2025-05-28,32,DPD90+,0,0,0
2025-05-28,34,Current,0,0,0
2025-05-28,34,DPD15-29,27,27,0
2025-05-28,34,DPD3-14,15,13,2
2025-05-28,34,DPD30-59,16,16,0
2025-05-28,34,DPD60-89,0,0,0
2025-05-28,34,DPD90+,0,0,0
2025-05-28,36,Current,0,0,0
2025-05-28,36,DPD15-29,15,15,0
2025-05-28,36,DPD3-14,8,8,0
2025-05-28,36,DPD30-59,10,10,0
2025-05-28,36,DPD60-89,0,0,0
2025-05-28,36,DPD90+,0,0,0
2025-05-28,38,Current,11,11,0
2025-05-28,38,DPD15-29,16,16,0
2025-05-28,38,DPD3-14,22,20,2
2025-05-28,38,DPD30-59,5,5,0
2025-05-28,38,DPD60-89,0,0,0
2025-05-28,38,DPD90+,0,0,0
2025-05-28,40,Current,0,0,0
2025-05-28,40,DPD15-29,13,13,0
2025-05-28,40,DPD3-14,6,5,1
2025-05-28,40,DPD30-59,4,4,0
2025-05-28,40,DPD60-89,0,0,0
2025-05-28,40,DPD90+,0,0,0
2025-05-28,42,Current,0,0,0
2025-05-28,42,DPD15-29,5,5,0
2025-05-28,42,DPD3-14,4,4,0
2025-05-28,42,DPD30-59,2,2,0
2025-05-28,42,DPD60-89,0,0,0
2025-05-28,42,DPD90+,0,0,0
2025-05-28,44,Current,0,0,0
2025-05-28,44,DPD15-29,20,20,0
2025-05-28,44,DPD3-14,8,8,0
2025-05-28,44,DPD30-59,9,9,0
2025-05-28,44,DPD60-89,0,0,0
2025-05-28,44,DPD90+,1,1,0
2025-05-28,46,Current,0,0,0
2025-05-28,48,Current,31,31,0
2025-05-28,48,DPD15-29,20,20,0
2025-05-28,48,DPD3-14,25,23,2
2025-05-28,48,DPD30-59,19,19,0
2025-05-28,48,DPD60-89,0,0,0
2025-05-28,48,DPD90+,0,0,0
2025-05-28,54,Current,15,15,0
2025-05-28,56,Current,0,0,0
2025-05-28,56,DPD15-29,1,1,0
2025-05-28,56,DPD3-14,0,0,0
2025-05-28,6,Current,0,0,0
2025-05-27,100,Current,0,0,0
2025-05-27,100,DPD15-29,0,0,0
2025-05-27,102,Current,0,0,0
2025-05-27,104,Current,0,0,0
2025-05-27,20,Current,0,0,0
2025-05-27,20,DPD15-29,97,97,0
2025-05-27,20,DPD3-14,118,108,10
2025-05-27,20,DPD30-59,48,48,0
2025-05-27,20,DPD60-89,0,0,0
2025-05-27,20,DPD90+,0,0,0
2025-05-27,22,Current,0,0,0
2025-05-27,24,Current,31,31,0
2025-05-27,24,DPD15-29,65,65,0
2025-05-27,24,DPD3-14,73,66,7
2025-05-27,24,DPD30-59,35,35,0
2025-05-27,24,DPD60-89,0,0,0
2025-05-27,24,DPD90+,0,0,0
2025-05-27,26,Current,0,0,0
2025-05-27,26,DPD15-29,11,11,0
2025-05-27,26,DPD3-14,4,3,1
2025-05-27,26,DPD30-59,3,3,0
2025-05-27,26,DPD60-89,0,0,0
2025-05-27,26,DPD90+,0,0,0
2025-05-27,32,Current,1,1,0
2025-05-27,32,DPD15-29,57,57,0
2025-05-27,32,DPD3-14,76,75,1
2025-05-27,32,DPD30-59,24,24,0
2025-05-27,32,DPD60-89,0,0,0
2025-05-27,32,DPD90+,0,0,0
2025-05-27,34,Current,0,0,0
2025-05-27,34,DPD15-29,23,23,0
2025-05-27,34,DPD3-14,29,28,1
2025-05-27,34,DPD30-59,7,7,0
2025-05-27,34,DPD60-89,0,0,0
2025-05-27,34,DPD90+,0,0,0
2025-05-27,36,Current,0,0,0
2025-05-27,36,DPD15-29,11,11,0
2025-05-27,36,DPD3-14,13,11,2
2025-05-27,36,DPD30-59,11,11,0
2025-05-27,36,DPD60-89,0,0,0
2025-05-27,36,DPD90+,0,0,0
2025-05-27,38,Current,8,8,0
2025-05-27,38,DPD15-29,20,20,0
2025-05-27,38,DPD3-14,24,23,1
2025-05-27,38,DPD30-59,7,7,0
2025-05-27,38,DPD60-89,0,0,0
2025-05-27,38,DPD90+,0,0,0
2025-05-27,40,Current,0,0,0
2025-05-27,40,DPD15-29,8,8,0
2025-05-27,40,DPD3-14,8,7,1
2025-05-27,40,DPD30-59,6,6,0
2025-05-27,40,DPD60-89,0,0,0
2025-05-27,40,DPD90+,0,0,0
2025-05-27,42,Current,0,0,0
2025-05-27,42,DPD15-29,6,6,0
2025-05-27,42,DPD3-14,4,4,0
2025-05-27,42,DPD30-59,0,0,0
2025-05-27,42,DPD60-89,0,0,0
2025-05-27,42,DPD90+,0,0,0
2025-05-27,44,Current,0,0,0
2025-05-27,44,DPD15-29,16,16,0
2025-05-27,44,DPD3-14,16,16,0
2025-05-27,44,DPD30-59,4,4,0
2025-05-27,44,DPD60-89,0,0,0
2025-05-27,44,DPD90+,0,0,0
2025-05-27,46,Current,0,0,0
2025-05-27,48,Current,21,21,0
2025-05-27,48,DPD15-29,23,22,1
2025-05-27,48,DPD3-14,30,29,1
2025-05-27,48,DPD30-59,11,11,0
2025-05-27,48,DPD60-89,0,0,0
2025-05-27,48,DPD90+,0,0,0
2025-05-27,54,Current,5,5,0
2025-05-27,56,Current,0,0,0
2025-05-27,56,DPD15-29,0,0,0
2025-05-27,56,DPD3-14,1,1,0
2025-05-27,6,Current,0,0,0
2025-05-26,100,Current,0,0,0
2025-05-26,100,DPD15-29,0,0,0
2025-05-26,102,Current,0,0,0
2025-05-26,104,Current,0,0,0
2025-05-26,20,Current,0,0,0
2025-05-26,20,DPD15-29,143,142,1
2025-05-26,20,DPD3-14,207,206,1
2025-05-26,20,DPD30-59,117,117,0
2025-05-26,20,DPD60-89,0,0,0
2025-05-26,20,DPD90+,0,0,0
2025-05-26,22,Current,0,0,0
2025-05-26,24,Current,68,68,0
2025-05-26,24,DPD15-29,85,85,0
2025-05-26,24,DPD3-14,120,120,0
2025-05-26,24,DPD30-59,69,69,0
2025-05-26,24,DPD60-89,0,0,0
2025-05-26,24,DPD90+,0,0,0
2025-05-26,26,Current,0,0,0
2025-05-26,26,DPD15-29,10,10,0
2025-05-26,26,DPD3-14,10,10,0
2025-05-26,26,DPD30-59,8,8,0
2025-05-26,26,DPD60-89,0,0,0
2025-05-26,26,DPD90+,0,0,0
2025-05-26,32,Current,0,0,0
2025-05-26,32,DPD15-29,72,72,0
2025-05-26,32,DPD3-14,96,96,0
2025-05-26,32,DPD30-59,54,54,0
2025-05-26,32,DPD60-89,0,0,0
2025-05-26,32,DPD90+,0,0,0
2025-05-26,34,Current,0,0,0
2025-05-26,34,DPD15-29,25,25,0
2025-05-26,34,DPD3-14,23,23,0
2025-05-26,34,DPD30-59,23,23,0
2025-05-26,34,DPD60-89,0,0,0
2025-05-26,34,DPD90+,0,0,0
2025-05-26,36,Current,0,0,0
2025-05-26,36,DPD15-29,17,17,0
2025-05-26,36,DPD3-14,18,18,0
2025-05-26,36,DPD30-59,14,14,0
2025-05-26,36,DPD60-89,0,0,0
2025-05-26,36,DPD90+,0,0,0
2025-05-26,38,Current,9,9,0
2025-05-26,38,DPD15-29,17,17,0
2025-05-26,38,DPD3-14,33,32,1
2025-05-26,38,DPD30-59,10,10,0
2025-05-26,38,DPD60-89,0,0,0
2025-05-26,38,DPD90+,0,0,0
2025-05-26,40,Current,0,0,0
2025-05-26,40,DPD15-29,16,16,0
2025-05-26,40,DPD3-14,18,18,0
2025-05-26,40,DPD30-59,3,3,0
2025-05-26,40,DPD60-89,0,0,0
2025-05-26,40,DPD90+,0,0,0
2025-05-26,42,Current,0,0,0
2025-05-26,42,DPD15-29,3,3,0
2025-05-26,42,DPD3-14,9,9,0
2025-05-26,42,DPD30-59,1,1,0
2025-05-26,42,DPD60-89,0,0,0
2025-05-26,42,DPD90+,0,0,0
2025-05-26,44,Current,0,0,0
2025-05-26,44,DPD15-29,21,21,0
2025-05-26,44,DPD3-14,22,22,0
2025-05-26,44,DPD30-59,11,11,0
2025-05-26,44,DPD60-89,0,0,0
2025-05-26,44,DPD90+,0,0,0
2025-05-26,46,Current,0,0,0
2025-05-26,48,Current,42,42,0
2025-05-26,48,DPD15-29,20,20,0
2025-05-26,48,DPD3-14,34,34,0
2025-05-26,48,DPD30-59,26,26,0
2025-05-26,48,DPD60-89,0,0,0
2025-05-26,48,DPD90+,0,0,0
2025-05-26,54,Current,12,12,0
2025-05-26,56,Current,6,6,0
2025-05-26,56,DPD15-29,1,1,0
2025-05-26,56,DPD3-14,0,0,0
2025-05-26,6,Current,0,0,0
2025-05-25,100,Current,0,0,0
2025-05-25,100,DPD15-29,0,0,0
2025-05-25,102,Current,0,0,0
2025-05-25,104,Current,0,0,0
2025-05-25,20,Current,0,0,0
2025-05-25,20,DPD15-29,90,90,0
2025-05-25,20,DPD3-14,93,93,0
2025-05-25,20,DPD30-59,40,40,0
2025-05-25,20,DPD60-89,0,0,0
2025-05-25,20,DPD90+,0,0,0
2025-05-25,22,Current,0,0,0
2025-05-25,24,Current,33,33,0
2025-05-25,24,DPD15-29,66,66,0
2025-05-25,24,DPD3-14,70,69,1
2025-05-25,24,DPD30-59,29,29,0
2025-05-25,24,DPD60-89,0,0,0
2025-05-25,24,DPD90+,0,0,0
2025-05-25,26,Current,0,0,0
2025-05-25,26,DPD15-29,11,11,0
2025-05-25,26,DPD3-14,5,5,0
2025-05-25,26,DPD30-59,2,2,0
2025-05-25,26,DPD60-89,0,0,0
2025-05-25,26,DPD90+,0,0,0
2025-05-25,32,Current,0,0,0
2025-05-25,32,DPD15-29,59,59,0
2025-05-25,32,DPD3-14,60,59,1
2025-05-25,32,DPD30-59,15,15,0
2025-05-25,32,DPD60-89,0,0,0
2025-05-25,32,DPD90+,0,0,0
2025-05-25,34,Current,0,0,0
2025-05-25,34,DPD15-29,18,18,0
2025-05-25,34,DPD3-14,21,21,0
2025-05-25,34,DPD30-59,4,4,0
2025-05-25,34,DPD60-89,0,0,0
2025-05-25,34,DPD90+,0,0,0
2025-05-25,36,Current,0,0,0
2025-05-25,36,DPD15-29,11,11,0
2025-05-25,36,DPD3-14,10,10,0
2025-05-25,36,DPD30-59,6,6,0
2025-05-25,36,DPD60-89,0,0,0
2025-05-25,36,DPD90+,0,0,0
2025-05-25,38,Current,5,5,0
2025-05-25,38,DPD15-29,18,18,0
2025-05-25,38,DPD3-14,21,21,0
2025-05-25,38,DPD30-59,8,8,0
2025-05-25,38,DPD60-89,0,0,0
2025-05-25,38,DPD90+,0,0,0
2025-05-25,40,Current,0,0,0
2025-05-25,40,DPD15-29,7,7,0
2025-05-25,40,DPD3-14,4,4,0
2025-05-25,40,DPD30-59,5,5,0
2025-05-25,40,DPD60-89,0,0,0
2025-05-25,40,DPD90+,0,0,0
2025-05-25,42,Current,0,0,0
2025-05-25,42,DPD15-29,5,5,0
2025-05-25,42,DPD3-14,1,1,0
2025-05-25,42,DPD30-59,1,1,0
2025-05-25,42,DPD60-89,0,0,0
2025-05-25,42,DPD90+,0,0,0
2025-05-25,44,Current,0,0,0
2025-05-25,44,DPD15-29,14,14,0
2025-05-25,44,DPD3-14,19,19,0
2025-05-25,44,DPD30-59,3,3,0
2025-05-25,44,DPD60-89,0,0,0
2025-05-25,44,DPD90+,0,0,0
2025-05-25,46,Current,0,0,0
2025-05-25,48,Current,25,25,0
2025-05-25,48,DPD15-29,21,21,0
2025-05-25,48,DPD3-14,20,20,0
2025-05-25,48,DPD30-59,8,8,0
2025-05-25,48,DPD60-89,0,0,0
2025-05-25,48,DPD90+,0,0,0
2025-05-25,54,Current,4,4,0
2025-05-25,56,Current,7,7,0
2025-05-25,56,DPD15-29,0,0,0
2025-05-25,56,DPD3-14,1,1,0
2025-05-25,6,Current,0,0,0
2025-05-24,100,Current,0,0,0
2025-05-24,100,DPD15-29,0,0,0
2025-05-24,102,Current,0,0,0
2025-05-24,104,Current,0,0,0
2025-05-24,20,Current,0,0,0
2025-05-24,20,DPD15-29,146,145,1
2025-05-24,20,DPD3-14,139,139,0
2025-05-24,20,DPD30-59,109,109,0
2025-05-24,20,DPD60-89,0,0,0
2025-05-24,20,DPD90+,0,0,0
2025-05-24,22,Current,0,0,0
2025-05-24,24,Current,37,37,0
2025-05-24,24,DPD15-29,79,79,0
2025-05-24,24,DPD3-14,90,90,0
2025-05-24,24,DPD30-59,65,65,0
2025-05-24,24,DPD60-89,0,0,0
2025-05-24,24,DPD90+,0,0,0
2025-05-24,26,Current,0,0,0
2025-05-24,26,DPD15-29,8,8,0
2025-05-24,26,DPD3-14,10,10,0
2025-05-24,26,DPD30-59,6,6,0
2025-05-24,26,DPD60-89,0,0,0
2025-05-24,26,DPD90+,0,0,0
2025-05-24,32,Current,0,0,0
2025-05-24,32,DPD15-29,80,80,0
2025-05-24,32,DPD3-14,65,65,0
2025-05-24,32,DPD30-59,45,45,0
2025-05-24,32,DPD60-89,0,0,0
2025-05-24,32,DPD90+,0,0,0
2025-05-24,34,Current,0,0,0
2025-05-24,34,DPD15-29,31,31,0
2025-05-24,34,DPD3-14,14,14,0
2025-05-24,34,DPD30-59,21,21,0
2025-05-24,34,DPD60-89,0,0,0
2025-05-24,34,DPD90+,0,0,0
2025-05-24,36,Current,0,0,0
2025-05-24,36,DPD15-29,20,20,0
2025-05-24,36,DPD3-14,10,10,0
2025-05-24,36,DPD30-59,11,11,0
2025-05-24,36,DPD60-89,0,0,0
2025-05-24,36,DPD90+,0,0,0
2025-05-24,38,Current,2,2,0
2025-05-24,38,DPD15-29,26,26,0
2025-05-24,38,DPD3-14,16,15,1
2025-05-24,38,DPD30-59,9,9,0
2025-05-24,38,DPD60-89,0,0,0
2025-05-24,38,DPD90+,0,0,0
2025-05-24,40,Current,0,0,0
2025-05-24,40,DPD15-29,14,14,0
2025-05-24,40,DPD3-14,12,12,0
2025-05-24,40,DPD30-59,6,6,0
2025-05-24,40,DPD60-89,0,0,0
2025-05-24,40,DPD90+,0,0,0
2025-05-24,42,Current,0,0,0
2025-05-24,42,DPD15-29,4,4,0
2025-05-24,42,DPD3-14,7,7,0
2025-05-24,42,DPD30-59,1,1,0
2025-05-24,42,DPD60-89,0,0,0
2025-05-24,42,DPD90+,0,0,0
2025-05-24,44,Current,0,0,0
2025-05-24,44,DPD15-29,21,21,0
2025-05-24,44,DPD3-14,16,16,0
2025-05-24,44,DPD30-59,10,10,0
2025-05-24,44,DPD60-89,0,0,0
2025-05-24,44,DPD90+,0,0,0
2025-05-24,46,Current,0,0,0
2025-05-24,48,Current,22,22,0
2025-05-24,48,DPD15-29,14,14,0
2025-05-24,48,DPD3-14,32,32,0
2025-05-24,48,DPD30-59,24,24,0
2025-05-24,48,DPD60-89,0,0,0
2025-05-24,48,DPD90+,0,0,0
2025-05-24,54,Current,4,4,0
2025-05-24,56,Current,5,5,0
2025-05-24,56,DPD3-14,0,0,0
2025-05-24,6,Current,0,0,0
2025-05-23,100,Current,0,0,0
2025-05-23,100,DPD15-29,0,0,0
2025-05-23,102,Current,0,0,0
2025-05-23,104,Current,0,0,0
2025-05-23,20,Current,0,0,0
2025-05-23,20,DPD15-29,91,91,0
2025-05-23,20,DPD3-14,107,107,0
2025-05-23,20,DPD30-59,36,36,0
2025-05-23,20,DPD60-89,0,0,0
2025-05-23,20,DPD90+,0,0,0
2025-05-23,22,Current,0,0,0
2025-05-23,24,Current,49,49,0
2025-05-23,24,DPD15-29,67,67,0
2025-05-23,24,DPD3-14,73,72,1
2025-05-23,24,DPD30-59,27,27,0
2025-05-23,24,DPD60-89,0,0,0
2025-05-23,24,DPD90+,0,0,0
2025-05-23,26,Current,0,0,0
2025-05-23,26,DPD15-29,11,11,0
2025-05-23,26,DPD3-14,11,11,0
2025-05-23,26,DPD30-59,2,2,0
2025-05-23,26,DPD60-89,0,0,0
2025-05-23,26,DPD90+,0,0,0
2025-05-23,32,Current,0,0,0
2025-05-23,32,DPD15-29,67,67,0
2025-05-23,32,DPD3-14,38,37,1
2025-05-23,32,DPD30-59,14,14,0
2025-05-23,32,DPD60-89,0,0,0
2025-05-23,32,DPD90+,0,0,0
2025-05-23,34,Current,0,0,0
2025-05-23,34,DPD15-29,17,17,0
2025-05-23,34,DPD3-14,22,22,0
2025-05-23,34,DPD30-59,4,4,0
2025-05-23,34,DPD60-89,0,0,0
2025-05-23,34,DPD90+,0,0,0
2025-05-23,36,Current,0,0,0
2025-05-23,36,DPD15-29,11,11,0
2025-05-23,36,DPD3-14,8,8,0
2025-05-23,36,DPD30-59,5,5,0
2025-05-23,36,DPD60-89,0,0,0
2025-05-23,36,DPD90+,0,0,0
2025-05-23,38,Current,4,4,0
2025-05-23,38,DPD15-29,18,18,0
2025-05-23,38,DPD3-14,16,16,0
2025-05-23,38,DPD30-59,7,7,0
2025-05-23,38,DPD60-89,0,0,0
2025-05-23,38,DPD90+,0,0,0
2025-05-23,40,Current,1,1,0
2025-05-23,40,DPD15-29,8,7,1
2025-05-23,40,DPD3-14,7,7,0
2025-05-23,40,DPD30-59,4,4,0
2025-05-23,40,DPD60-89,0,0,0
2025-05-23,40,DPD90+,0,0,0
2025-05-23,42,Current,0,0,0
2025-05-23,42,DPD15-29,5,5,0
2025-05-23,42,DPD3-14,4,4,0
2025-05-23,42,DPD30-59,1,1,0
2025-05-23,42,DPD60-89,0,0,0
2025-05-23,42,DPD90+,0,0,0
2025-05-23,44,Current,1,1,0
2025-05-23,44,DPD15-29,14,14,0
2025-05-23,44,DPD3-14,14,14,0
2025-05-23,44,DPD30-59,3,3,0
2025-05-23,44,DPD60-89,0,0,0
2025-05-23,44,DPD90+,0,0,0
2025-05-23,46,Current,0,0,0
2025-05-23,48,Current,27,27,0
2025-05-23,48,DPD15-29,22,22,0
2025-05-23,48,DPD3-14,24,24,0
2025-05-23,48,DPD30-59,6,6,0
2025-05-23,48,DPD60-89,0,0,0
2025-05-23,48,DPD90+,0,0,0
2025-05-23,54,Current,9,9,0
2025-05-23,56,Current,12,12,0
2025-05-23,56,DPD3-14,0,0,0
2025-05-23,6,Current,0,0,0
2025-05-22,100,Current,0,0,0
2025-05-22,100,DPD15-29,0,0,0
2025-05-22,102,Current,0,0,0
2025-05-22,104,Current,0,0,0
2025-05-22,20,Current,0,0,0
2025-05-22,20,DPD15-29,178,177,1
2025-05-22,20,DPD3-14,107,107,0
2025-05-22,20,DPD30-59,117,117,0
2025-05-22,20,DPD60-89,0,0,0
2025-05-22,20,DPD90+,0,0,0
2025-05-22,22,Current,0,0,0
2025-05-22,24,Current,71,71,0
2025-05-22,24,DPD15-29,96,96,0
2025-05-22,24,DPD3-14,80,80,0
2025-05-22,24,DPD30-59,71,71,0
2025-05-22,24,DPD60-89,0,0,0
2025-05-22,24,DPD90+,0,0,0
2025-05-22,26,Current,0,0,0
2025-05-22,26,DPD15-29,7,7,0
2025-05-22,26,DPD3-14,5,5,0
2025-05-22,26,DPD30-59,6,6,0
2025-05-22,26,DPD60-89,0,0,0
2025-05-22,26,DPD90+,0,0,0
2025-05-22,32,Current,1,1,0
2025-05-22,32,DPD15-29,96,96,0
2025-05-22,32,DPD3-14,42,42,0
2025-05-22,32,DPD30-59,49,49,0
2025-05-22,32,DPD60-89,0,0,0
2025-05-22,32,DPD90+,0,0,0
2025-05-22,34,Current,0,0,0
2025-05-22,34,DPD15-29,35,35,0
2025-05-22,34,DPD3-14,23,23,0
2025-05-22,34,DPD30-59,26,26,0
2025-05-22,34,DPD60-89,0,0,0
2025-05-22,34,DPD90+,0,0,0
2025-05-22,36,Current,0,0,0
2025-05-22,36,DPD15-29,29,29,0
2025-05-22,36,DPD3-14,13,13,0
2025-05-22,36,DPD30-59,10,10,0
2025-05-22,36,DPD60-89,0,0,0
2025-05-22,36,DPD90+,0,0,0
2025-05-22,38,Current,6,6,0
2025-05-22,38,DPD15-29,27,27,0
2025-05-22,38,DPD3-14,15,15,0
2025-05-22,38,DPD30-59,10,10,0
2025-05-22,38,DPD60-89,0,0,0
2025-05-22,38,DPD90+,0,0,0
2025-05-22,40,Current,0,0,0
2025-05-22,40,DPD15-29,17,17,0
2025-05-22,40,DPD3-14,15,15,0
2025-05-22,40,DPD30-59,5,5,0
2025-05-22,40,DPD60-89,0,0,0
2025-05-22,40,DPD90+,0,0,0
2025-05-22,42,Current,0,0,0
2025-05-22,42,DPD15-29,7,7,0
2025-05-22,42,DPD3-14,2,2,0
2025-05-22,42,DPD30-59,2,2,0
2025-05-22,42,DPD60-89,0,0,0
2025-05-22,42,DPD90+,0,0,0
2025-05-22,44,Current,0,0,0
2025-05-22,44,DPD15-29,24,24,0
2025-05-22,44,DPD3-14,26,26,0
2025-05-22,44,DPD30-59,9,9,0
2025-05-22,44,DPD60-89,0,0,0
2025-05-22,44,DPD90+,0,0,0
2025-05-22,46,Current,0,0,0
2025-05-22,48,Current,56,56,0
2025-05-22,48,DPD15-29,18,18,0
2025-05-22,48,DPD3-14,37,36,1
2025-05-22,48,DPD30-59,25,25,0
2025-05-22,48,DPD60-89,0,0,0
2025-05-22,48,DPD90+,0,0,0
2025-05-22,54,Current,9,9,0
2025-05-22,56,Current,21,21,0
2025-05-22,56,DPD3-14,0,0,0
2025-05-22,6,Current,0,0,0
2025-05-21,100,Current,0,0,0
2025-05-21,100,DPD15-29,0,0,0
2025-05-21,102,Current,0,0,0
2025-05-21,104,Current,0,0,0
2025-05-21,20,Current,0,0,0
2025-05-21,20,DPD15-29,104,104,0
2025-05-21,20,DPD3-14,208,208,0
2025-05-21,20,DPD30-59,37,37,0
2025-05-21,20,DPD60-89,0,0,0
2025-05-21,20,DPD90+,0,0,0
2025-05-21,22,Current,0,0,0
2025-05-21,24,Current,73,73,0
2025-05-21,24,DPD15-29,73,73,0
2025-05-21,24,DPD3-14,120,119,1
2025-05-21,24,DPD30-59,24,24,0
2025-05-21,24,DPD60-89,0,0,0
2025-05-21,24,DPD90+,0,0,0
2025-05-21,26,Current,0,0,0
2025-05-21,26,DPD15-29,10,10,0
2025-05-21,26,DPD3-14,13,13,0
2025-05-21,26,DPD30-59,2,2,0
2025-05-21,26,DPD60-89,0,0,0
2025-05-21,26,DPD90+,0,0,0
2025-05-21,32,Current,0,0,0
2025-05-21,32,DPD15-29,66,66,0
2025-05-21,32,DPD3-14,73,73,0
2025-05-21,32,DPD30-59,12,12,0
2025-05-21,32,DPD60-89,0,0,0
2025-05-21,32,DPD90+,0,0,0
2025-05-21,34,Current,0,0,0
2025-05-21,34,DPD15-29,18,18,0
2025-05-21,34,DPD3-14,29,29,0
2025-05-21,34,DPD30-59,4,4,0
2025-05-21,34,DPD60-89,0,0,0
2025-05-21,34,DPD90+,0,0,0
2025-05-21,36,Current,0,0,0
2025-05-21,36,DPD15-29,11,11,0
2025-05-21,36,DPD3-14,12,12,0
2025-05-21,36,DPD30-59,3,3,0
2025-05-21,36,DPD60-89,0,0,0
2025-05-21,36,DPD90+,0,0,0
2025-05-21,38,Current,9,9,0
2025-05-21,38,DPD15-29,17,17,0
2025-05-21,38,DPD3-14,26,26,0
2025-05-21,38,DPD30-59,7,7,0
2025-05-21,38,DPD60-89,0,0,0
2025-05-21,38,DPD90+,0,0,0
2025-05-21,40,Current,0,0,0
2025-05-21,40,DPD15-29,7,6,1
2025-05-21,40,DPD3-14,19,19,0
2025-05-21,40,DPD30-59,3,3,0
2025-05-21,40,DPD60-89,0,0,0
2025-05-21,40,DPD90+,0,0,0
2025-05-21,42,Current,0,0,0
2025-05-21,42,DPD15-29,6,6,0
2025-05-21,42,DPD3-14,12,12,0
2025-05-21,42,DPD30-59,0,0,0
2025-05-21,42,DPD60-89,0,0,0
2025-05-21,42,DPD90+,0,0,0
2025-05-21,44,Current,7,7,0
2025-05-21,44,DPD15-29,17,17,0
2025-05-21,44,DPD3-14,21,21,0
2025-05-21,44,DPD30-59,3,3,0
2025-05-21,44,DPD60-89,0,0,0
2025-05-21,44,DPD90+,0,0,0
2025-05-21,46,Current,0,0,0
2025-05-21,48,Current,36,36,0
2025-05-21,48,DPD15-29,22,22,0
2025-05-21,48,DPD3-14,27,27,0
2025-05-21,48,DPD30-59,2,2,0
2025-05-21,48,DPD60-89,0,0,0
2025-05-21,48,DPD90+,0,0,0
2025-05-21,54,Current,15,15,0
2025-05-21,56,Current,1,1,0
2025-05-21,56,DPD3-14,1,1,0
2025-05-21,6,Current,0,0,0
2025-05-20,100,Current,0,0,0
2025-05-20,100,DPD15-29,0,0,0
2025-05-20,102,Current,0,0,0
2025-05-20,104,Current,0,0,0
2025-05-20,20,Current,0,0,0
2025-05-20,20,DPD15-29,209,208,1
2025-05-20,20,DPD3-14,102,102,0
2025-05-20,20,DPD30-59,124,124,0
2025-05-20,20,DPD60-89,0,0,0
2025-05-20,20,DPD90+,0,0,0
2025-05-20,22,Current,0,0,0
2025-05-20,24,Current,33,33,0
2025-05-20,24,DPD15-29,105,105,0
2025-05-20,24,DPD3-14,78,78,0
2025-05-20,24,DPD30-59,78,78,0
2025-05-20,24,DPD60-89,0,0,0
2025-05-20,24,DPD90+,0,0,0
2025-05-20,26,Current,0,0,0
2025-05-20,26,DPD15-29,6,6,0
2025-05-20,26,DPD3-14,5,5,0
2025-05-20,26,DPD30-59,6,6,0
2025-05-20,26,DPD60-89,0,0,0
2025-05-20,26,DPD90+,0,0,0
2025-05-20,32,Current,2,2,0
2025-05-20,32,DPD15-29,121,121,0
2025-05-20,32,DPD3-14,53,53,0
2025-05-20,32,DPD30-59,58,58,0
2025-05-20,32,DPD60-89,0,0,0
2025-05-20,32,DPD90+,0,0,0
2025-05-20,34,Current,0,0,0
2025-05-20,34,DPD15-29,39,39,0
2025-05-20,34,DPD3-14,21,21,0
2025-05-20,34,DPD30-59,31,31,0
2025-05-20,34,DPD60-89,0,0,0
2025-05-20,34,DPD90+,0,0,0
2025-05-20,36,Current,0,0,0
2025-05-20,36,DPD15-29,33,33,0
2025-05-20,36,DPD3-14,16,16,0
2025-05-20,36,DPD30-59,11,11,0
2025-05-20,36,DPD60-89,0,0,0
2025-05-20,36,DPD90+,0,0,0
2025-05-20,38,Current,6,6,0
2025-05-20,38,DPD15-29,34,34,0
2025-05-20,38,DPD3-14,17,17,0
2025-05-20,38,DPD30-59,13,13,0
2025-05-20,38,DPD60-89,0,0,0
2025-05-20,38,DPD90+,0,0,0
2025-05-20,40,Current,1,1,0
2025-05-20,40,DPD15-29,19,19,0
2025-05-20,40,DPD3-14,10,10,0
2025-05-20,40,DPD30-59,5,5,0
2025-05-20,40,DPD60-89,0,0,0
2025-05-20,40,DPD90+,0,0,0
2025-05-20,42,Current,0,0,0
2025-05-20,42,DPD15-29,9,9,0
2025-05-20,42,DPD3-14,1,1,0
2025-05-20,42,DPD30-59,2,2,0
2025-05-20,42,DPD60-89,0,0,0
2025-05-20,42,DPD90+,0,0,0
2025-05-20,44,Current,0,0,0
2025-05-20,44,DPD15-29,25,25,0
2025-05-20,44,DPD3-14,22,21,1
2025-05-20,44,DPD30-59,13,13,0
2025-05-20,44,DPD60-89,0,0,0
2025-05-20,44,DPD90+,0,0,0
2025-05-20,46,Current,0,0,0
2025-05-20,48,Current,23,23,0
2025-05-20,48,DPD15-29,26,25,1
2025-05-20,48,DPD3-14,32,32,0
2025-05-20,48,DPD30-59,27,27,0
2025-05-20,48,DPD60-89,0,0,0
2025-05-20,48,DPD90+,0,0,0
2025-05-20,54,Current,7,7,0
2025-05-20,56,Current,0,0,0
2025-05-20,56,DPD3-14,0,0,0
2025-05-20,6,Current,0,0,0
2025-05-19,100,Current,0,0,0
2025-05-19,100,DPD15-29,0,0,0
2025-05-19,102,Current,0,0,0
2025-05-19,104,Current,0,0,0
2025-05-19,20,Current,4,1,3
2025-05-19,20,DPD15-29,90,90,0
2025-05-19,20,DPD3-14,189,188,1
2025-05-19,20,DPD30-59,33,33,0
2025-05-19,20,DPD60-89,0,0,0
2025-05-19,20,DPD90+,0,0,0
2025-05-19,22,Current,0,0,0
2025-05-19,24,Current,115,103,12
2025-05-19,24,DPD15-29,69,69,0
2025-05-19,24,DPD3-14,113,113,0
2025-05-19,24,DPD30-59,23,23,0
2025-05-19,24,DPD60-89,0,0,0
2025-05-19,24,DPD90+,0,0,0
2025-05-19,26,Current,1,0,1
2025-05-19,26,DPD15-29,8,8,0
2025-05-19,26,DPD3-14,10,10,0
2025-05-19,26,DPD30-59,2,2,0
2025-05-19,26,DPD60-89,0,0,0
2025-05-19,26,DPD90+,0,0,0
2025-05-19,32,Current,10,4,6
2025-05-19,32,DPD15-29,65,65,0
2025-05-19,32,DPD3-14,78,78,0
2025-05-19,32,DPD30-59,10,10,0
2025-05-19,32,DPD60-89,0,0,0
2025-05-19,32,DPD90+,0,0,0
2025-05-19,34,Current,0,0,0
2025-05-19,34,DPD15-29,19,19,0
2025-05-19,34,DPD3-14,30,30,0
2025-05-19,34,DPD30-59,2,2,0
2025-05-19,34,DPD60-89,0,0,0
2025-05-19,34,DPD90+,0,0,0
2025-05-19,36,Current,0,0,0
2025-05-19,36,DPD15-29,10,10,0
2025-05-19,36,DPD3-14,18,18,0
2025-05-19,36,DPD30-59,3,3,0
2025-05-19,36,DPD60-89,0,0,0
2025-05-19,36,DPD90+,0,0,0
2025-05-19,38,Current,16,14,2
2025-05-19,38,DPD15-29,15,15,0
2025-05-19,38,DPD3-14,33,33,0
2025-05-19,38,DPD30-59,4,4,0
2025-05-19,38,DPD60-89,0,0,0
2025-05-19,38,DPD90+,0,0,0
2025-05-19,40,Current,1,0,1
2025-05-19,40,DPD15-29,8,7,1
2025-05-19,40,DPD3-14,15,15,0
2025-05-19,40,DPD30-59,3,3,0
2025-05-19,40,DPD60-89,0,0,0
2025-05-19,40,DPD90+,0,0,0
2025-05-19,42,Current,0,0,0
2025-05-19,42,DPD15-29,8,8,0
2025-05-19,42,DPD3-14,15,15,0
2025-05-19,42,DPD30-59,0,0,0
2025-05-19,42,DPD60-89,0,0,0
2025-05-19,42,DPD90+,0,0,0
2025-05-19,44,Current,5,1,4
2025-05-19,44,DPD15-29,20,20,0
2025-05-19,44,DPD3-14,25,25,0
2025-05-19,44,DPD30-59,3,3,0
2025-05-19,44,DPD60-89,0,0,0
2025-05-19,44,DPD90+,0,0,0
2025-05-19,46,Current,0,0,0
2025-05-19,48,Current,65,62,3
2025-05-19,48,DPD15-29,20,20,0
2025-05-19,48,DPD3-14,28,28,0
2025-05-19,48,DPD30-59,2,2,0
2025-05-19,48,DPD60-89,0,0,0
2025-05-19,48,DPD90+,0,0,0
2025-05-19,54,Current,29,29,0
2025-05-19,56,Current,0,0,0
2025-05-19,56,DPD3-14,0,0,0
2025-05-19,6,Current,0,0,0
2025-05-18,100,Current,0,0,0
2025-05-18,100,DPD15-29,0,0,0
2025-05-18,102,Current,0,0,0
2025-05-18,104,Current,0,0,0
2025-05-18,20,Current,0,0,0
2025-05-18,20,DPD15-29,228,227,1
2025-05-18,20,DPD3-14,83,83,0
2025-05-18,20,DPD30-59,130,130,0
2025-05-18,20,DPD60-89,0,0,0
2025-05-18,20,DPD90+,0,0,0
2025-05-18,22,Current,0,0,0
2025-05-18,24,Current,33,33,0
2025-05-18,24,DPD15-29,124,124,0
2025-05-18,24,DPD3-14,65,65,0
2025-05-18,24,DPD30-59,81,81,0
2025-05-18,24,DPD60-89,0,0,0
2025-05-18,24,DPD90+,0,0,0
2025-05-18,26,Current,0,0,0
2025-05-18,26,DPD15-29,11,11,0
2025-05-18,26,DPD3-14,8,8,0
2025-05-18,26,DPD30-59,8,8,0
2025-05-18,26,DPD60-89,0,0,0
2025-05-18,26,DPD90+,0,0,0
2025-05-18,32,Current,0,0,0
2025-05-18,32,DPD15-29,132,132,0
2025-05-18,32,DPD3-14,41,41,0
2025-05-18,32,DPD30-59,66,66,0
2025-05-18,32,DPD60-89,0,0,0
2025-05-18,32,DPD90+,0,0,0
2025-05-18,34,Current,0,0,0
2025-05-18,34,DPD15-29,39,39,0
2025-05-18,34,DPD3-14,16,16,0
2025-05-18,34,DPD30-59,32,32,0
2025-05-18,34,DPD60-89,0,0,0
2025-05-18,34,DPD90+,0,0,0
2025-05-18,36,Current,0,0,0
2025-05-18,36,DPD15-29,35,35,0
2025-05-18,36,DPD3-14,4,4,0
2025-05-18,36,DPD30-59,13,13,0
2025-05-18,36,DPD60-89,0,0,0
2025-05-18,36,DPD90+,0,0,0
2025-05-18,38,Current,3,3,0
2025-05-18,38,DPD15-29,39,39,0
2025-05-18,38,DPD3-14,12,12,0
2025-05-18,38,DPD30-59,15,15,0
2025-05-18,38,DPD60-89,0,0,0
2025-05-18,38,DPD90+,0,0,0
2025-05-18,40,Current,0,0,0
2025-05-18,40,DPD15-29,19,19,0
2025-05-18,40,DPD3-14,9,9,0
2025-05-18,40,DPD30-59,6,6,0
2025-05-18,40,DPD60-89,0,0,0
2025-05-18,40,DPD90+,0,0,0
2025-05-18,42,Current,0,0,0
2025-05-18,42,DPD15-29,8,8,0
2025-05-18,42,DPD3-14,3,3,0
2025-05-18,42,DPD30-59,3,3,0
2025-05-18,42,DPD60-89,0,0,0
2025-05-18,42,DPD90+,0,0,0
2025-05-18,44,Current,0,0,0
2025-05-18,44,DPD15-29,31,31,0
2025-05-18,44,DPD3-14,12,12,0
2025-05-18,44,DPD30-59,16,16,0
2025-05-18,44,DPD60-89,0,0,0
2025-05-18,44,DPD90+,0,0,0
2025-05-18,46,Current,0,0,0
2025-05-18,48,Current,19,19,0
2025-05-18,48,DPD15-29,30,29,1
2025-05-18,48,DPD3-14,22,22,0
2025-05-18,48,DPD30-59,26,26,0
2025-05-18,48,DPD60-89,0,0,0
2025-05-18,48,DPD90+,0,0,0
2025-05-18,54,Current,12,12,0
2025-05-18,56,Current,0,0,0
2025-05-18,56,DPD3-14,0,0,0
2025-05-18,6,Current,0,0,0
2025-05-17,100,Current,0,0,0
2025-05-17,100,DPD3-14,0,0,0
2025-05-17,102,Current,0,0,0
2025-05-17,104,Current,0,0,0
2025-05-17,20,Current,0,0,0
2025-05-17,20,DPD15-29,75,75,0
2025-05-17,20,DPD3-14,88,88,0
2025-05-17,20,DPD30-59,26,26,0
2025-05-17,20,DPD60-89,0,0,0
2025-05-17,20,DPD90+,0,0,0
2025-05-17,22,Current,0,0,0
2025-05-17,24,Current,25,25,0
2025-05-17,24,DPD15-29,59,59,0
2025-05-17,24,DPD3-14,48,48,0
2025-05-17,24,DPD30-59,19,19,0
2025-05-17,24,DPD60-89,0,0,0
2025-05-17,24,DPD90+,0,0,0
2025-05-17,26,Current,0,0,0
2025-05-17,26,DPD15-29,5,5,0
2025-05-17,26,DPD3-14,5,5,0
2025-05-17,26,DPD30-59,1,1,0
2025-05-17,26,DPD60-89,0,0,0
2025-05-17,26,DPD90+,0,0,0
2025-05-17,32,Current,0,0,0
2025-05-17,32,DPD15-29,59,59,0
2025-05-17,32,DPD3-14,26,26,0
2025-05-17,32,DPD30-59,7,7,0
2025-05-17,32,DPD60-89,0,0,0
2025-05-17,32,DPD90+,0,0,0
2025-05-17,34,Current,0,0,0
2025-05-17,34,DPD15-29,17,17,0
2025-05-17,34,DPD3-14,15,15,0
2025-05-17,34,DPD30-59,2,2,0
2025-05-17,34,DPD60-89,0,0,0
2025-05-17,34,DPD90+,0,0,0
2025-05-17,36,Current,0,0,0
2025-05-17,36,DPD15-29,8,8,0
2025-05-17,36,DPD3-14,12,12,0
2025-05-17,36,DPD30-59,2,2,0
2025-05-17,36,DPD60-89,0,0,0
2025-05-17,36,DPD90+,0,0,0
2025-05-17,38,Current,7,7,0
2025-05-17,38,DPD15-29,12,12,0
2025-05-17,38,DPD3-14,11,11,0
2025-05-17,38,DPD30-59,3,3,0
2025-05-17,38,DPD60-89,0,0,0
2025-05-17,38,DPD90+,0,0,0
2025-05-17,40,Current,0,0,0
2025-05-17,40,DPD15-29,6,5,1
2025-05-17,40,DPD3-14,4,4,0
2025-05-17,40,DPD30-59,2,2,0
2025-05-17,40,DPD60-89,0,0,0
2025-05-17,40,DPD90+,0,0,0
2025-05-17,42,Current,0,0,0
2025-05-17,42,DPD15-29,7,7,0
2025-05-17,42,DPD3-14,5,5,0
2025-05-17,42,DPD30-59,0,0,0
2025-05-17,42,DPD60-89,0,0,0
2025-05-17,42,DPD90+,0,0,0
2025-05-17,44,Current,3,3,0
2025-05-17,44,DPD15-29,19,19,0
2025-05-17,44,DPD3-14,13,13,0
2025-05-17,44,DPD30-59,3,3,0
2025-05-17,44,DPD60-89,0,0,0
2025-05-17,44,DPD90+,0,0,0
2025-05-17,46,Current,0,0,0
2025-05-17,48,Current,21,21,0
2025-05-17,48,DPD15-29,17,17,0
2025-05-17,48,DPD3-14,21,20,1
2025-05-17,48,DPD30-59,2,2,0
2025-05-17,48,DPD60-89,0,0,0
2025-05-17,48,DPD90+,0,0,0
2025-05-17,54,Current,14,14,0
2025-05-17,56,Current,0,0,0
2025-05-17,56,DPD3-14,0,0,0
2025-05-17,6,Current,0,0,0
2025-05-16,100,Current,0,0,0
2025-05-16,100,DPD3-14,0,0,0
2025-05-16,100,DPD60-89,0,0,0
2025-05-16,102,Current,0,0,0
2025-05-16,104,Current,0,0,0
2025-05-16,20,Current,0,0,0
2025-05-16,20,DPD15-29,283,281,2
2025-05-16,20,DPD3-14,99,99,0
2025-05-16,20,DPD30-59,156,156,0
2025-05-16,20,DPD60-89,0,0,0
2025-05-16,20,DPD90+,0,0,0
2025-05-16,22,Current,0,0,0
2025-05-16,24,Current,47,47,0
2025-05-16,24,DPD15-29,160,160,0
2025-05-16,24,DPD3-14,75,75,0
2025-05-16,24,DPD30-59,83,83,0
2025-05-16,24,DPD60-89,0,0,0
2025-05-16,24,DPD90+,0,0,0
2025-05-16,26,Current,1,1,0
2025-05-16,26,DPD15-29,15,15,0
2025-05-16,26,DPD3-14,12,12,0
2025-05-16,26,DPD30-59,10,10,0
2025-05-16,26,DPD60-89,0,0,0
2025-05-16,26,DPD90+,0,0,0
2025-05-16,32,Current,0,0,0
2025-05-16,32,DPD15-29,152,152,0
2025-05-16,32,DPD3-14,27,27,0
2025-05-16,32,DPD30-59,72,72,0
2025-05-16,32,DPD60-89,0,0,0
2025-05-16,32,DPD90+,0,0,0
2025-05-16,34,Current,0,0,0
2025-05-16,34,DPD15-29,50,50,0
2025-05-16,34,DPD3-14,14,14,0
2025-05-16,34,DPD30-59,32,32,0
2025-05-16,34,DPD60-89,0,0,0
2025-05-16,34,DPD90+,0,0,0
2025-05-16,36,Current,0,0,0
2025-05-16,36,DPD15-29,40,40,0
2025-05-16,36,DPD3-14,6,6,0
2025-05-16,36,DPD30-59,14,14,0
2025-05-16,36,DPD60-89,0,0,0
2025-05-16,36,DPD90+,0,0,0
2025-05-16,38,Current,11,11,0
2025-05-16,38,DPD15-29,43,42,1
2025-05-16,38,DPD3-14,18,18,0
2025-05-16,38,DPD30-59,20,20,0
2025-05-16,38,DPD60-89,0,0,0
2025-05-16,38,DPD90+,0,0,0
2025-05-16,40,Current,0,0,0
2025-05-16,40,DPD15-29,26,26,0
2025-05-16,40,DPD3-14,12,12,0
2025-05-16,40,DPD30-59,9,9,0
2025-05-16,40,DPD60-89,0,0,0
2025-05-16,40,DPD90+,0,0,0
2025-05-16,42,Current,0,0,0
2025-05-16,42,DPD15-29,9,9,0
2025-05-16,42,DPD3-14,4,4,0
2025-05-16,42,DPD30-59,5,5,0
2025-05-16,42,DPD60-89,0,0,0
2025-05-16,42,DPD90+,0,0,0
2025-05-16,44,Current,0,0,0
2025-05-16,44,DPD15-29,33,33,0
2025-05-16,44,DPD3-14,11,11,0
2025-05-16,44,DPD30-59,17,17,0
2025-05-16,44,DPD60-89,0,0,0
2025-05-16,44,DPD90+,0,0,0
2025-05-16,46,Current,0,0,0
2025-05-16,48,Current,21,21,0
2025-05-16,48,DPD15-29,40,39,1
2025-05-16,48,DPD3-14,26,26,0
2025-05-16,48,DPD30-59,32,32,0
2025-05-16,48,DPD60-89,0,0,0
2025-05-16,48,DPD90+,0,0,0
2025-05-16,54,Current,12,12,0
2025-05-16,56,Current,0,0,0
2025-05-16,56,DPD3-14,1,1,0
2025-05-16,6,Current,0,0,0
2025-05-15,100,Current,0,0,0
2025-05-15,100,DPD3-14,0,0,0
2025-05-15,102,Current,0,0,0
2025-05-15,104,Current,0,0,0
2025-05-15,20,Current,0,0,0
2025-05-15,20,DPD15-29,51,51,0
2025-05-15,20,DPD3-14,76,76,0
2025-05-15,20,DPD30-59,21,21,0
2025-05-15,20,DPD60-89,0,0,0
2025-05-15,20,DPD90+,0,0,0
2025-05-15,22,Current,0,0,0
2025-05-15,24,Current,76,76,0
2025-05-15,24,DPD15-29,44,44,0
2025-05-15,24,DPD3-14,50,50,0
2025-05-15,24,DPD30-59,17,17,0
2025-05-15,24,DPD60-89,0,0,0
2025-05-15,24,DPD90+,0,0,0
2025-05-15,26,Current,0,0,0
2025-05-15,26,DPD15-29,6,6,0
2025-05-15,26,DPD3-14,1,1,0
2025-05-15,26,DPD30-59,1,1,0
2025-05-15,26,DPD60-89,0,0,0
2025-05-15,26,DPD90+,0,0,0
2025-05-15,32,Current,0,0,0
2025-05-15,32,DPD15-29,35,35,0
2025-05-15,32,DPD3-14,29,29,0
2025-05-15,32,DPD30-59,4,4,0
2025-05-15,32,DPD60-89,0,0,0
2025-05-15,32,DPD90+,0,0,0
2025-05-15,34,Current,0,0,0
2025-05-15,34,DPD15-29,13,13,0
2025-05-15,34,DPD3-14,19,19,0
2025-05-15,34,DPD30-59,1,1,0
2025-05-15,34,DPD60-89,0,0,0
2025-05-15,34,DPD90+,0,0,0
2025-05-15,36,Current,0,0,0
2025-05-15,36,DPD15-29,6,6,0
2025-05-15,36,DPD3-14,8,8,0
2025-05-15,36,DPD30-59,1,1,0
2025-05-15,36,DPD60-89,0,0,0
2025-05-15,36,DPD90+,0,0,0
2025-05-15,38,Current,8,8,0
2025-05-15,38,DPD15-29,2,2,0
2025-05-15,38,DPD3-14,10,10,0
2025-05-15,38,DPD30-59,2,2,0
2025-05-15,38,DPD60-89,0,0,0
2025-05-15,38,DPD90+,0,0,0
2025-05-15,40,Current,0,0,0
2025-05-15,40,DPD15-29,4,3,1
2025-05-15,40,DPD3-14,6,6,0
2025-05-15,40,DPD30-59,1,1,0
2025-05-15,40,DPD60-89,0,0,0
2025-05-15,40,DPD90+,0,0,0
2025-05-15,42,Current,0,0,0
2025-05-15,42,DPD15-29,2,2,0
2025-05-15,42,DPD3-14,3,3,0
2025-05-15,42,DPD30-59,0,0,0
2025-05-15,42,DPD60-89,0,0,0
2025-05-15,42,DPD90+,0,0,0
2025-05-15,44,Current,0,0,0
2025-05-15,44,DPD15-29,8,8,0
2025-05-15,44,DPD3-14,11,11,0
2025-05-15,44,DPD30-59,2,2,0
2025-05-15,44,DPD60-89,0,0,0
2025-05-15,44,DPD90+,0,0,0
2025-05-15,46,Current,0,0,0
2025-05-15,48,Current,37,37,0
2025-05-15,48,DPD15-29,15,15,0
2025-05-15,48,DPD3-14,21,20,1
2025-05-15,48,DPD30-59,1,1,0
2025-05-15,48,DPD60-89,0,0,0
2025-05-15,48,DPD90+,0,0,0
2025-05-15,54,Current,7,7,0
2025-05-15,56,Current,12,12,0
2025-05-15,56,DPD3-14,0,0,0
2025-05-15,6,Current,0,0,0
2025-05-14,100,Current,0,0,0
2025-05-14,100,DPD3-14,0,0,0
2025-05-14,100,DPD90+,0,0,0
2025-05-14,102,Current,0,0,0
2025-05-14,104,Current,0,0,0
2025-05-14,20,Current,1,1,0
2025-05-14,20,DPD15-29,372,370,2
2025-05-14,20,DPD3-14,77,76,1
2025-05-14,20,DPD30-59,176,176,0
2025-05-14,20,DPD60-89,0,0,0
2025-05-14,20,DPD90+,0,0,0
2025-05-14,22,Current,0,0,0
2025-05-14,24,Current,38,38,0
2025-05-14,24,DPD15-29,223,223,0
2025-05-14,24,DPD3-14,75,75,0
2025-05-14,24,DPD30-59,90,90,0
2025-05-14,24,DPD60-89,0,0,0
2025-05-14,24,DPD90+,0,0,0
2025-05-14,26,Current,0,0,0
2025-05-14,26,DPD15-29,24,24,0
2025-05-14,26,DPD3-14,10,10,0
2025-05-14,26,DPD30-59,12,12,0
2025-05-14,26,DPD60-89,0,0,0
2025-05-14,26,DPD90+,0,0,0
2025-05-14,32,Current,0,0,0
2025-05-14,32,DPD15-29,196,196,0
2025-05-14,32,DPD3-14,35,35,0
2025-05-14,32,DPD30-59,92,92,0
2025-05-14,32,DPD60-89,0,0,0
2025-05-14,32,DPD90+,0,0,0
2025-05-14,34,Current,0,0,0
2025-05-14,34,DPD15-29,72,72,0
2025-05-14,34,DPD3-14,12,12,0
2025-05-14,34,DPD30-59,35,35,0
2025-05-14,34,DPD60-89,0,0,0
2025-05-14,34,DPD90+,0,0,0
2025-05-14,36,Current,0,0,0
2025-05-14,36,DPD15-29,48,48,0
2025-05-14,36,DPD3-14,3,3,0
2025-05-14,36,DPD30-59,15,15,0
2025-05-14,36,DPD60-89,0,0,0
2025-05-14,36,DPD90+,0,0,0
2025-05-14,38,Current,6,6,0
2025-05-14,38,DPD15-29,57,56,1
2025-05-14,38,DPD3-14,15,15,0
2025-05-14,38,DPD30-59,23,23,0
2025-05-14,38,DPD60-89,0,0,0
2025-05-14,38,DPD90+,0,0,0
2025-05-14,40,Current,0,0,0
2025-05-14,40,DPD15-29,30,30,0
2025-05-14,40,DPD3-14,12,12,0
2025-05-14,40,DPD30-59,13,13,0
2025-05-14,40,DPD60-89,0,0,0
2025-05-14,40,DPD90+,0,0,0
2025-05-14,42,Current,0,0,0
2025-05-14,42,DPD15-29,12,12,0
2025-05-14,42,DPD3-14,3,3,0
2025-05-14,42,DPD30-59,9,9,0
2025-05-14,42,DPD60-89,0,0,0
2025-05-14,42,DPD90+,0,0,0
2025-05-14,44,Current,0,0,0
2025-05-14,44,DPD15-29,39,39,0
2025-05-14,44,DPD3-14,11,11,0
2025-05-14,44,DPD30-59,21,21,0
2025-05-14,44,DPD60-89,0,0,0
2025-05-14,44,DPD90+,0,0,0
2025-05-14,46,Current,0,0,0
2025-05-14,48,Current,19,19,0
2025-05-14,48,DPD15-29,50,49,1
2025-05-14,48,DPD3-14,21,21,0
2025-05-14,48,DPD30-59,32,32,0
2025-05-14,48,DPD60-89,0,0,0
2025-05-14,48,DPD90+,0,0,0
2025-05-14,54,Current,8,8,0
2025-05-14,56,Current,0,0,0
2025-05-14,56,DPD3-14,0,0,0
2025-05-14,6,Current,0,0,0
2025-05-13,100,Current,0,0,0
2025-05-13,100,DPD3-14,0,0,0
2025-05-13,100,DPD90+,0,0,0
2025-05-13,102,Current,0,0,0
2025-05-13,104,Current,0,0,0
2025-05-13,20,Current,4,1,3
2025-05-13,20,DPD15-29,27,27,0
2025-05-13,20,DPD3-14,58,58,0
2025-05-13,20,DPD30-59,9,9,0
2025-05-13,20,DPD60-89,0,0,0
2025-05-13,20,DPD90+,0,0,0
2025-05-13,22,Current,0,0,0
2025-05-13,24,Current,56,44,12
2025-05-13,24,DPD15-29,24,24,0
2025-05-13,24,DPD3-14,47,47,0
2025-05-13,24,DPD30-59,6,6,0
2025-05-13,24,DPD60-89,0,0,0
2025-05-13,24,DPD90+,0,0,0
2025-05-13,26,Current,1,0,1
2025-05-13,26,DPD15-29,3,3,0
2025-05-13,26,DPD3-14,5,5,0
2025-05-13,26,DPD30-59,0,0,0
2025-05-13,26,DPD60-89,0,0,0
2025-05-13,26,DPD90+,0,0,0
2025-05-13,32,Current,10,4,6
2025-05-13,32,DPD15-29,22,22,0
2025-05-13,32,DPD3-14,35,35,0
2025-05-13,32,DPD30-59,2,2,0
2025-05-13,32,DPD60-89,0,0,0
2025-05-13,32,DPD90+,0,0,0
2025-05-13,34,Current,0,0,0
2025-05-13,34,DPD15-29,8,8,0
2025-05-13,34,DPD3-14,11,11,0
2025-05-13,34,DPD30-59,0,0,0
2025-05-13,34,DPD60-89,0,0,0
2025-05-13,34,DPD90+,0,0,0
2025-05-13,36,Current,0,0,0
2025-05-13,36,DPD15-29,4,4,0
2025-05-13,36,DPD3-14,9,9,0
2025-05-13,36,DPD30-59,0,0,0
2025-05-13,36,DPD60-89,0,0,0
2025-05-13,36,DPD90+,0,0,0
2025-05-13,38,Current,6,4,2
2025-05-13,38,DPD15-29,1,1,0
2025-05-13,38,DPD3-14,7,7,0
2025-05-13,38,DPD30-59,0,0,0
2025-05-13,38,DPD60-89,0,0,0
2025-05-13,38,DPD90+,0,0,0
2025-05-13,40,Current,1,0,1
2025-05-13,40,DPD15-29,2,2,0
2025-05-13,40,DPD3-14,7,7,0
2025-05-13,40,DPD30-59,0,0,0
2025-05-13,40,DPD60-89,0,0,0
2025-05-13,40,DPD90+,0,0,0
2025-05-13,42,Current,0,0,0
2025-05-13,42,DPD15-29,2,2,0
2025-05-13,42,DPD3-14,4,4,0
2025-05-13,42,DPD30-59,0,0,0
2025-05-13,42,DPD60-89,0,0,0
2025-05-13,42,DPD90+,0,0,0
2025-05-13,44,Current,5,1,4
2025-05-13,44,DPD15-29,4,4,0
2025-05-13,44,DPD3-14,10,10,0
2025-05-13,44,DPD30-59,0,0,0
2025-05-13,44,DPD60-89,0,0,0
2025-05-13,44,DPD90+,0,0,0
2025-05-13,46,Current,0,0,0
2025-05-13,48,Current,29,26,3
2025-05-13,48,DPD15-29,5,5,0
2025-05-13,48,DPD3-14,17,17,0
2025-05-13,48,DPD30-59,1,1,0
2025-05-13,48,DPD60-89,0,0,0
2025-05-13,48,DPD90+,0,0,0
2025-05-13,54,Current,17,17,0
2025-05-13,56,Current,0,0,0
2025-05-13,56,DPD3-14,0,0,0
2025-05-13,6,Current,0,0,0
2025-05-12,100,Current,0,0,0
2025-05-12,100,DPD3-14,0,0,0
2025-05-12,100,DPD90+,0,0,0
2025-05-12,102,Current,0,0,0
2025-05-12,104,Current,0,0,0
2025-05-12,20,Current,0,0,0
2025-05-12,20,DPD15-29,325,323,2
2025-05-12,20,DPD3-14,100,99,1
2025-05-12,20,DPD30-59,178,178,0
2025-05-12,20,DPD60-89,0,0,0
2025-05-12,20,DPD90+,0,0,0
2025-05-12,22,Current,0,0,0
2025-05-12,24,Current,88,88,0
2025-05-12,24,DPD15-29,183,183,0
2025-05-12,24,DPD3-14,55,55,0
2025-05-12,24,DPD30-59,95,95,0
2025-05-12,24,DPD60-89,0,0,0
2025-05-12,24,DPD90+,0,0,0
2025-05-12,26,Current,0,0,0
2025-05-12,26,DPD15-29,24,24,0
2025-05-12,26,DPD3-14,9,9,0
2025-05-12,26,DPD30-59,13,13,0
2025-05-12,26,DPD60-89,0,0,0
2025-05-12,26,DPD90+,0,0,0
2025-05-12,32,Current,0,0,0
2025-05-12,32,DPD15-29,164,164,0
2025-05-12,32,DPD3-14,62,62,0
2025-05-12,32,DPD30-59,100,100,0
2025-05-12,32,DPD60-89,0,0,0
2025-05-12,32,DPD90+,0,0,0
2025-05-12,34,Current,0,0,0
2025-05-12,34,DPD15-29,60,60,0
2025-05-12,34,DPD3-14,22,22,0
2025-05-12,34,DPD30-59,40,40,0
2025-05-12,34,DPD60-89,0,0,0
2025-05-12,34,DPD90+,0,0,0
2025-05-12,36,Current,0,0,0
2025-05-12,36,DPD15-29,46,46,0
2025-05-12,36,DPD3-14,16,16,0
2025-05-12,36,DPD30-59,17,17,0
2025-05-12,36,DPD60-89,0,0,0
2025-05-12,36,DPD90+,0,0,0
2025-05-12,38,Current,9,9,0
2025-05-12,38,DPD15-29,48,47,1
2025-05-12,38,DPD3-14,25,25,0
2025-05-12,38,DPD30-59,26,26,0
2025-05-12,38,DPD60-89,0,0,0
2025-05-12,38,DPD90+,0,0,0
2025-05-12,40,Current,1,1,0
2025-05-12,40,DPD15-29,26,26,0
2025-05-12,40,DPD3-14,11,11,0
2025-05-12,40,DPD30-59,16,16,0
2025-05-12,40,DPD60-89,0,0,0
2025-05-12,40,DPD90+,0,0,0
2025-05-12,42,Current,0,0,0
2025-05-12,42,DPD15-29,11,11,0
2025-05-12,42,DPD3-14,5,5,0
2025-05-12,42,DPD30-59,9,9,0
2025-05-12,42,DPD60-89,0,0,0
2025-05-12,42,DPD90+,0,0,0
2025-05-12,44,Current,0,0,0
2025-05-12,44,DPD15-29,38,38,0
2025-05-12,44,DPD3-14,31,31,0
2025-05-12,44,DPD30-59,22,22,0
2025-05-12,44,DPD60-89,0,0,0
2025-05-12,44,DPD90+,0,0,0
2025-05-12,46,Current,0,0,0
2025-05-12,48,Current,87,87,0
2025-05-12,48,DPD15-29,53,52,1
2025-05-12,48,DPD3-14,29,29,0
2025-05-12,48,DPD30-59,28,28,0
2025-05-12,48,DPD60-89,0,0,0
2025-05-12,48,DPD90+,0,0,0
2025-05-12,54,Current,35,35,0
2025-05-12,56,Current,4,4,0
2025-05-12,6,Current,0,0,0
2025-05-11,100,Current,0,0,0
2025-05-11,100,DPD3-14,0,0,0
2025-05-11,100,DPD90+,0,0,0
2025-05-11,102,Current,0,0,0
2025-05-11,104,Current,0,0,0
2025-05-11,20,Current,0,0,0
2025-05-11,20,DPD15-29,0,0,0
2025-05-11,20,DPD3-14,0,0,0
2025-05-11,20,DPD30-59,0,0,0
2025-05-11,20,DPD60-89,0,0,0
2025-05-11,20,DPD90+,0,0,0
2025-05-11,22,Current,0,0,0
2025-05-11,24,Current,28,28,0
2025-05-11,24,DPD15-29,0,0,0
2025-05-11,24,DPD3-14,0,0,0
2025-05-11,24,DPD30-59,0,0,0
2025-05-11,24,DPD60-89,0,0,0
2025-05-11,24,DPD90+,0,0,0
2025-05-11,26,Current,0,0,0
2025-05-11,26,DPD15-29,0,0,0
2025-05-11,26,DPD3-14,0,0,0
2025-05-11,26,DPD30-59,0,0,0
2025-05-11,26,DPD60-89,0,0,0
2025-05-11,26,DPD90+,0,0,0
2025-05-11,32,Current,1,1,0
2025-05-11,32,DPD15-29,0,0,0
2025-05-11,32,DPD3-14,0,0,0
2025-05-11,32,DPD30-59,0,0,0
2025-05-11,32,DPD60-89,0,0,0
2025-05-11,32,DPD90+,0,0,0
2025-05-11,34,Current,0,0,0
2025-05-11,34,DPD15-29,0,0,0
2025-05-11,34,DPD3-14,0,0,0
2025-05-11,34,DPD30-59,0,0,0
2025-05-11,34,DPD60-89,0,0,0
2025-05-11,34,DPD90+,0,0,0
2025-05-11,36,Current,0,0,0
2025-05-11,36,DPD15-29,0,0,0
2025-05-11,36,DPD3-14,0,0,0
2025-05-11,36,DPD30-59,0,0,0
2025-05-11,36,DPD60-89,0,0,0
2025-05-11,36,DPD90+,0,0,0
2025-05-11,38,Current,4,4,0
2025-05-11,38,DPD15-29,0,0,0
2025-05-11,38,DPD3-14,0,0,0
2025-05-11,38,DPD30-59,0,0,0
2025-05-11,38,DPD60-89,0,0,0
2025-05-11,38,DPD90+,0,0,0
2025-05-11,40,Current,0,0,0
2025-05-11,40,DPD15-29,0,0,0
2025-05-11,40,DPD3-14,0,0,0
2025-05-11,40,DPD30-59,0,0,0
2025-05-11,40,DPD60-89,0,0,0
2025-05-11,40,DPD90+,0,0,0
2025-05-11,42,Current,0,0,0
2025-05-11,42,DPD15-29,0,0,0
2025-05-11,42,DPD3-14,0,0,0
2025-05-11,42,DPD30-59,0,0,0
2025-05-11,42,DPD60-89,0,0,0
2025-05-11,42,DPD90+,0,0,0
2025-05-11,44,Current,0,0,0
2025-05-11,44,DPD15-29,0,0,0
2025-05-11,44,DPD3-14,0,0,0
2025-05-11,44,DPD30-59,0,0,0
2025-05-11,44,DPD60-89,0,0,0
2025-05-11,44,DPD90+,0,0,0
2025-05-11,46,Current,0,0,0
2025-05-11,46,DPD3-14,0,0,0
2025-05-11,48,Current,35,35,0
2025-05-11,48,DPD15-29,0,0,0
2025-05-11,48,DPD3-14,0,0,0
2025-05-11,48,DPD30-59,0,0,0
2025-05-11,48,DPD60-89,0,0,0
2025-05-11,48,DPD90+,0,0,0
2025-05-11,54,Current,4,4,0
2025-05-11,56,Current,5,5,0
2025-05-11,6,Current,0,0,0
2025-05-10,100,Current,0,0,0
2025-05-10,100,DPD3-14,0,0,0
2025-05-10,100,DPD90+,0,0,0
2025-05-10,102,Current,0,0,0
2025-05-10,104,Current,0,0,0
2025-05-10,20,Current,0,0,0
2025-05-10,20,DPD15-29,0,0,0
2025-05-10,20,DPD3-14,0,0,0
2025-05-10,20,DPD30-59,0,0,0
2025-05-10,20,DPD60-89,0,0,0
2025-05-10,20,DPD90+,0,0,0
2025-05-10,22,Current,0,0,0
2025-05-10,24,Current,29,29,0
2025-05-10,24,DPD15-29,0,0,0
2025-05-10,24,DPD3-14,0,0,0
2025-05-10,24,DPD30-59,0,0,0
2025-05-10,24,DPD60-89,0,0,0
2025-05-10,24,DPD90+,0,0,0
2025-05-10,26,Current,0,0,0
2025-05-10,26,DPD15-29,0,0,0
2025-05-10,26,DPD3-14,0,0,0
2025-05-10,26,DPD30-59,0,0,0
2025-05-10,26,DPD60-89,0,0,0
2025-05-10,26,DPD90+,0,0,0
2025-05-10,32,Current,0,0,0
2025-05-10,32,DPD15-29,0,0,0
2025-05-10,32,DPD3-14,0,0,0
2025-05-10,32,DPD30-59,0,0,0
2025-05-10,32,DPD60-89,0,0,0
2025-05-10,32,DPD90+,0,0,0
2025-05-10,34,Current,0,0,0
2025-05-10,34,DPD15-29,0,0,0
2025-05-10,34,DPD3-14,0,0,0
2025-05-10,34,DPD30-59,0,0,0
2025-05-10,34,DPD60-89,0,0,0
2025-05-10,34,DPD90+,0,0,0
2025-05-10,36,Current,0,0,0
2025-05-10,36,DPD15-29,0,0,0
2025-05-10,36,DPD3-14,0,0,0
2025-05-10,36,DPD30-59,0,0,0
2025-05-10,36,DPD60-89,0,0,0
2025-05-10,36,DPD90+,0,0,0
2025-05-10,38,Current,6,6,0
2025-05-10,38,DPD15-29,0,0,0
2025-05-10,38,DPD3-14,0,0,0
2025-05-10,38,DPD30-59,0,0,0
2025-05-10,38,DPD60-89,0,0,0
2025-05-10,38,DPD90+,0,0,0
2025-05-10,40,Current,0,0,0
2025-05-10,40,DPD15-29,0,0,0
2025-05-10,40,DPD3-14,0,0,0
2025-05-10,40,DPD30-59,0,0,0
2025-05-10,40,DPD60-89,0,0,0
2025-05-10,40,DPD90+,0,0,0
2025-05-10,42,Current,0,0,0
2025-05-10,42,DPD15-29,0,0,0
2025-05-10,42,DPD3-14,0,0,0
2025-05-10,42,DPD30-59,0,0,0
2025-05-10,42,DPD60-89,0,0,0
2025-05-10,42,DPD90+,0,0,0
2025-05-10,44,Current,1,1,0
2025-05-10,44,DPD15-29,0,0,0
2025-05-10,44,DPD3-14,0,0,0
2025-05-10,44,DPD30-59,0,0,0
2025-05-10,44,DPD60-89,0,0,0
2025-05-10,44,DPD90+,0,0,0
2025-05-10,46,Current,0,0,0
2025-05-10,46,DPD3-14,0,0,0
2025-05-10,48,Current,38,38,0
2025-05-10,48,DPD15-29,0,0,0
2025-05-10,48,DPD3-14,0,0,0
2025-05-10,48,DPD30-59,0,0,0
2025-05-10,48,DPD60-89,0,0,0
2025-05-10,48,DPD90+,0,0,0
2025-05-10,54,Current,4,4,0
2025-05-10,56,Current,7,7,0
2025-05-10,6,Current,0,0,0
2025-05-09,100,Current,0,0,0
2025-05-09,100,DPD3-14,0,0,0
2025-05-09,100,DPD90+,0,0,0
2025-05-09,102,Current,0,0,0
2025-05-09,104,Current,0,0,0
2025-05-09,20,Current,1,1,0
2025-05-09,20,DPD15-29,152,152,0
2025-05-09,20,DPD3-14,154,154,0
2025-05-09,20,DPD30-59,77,77,0
2025-05-09,20,DPD60-89,0,0,0
2025-05-09,20,DPD90+,0,0,0
2025-05-09,22,Current,0,0,0
2025-05-09,24,Current,49,49,0
2025-05-09,24,DPD15-29,79,79,0
2025-05-09,24,DPD3-14,100,100,0
2025-05-09,24,DPD30-59,50,50,0
2025-05-09,24,DPD60-89,0,0,0
2025-05-09,24,DPD90+,0,0,0
2025-05-09,26,Current,0,0,0
2025-05-09,26,DPD15-29,14,14,0
2025-05-09,26,DPD3-14,10,10,0
2025-05-09,26,DPD30-59,5,5,0
2025-05-09,26,DPD60-89,0,0,0
2025-05-09,26,DPD90+,0,0,0
2025-05-09,32,Current,0,0,0
2025-05-09,32,DPD15-29,82,82,0
2025-05-09,32,DPD3-14,70,70,0
2025-05-09,32,DPD30-59,51,51,0
2025-05-09,32,DPD60-89,0,0,0
2025-05-09,32,DPD90+,0,0,0
2025-05-09,34,Current,0,0,0
2025-05-09,34,DPD15-29,27,27,0
2025-05-09,34,DPD3-14,20,20,0
2025-05-09,34,DPD30-59,21,21,0
2025-05-09,34,DPD60-89,0,0,0
2025-05-09,34,DPD90+,0,0,0
2025-05-09,36,Current,0,0,0
2025-05-09,36,DPD15-29,16,16,0
2025-05-09,36,DPD3-14,18,18,0
2025-05-09,36,DPD30-59,13,13,0
2025-05-09,36,DPD60-89,0,0,0
2025-05-09,36,DPD90+,0,0,0
2025-05-09,38,Current,5,5,0
2025-05-09,38,DPD15-29,15,15,0
2025-05-09,38,DPD3-14,21,21,0
2025-05-09,38,DPD30-59,14,14,0
2025-05-09,38,DPD60-89,0,0,0
2025-05-09,38,DPD90+,0,0,0
2025-05-09,40,Current,0,0,0
2025-05-09,40,DPD15-29,8,8,0
2025-05-09,40,DPD3-14,12,12,0
2025-05-09,40,DPD30-59,7,7,0
2025-05-09,40,DPD60-89,0,0,0
2025-05-09,40,DPD90+,0,0,0
2025-05-09,42,Current,0,0,0
2025-05-09,42,DPD15-29,7,7,0
2025-05-09,42,DPD3-14,8,8,0
2025-05-09,42,DPD30-59,5,5,0
2025-05-09,42,DPD60-89,0,0,0
2025-05-09,42,DPD90+,0,0,0
2025-05-09,44,Current,3,3,0
2025-05-09,44,DPD15-29,19,19,0
2025-05-09,44,DPD3-14,15,15,0
2025-05-09,44,DPD30-59,7,7,0
2025-05-09,44,DPD60-89,0,0,0
2025-05-09,44,DPD90+,0,0,0
2025-05-09,46,Current,0,0,0
2025-05-09,46,DPD3-14,0,0,0
2025-05-09,48,Current,32,32,0
2025-05-09,48,DPD15-29,19,19,0
2025-05-09,48,DPD3-14,23,23,0
2025-05-09,48,DPD30-59,13,13,0
2025-05-09,48,DPD60-89,0,0,0
2025-05-09,48,DPD90+,0,0,0
2025-05-09,54,Current,8,8,0
2025-05-09,56,Current,7,7,0
2025-05-09,6,Current,0,0,0
2025-05-08,100,Current,0,0,0
2025-05-08,100,DPD3-14,0,0,0
2025-05-08,100,DPD90+,0,0,0
2025-05-08,102,Current,0,0,0
2025-05-08,104,Current,0,0,0
2025-05-08,20,Current,0,0,0
2025-05-08,20,DPD15-29,177,176,1
2025-05-08,20,DPD3-14,68,68,0
2025-05-08,20,DPD30-59,118,118,0
2025-05-08,20,DPD60-89,0,0,0
2025-05-08,20,DPD90+,0,0,0
2025-05-08,22,Current,0,0,0
2025-05-08,24,Current,49,49,0
2025-05-08,24,DPD15-29,103,103,0
2025-05-08,24,DPD3-14,57,57,0
2025-05-08,24,DPD30-59,51,51,0
2025-05-08,24,DPD60-89,0,0,0
2025-05-08,24,DPD90+,0,0,0
2025-05-08,26,Current,0,0,0
2025-05-08,26,DPD15-29,11,11,0
2025-05-08,26,DPD3-14,6,6,0
2025-05-08,26,DPD30-59,5,5,0
2025-05-08,26,DPD60-89,0,0,0
2025-05-08,26,DPD90+,0,0,0
2025-05-08,32,Current,1,1,0
2025-05-08,32,DPD15-29,73,73,0
2025-05-08,32,DPD3-14,43,43,0
2025-05-08,32,DPD30-59,43,43,0
2025-05-08,32,DPD60-89,0,0,0
2025-05-08,32,DPD90+,0,0,0
2025-05-08,34,Current,0,0,0
2025-05-08,34,DPD15-29,32,32,0
2025-05-08,34,DPD3-14,21,21,0
2025-05-08,34,DPD30-59,17,17,0
2025-05-08,34,DPD60-89,0,0,0
2025-05-08,34,DPD90+,0,0,0
2025-05-08,36,Current,0,0,0
2025-05-08,36,DPD15-29,22,22,0
2025-05-08,36,DPD3-14,14,14,0
2025-05-08,36,DPD30-59,10,10,0
2025-05-08,36,DPD60-89,0,0,0
2025-05-08,36,DPD90+,0,0,0
2025-05-08,38,Current,5,5,0
2025-05-08,38,DPD15-29,27,26,1
2025-05-08,38,DPD3-14,8,8,0
2025-05-08,38,DPD30-59,17,17,0
2025-05-08,38,DPD60-89,0,0,0
2025-05-08,38,DPD90+,0,0,0
2025-05-08,40,Current,0,0,0
2025-05-08,40,DPD15-29,16,16,0
2025-05-08,40,DPD3-14,5,5,0
2025-05-08,40,DPD30-59,13,13,0
2025-05-08,40,DPD60-89,0,0,0
2025-05-08,40,DPD90+,0,0,0
2025-05-08,42,Current,0,0,0
2025-05-08,42,DPD15-29,5,5,0
2025-05-08,42,DPD3-14,3,3,0
2025-05-08,42,DPD30-59,3,3,0
2025-05-08,42,DPD60-89,0,0,0
2025-05-08,42,DPD90+,0,0,0
2025-05-08,44,Current,0,0,0
2025-05-08,44,DPD15-29,25,25,0
2025-05-08,44,DPD3-14,10,10,0
2025-05-08,44,DPD30-59,11,11,0
2025-05-08,44,DPD60-89,0,0,0
2025-05-08,44,DPD90+,0,0,0
2025-05-08,46,Current,0,0,0
2025-05-08,46,DPD3-14,0,0,0
2025-05-08,48,Current,59,59,0
2025-05-08,48,DPD15-29,34,33,1
2025-05-08,48,DPD3-14,14,14,0
2025-05-08,48,DPD30-59,16,16,0
2025-05-08,48,DPD60-89,0,0,0
2025-05-08,48,DPD90+,0,0,0
2025-05-08,54,Current,8,8,0
2025-05-08,56,Current,13,13,0
2025-05-08,6,Current,0,0,0
2025-05-07,100,Current,0,0,0
2025-05-07,100,DPD3-14,0,0,0
2025-05-07,100,DPD90+,0,0,0
2025-05-07,102,Current,0,0,0
2025-05-07,104,Current,0,0,0
2025-05-07,20,Current,0,0,0
2025-05-07,20,DPD15-29,153,153,0
2025-05-07,20,DPD3-14,110,109,1
2025-05-07,20,DPD30-59,83,83,0
2025-05-07,20,DPD60-89,0,0,0
2025-05-07,20,DPD90+,0,0,0
2025-05-07,22,Current,0,0,0
2025-05-07,24,Current,50,50,0
2025-05-07,24,DPD15-29,80,80,0
2025-05-07,24,DPD3-14,61,61,0
2025-05-07,24,DPD30-59,53,53,0
2025-05-07,24,DPD60-89,0,0,0
2025-05-07,24,DPD90+,0,0,0
2025-05-07,26,Current,0,0,0
2025-05-07,26,DPD15-29,15,15,0
2025-05-07,26,DPD3-14,10,9,1
2025-05-07,26,DPD30-59,5,5,0
2025-05-07,26,DPD60-89,0,0,0
2025-05-07,26,DPD90+,0,0,0
2025-05-07,32,Current,0,0,0
2025-05-07,32,DPD15-29,73,73,0
2025-05-07,32,DPD3-14,59,59,0
2025-05-07,32,DPD30-59,56,56,0
2025-05-07,32,DPD60-89,0,0,0
2025-05-07,32,DPD90+,0,0,0
2025-05-07,34,Current,1,1,0
2025-05-07,34,DPD15-29,24,24,0
2025-05-07,34,DPD3-14,18,18,0
2025-05-07,34,DPD30-59,22,22,0
2025-05-07,34,DPD60-89,0,0,0
2025-05-07,34,DPD90+,0,0,0
2025-05-07,36,Current,0,0,0
2025-05-07,36,DPD15-29,17,17,0
2025-05-07,36,DPD3-14,14,14,0
2025-05-07,36,DPD30-59,14,14,0
2025-05-07,36,DPD60-89,0,0,0
2025-05-07,36,DPD90+,0,0,0
2025-05-07,38,Current,11,11,0
2025-05-07,38,DPD15-29,12,12,0
2025-05-07,38,DPD3-14,19,19,0
2025-05-07,38,DPD30-59,15,15,0
2025-05-07,38,DPD60-89,0,0,0
2025-05-07,38,DPD90+,1,1,0
2025-05-07,40,Current,0,0,0
2025-05-07,40,DPD15-29,9,9,0
2025-05-07,40,DPD3-14,14,14,0
2025-05-07,40,DPD30-59,8,8,0
2025-05-07,40,DPD60-89,0,0,0
2025-05-07,40,DPD90+,0,0,0
2025-05-07,42,Current,0,0,0
2025-05-07,42,DPD15-29,7,7,0
2025-05-07,42,DPD3-14,11,11,0
2025-05-07,42,DPD30-59,5,5,0
2025-05-07,42,DPD60-89,0,0,0
2025-05-07,42,DPD90+,0,0,0
2025-05-07,44,Current,0,0,0
2025-05-07,44,DPD15-29,18,18,0
2025-05-07,44,DPD3-14,25,25,0
2025-05-07,44,DPD30-59,7,7,0
2025-05-07,44,DPD60-89,0,0,0
2025-05-07,44,DPD90+,0,0,0
2025-05-07,46,Current,0,0,0
2025-05-07,46,DPD3-14,1,1,0
2025-05-07,48,Current,49,49,0
2025-05-07,48,DPD15-29,21,20,1
2025-05-07,48,DPD3-14,26,26,0
2025-05-07,48,DPD30-59,13,13,0
2025-05-07,48,DPD60-89,0,0,0
2025-05-07,48,DPD90+,0,0,0
2025-05-07,54,Current,24,24,0
2025-05-07,56,Current,0,0,0
2025-05-07,6,Current,0,0,0
2025-05-06,100,Current,0,0,0
2025-05-06,100,DPD3-14,0,0,0
2025-05-06,100,DPD90+,0,0,0
2025-05-06,102,Current,0,0,0
2025-05-06,104,Current,0,0,0
2025-05-06,20,Current,0,0,0
2025-05-06,20,DPD15-29,167,167,0
2025-05-06,20,DPD3-14,61,61,0
2025-05-06,20,DPD30-59,86,86,0
2025-05-06,20,DPD60-89,0,0,0
2025-05-06,20,DPD90+,0,0,0
2025-05-06,22,Current,0,0,0
2025-05-06,24,Current,84,84,0
2025-05-06,24,DPD15-29,96,96,0
2025-05-06,24,DPD3-14,25,25,0
2025-05-06,24,DPD30-59,46,46,0
2025-05-06,24,DPD60-89,0,0,0
2025-05-06,24,DPD90+,0,0,0
2025-05-06,26,Current,0,0,0
2025-05-06,26,DPD15-29,10,10,0
2025-05-06,26,DPD3-14,4,4,0
2025-05-06,26,DPD30-59,3,3,0
2025-05-06,26,DPD60-89,0,0,0
2025-05-06,26,DPD90+,0,0,0
2025-05-06,32,Current,0,0,0
2025-05-06,32,DPD15-29,73,73,0
2025-05-06,32,DPD3-14,28,28,0
2025-05-06,32,DPD30-59,36,36,0
2025-05-06,32,DPD60-89,0,0,0
2025-05-06,32,DPD90+,0,0,0
2025-05-06,34,Current,0,0,0
2025-05-06,34,DPD15-29,36,36,0
2025-05-06,34,DPD3-14,10,10,0
2025-05-06,34,DPD30-59,13,13,0
2025-05-06,34,DPD60-89,0,0,0
2025-05-06,34,DPD90+,0,0,0
2025-05-06,36,Current,0,0,0
2025-05-06,36,DPD15-29,22,22,0
2025-05-06,36,DPD3-14,11,11,0
2025-05-06,36,DPD30-59,11,11,0
2025-05-06,36,DPD60-89,0,0,0
2025-05-06,36,DPD90+,0,0,0
2025-05-06,38,Current,25,25,0
2025-05-06,38,DPD15-29,23,22,1
2025-05-06,38,DPD3-14,9,9,0
2025-05-06,38,DPD30-59,14,14,0
2025-05-06,38,DPD60-89,0,0,0
2025-05-06,38,DPD90+,0,0,0
2025-05-06,40,Current,0,0,0
2025-05-06,40,DPD15-29,15,15,0
2025-05-06,40,DPD3-14,5,5,0
2025-05-06,40,DPD30-59,12,12,0
2025-05-06,40,DPD60-89,0,0,0
2025-05-06,40,DPD90+,0,0,0
2025-05-06,42,Current,0,0,0
2025-05-06,42,DPD15-29,5,5,0
2025-05-06,42,DPD3-14,1,1,0
2025-05-06,42,DPD30-59,2,2,0
2025-05-06,42,DPD60-89,0,0,0
2025-05-06,42,DPD90+,0,0,0
2025-05-06,44,Current,43,43,0
2025-05-06,44,DPD15-29,22,22,0
2025-05-06,44,DPD3-14,9,9,0
2025-05-06,44,DPD30-59,14,14,0
2025-05-06,44,DPD60-89,0,0,0
2025-05-06,44,DPD90+,0,0,0
2025-05-06,46,Current,0,0,0
2025-05-06,46,DPD3-14,0,0,0
2025-05-06,48,Current,28,28,0
2025-05-06,48,DPD15-29,35,34,1
2025-05-06,48,DPD3-14,11,11,0
2025-05-06,48,DPD30-59,12,12,0
2025-05-06,48,DPD60-89,0,0,0
2025-05-06,48,DPD90+,0,0,0
2025-05-06,54,Current,10,10,0
2025-05-06,56,Current,1,1,0
2025-05-06,6,Current,0,0,0
2025-05-05,100,Current,0,0,0
2025-05-05,100,DPD60-89,0,0,0
2025-05-05,102,Current,0,0,0
2025-05-05,104,Current,0,0,0
2025-05-05,20,Current,0,0,0
2025-05-05,20,DPD15-29,154,154,0
2025-05-05,20,DPD3-14,85,85,0
2025-05-05,20,DPD30-59,84,84,0
2025-05-05,20,DPD60-89,0,0,0
2025-05-05,20,DPD90+,0,0,0
2025-05-05,22,Current,0,0,0
2025-05-05,24,Current,105,105,0
2025-05-05,24,DPD15-29,70,70,0
2025-05-05,24,DPD3-14,49,49,0
2025-05-05,24,DPD30-59,50,50,0
2025-05-05,24,DPD60-89,0,0,0
2025-05-05,24,DPD90+,0,0,0
2025-05-05,26,Current,0,0,0
2025-05-05,26,DPD15-29,13,13,0
2025-05-05,26,DPD3-14,8,8,0
2025-05-05,26,DPD30-59,4,4,0
2025-05-05,26,DPD60-89,0,0,0
2025-05-05,26,DPD90+,0,0,0
2025-05-05,32,Current,0,0,0
2025-05-05,32,DPD15-29,63,63,0
2025-05-05,32,DPD3-14,58,58,0
2025-05-05,32,DPD30-59,52,52,0
2025-05-05,32,DPD60-89,0,0,0
2025-05-05,32,DPD90+,0,0,0
2025-05-05,34,Current,1,1,0
2025-05-05,34,DPD15-29,24,24,0
2025-05-05,34,DPD3-14,22,22,0
2025-05-05,34,DPD30-59,22,22,0
2025-05-05,34,DPD60-89,0,0,0
2025-05-05,34,DPD90+,0,0,0
2025-05-05,36,Current,1,1,0
2025-05-05,36,DPD15-29,14,14,0
2025-05-05,36,DPD3-14,14,14,0
2025-05-05,36,DPD30-59,13,13,0
2025-05-05,36,DPD60-89,0,0,0
2025-05-05,36,DPD90+,0,0,0
2025-05-05,38,Current,9,9,0
2025-05-05,38,DPD15-29,13,13,0
2025-05-05,38,DPD3-14,30,30,0
2025-05-05,38,DPD30-59,15,15,0
2025-05-05,38,DPD60-89,0,0,0
2025-05-05,38,DPD90+,0,0,0
2025-05-05,40,Current,0,0,0
2025-05-05,40,DPD15-29,8,8,0
2025-05-05,40,DPD3-14,13,13,0
2025-05-05,40,DPD30-59,8,8,0
2025-05-05,40,DPD60-89,0,0,0
2025-05-05,40,DPD90+,0,0,0
2025-05-05,42,Current,0,0,0
2025-05-05,42,DPD15-29,7,7,0
2025-05-05,42,DPD3-14,6,6,0
2025-05-05,42,DPD30-59,5,5,0
2025-05-05,42,DPD60-89,0,0,0
2025-05-05,42,DPD90+,0,0,0
2025-05-05,44,Current,39,39,0
2025-05-05,44,DPD15-29,18,18,0
2025-05-05,44,DPD3-14,18,18,0
2025-05-05,44,DPD30-59,7,7,0
2025-05-05,44,DPD60-89,0,0,0
2025-05-05,44,DPD90+,0,0,0
2025-05-05,46,Current,0,0,0
2025-05-05,46,DPD15-29,1,1,0
2025-05-05,46,DPD3-14,1,1,0
2025-05-05,48,Current,28,28,0
2025-05-05,48,DPD15-29,31,30,1
2025-05-05,48,DPD3-14,19,19,0
2025-05-05,48,DPD30-59,9,9,0
2025-05-05,48,DPD60-89,0,0,0
2025-05-05,48,DPD90+,0,0,0
2025-05-05,54,Current,32,32,0
2025-05-05,56,Current,1,1,0
2025-05-05,6,Current,0,0,0
2025-05-04,100,Current,0,0,0
2025-05-04,100,DPD60-89,0,0,0
2025-05-04,102,Current,0,0,0
2025-05-04,104,Current,0,0,0
2025-05-04,20,Current,0,0,0
2025-05-04,20,DPD15-29,127,127,0
2025-05-04,20,DPD3-14,140,140,0
2025-05-04,20,DPD30-59,81,81,0
2025-05-04,20,DPD60-89,0,0,0
2025-05-04,20,DPD90+,0,0,0
2025-05-04,22,Current,0,0,0
2025-05-04,24,Current,44,44,0
2025-05-04,24,DPD15-29,92,92,0
2025-05-04,24,DPD3-14,86,86,0
2025-05-04,24,DPD30-59,43,43,0
2025-05-04,24,DPD60-89,0,0,0
2025-05-04,24,DPD90+,0,0,0
2025-05-04,26,Current,0,0,0
2025-05-04,26,DPD15-29,11,11,0
2025-05-04,26,DPD3-14,4,4,0
2025-05-04,26,DPD30-59,3,3,0
2025-05-04,26,DPD60-89,0,0,0
2025-05-04,26,DPD90+,0,0,0
2025-05-04,32,Current,0,0,0
2025-05-04,32,DPD15-29,62,62,0
2025-05-04,32,DPD3-14,78,78,0
2025-05-04,32,DPD30-59,38,38,0
2025-05-04,32,DPD60-89,0,0,0
2025-05-04,32,DPD90+,0,0,0
2025-05-04,34,Current,0,0,0
2025-05-04,34,DPD15-29,30,30,0
2025-05-04,34,DPD3-14,22,22,0
2025-05-04,34,DPD30-59,14,14,0
2025-05-04,34,DPD60-89,0,0,0
2025-05-04,34,DPD90+,0,0,0
2025-05-04,36,Current,0,0,0
2025-05-04,36,DPD15-29,14,14,0
2025-05-04,36,DPD3-14,17,17,0
2025-05-04,36,DPD30-59,12,12,0
2025-05-04,36,DPD60-89,0,0,0
2025-05-04,36,DPD90+,0,0,0
2025-05-04,38,Current,2,2,0
2025-05-04,38,DPD15-29,15,15,0
2025-05-04,38,DPD3-14,17,17,0
2025-05-04,38,DPD30-59,14,14,0
2025-05-04,38,DPD60-89,0,0,0
2025-05-04,38,DPD90+,0,0,0
2025-05-04,40,Current,0,0,0
2025-05-04,40,DPD15-29,14,14,0
2025-05-04,40,DPD3-14,12,12,0
2025-05-04,40,DPD30-59,10,10,0
2025-05-04,40,DPD60-89,0,0,0
2025-05-04,40,DPD90+,0,0,0
2025-05-04,42,Current,0,0,0
2025-05-04,42,DPD15-29,4,4,0
2025-05-04,42,DPD3-14,6,6,0
2025-05-04,42,DPD30-59,1,1,0
2025-05-04,42,DPD60-89,0,0,0
2025-05-04,42,DPD90+,0,0,0
2025-05-04,44,Current,24,24,0
2025-05-04,44,DPD15-29,19,19,0
2025-05-04,44,DPD3-14,18,18,0
2025-05-04,44,DPD30-59,11,11,0
2025-05-04,44,DPD60-89,0,0,0
2025-05-04,44,DPD90+,0,0,0
2025-05-04,46,Current,0,0,0
2025-05-04,46,DPD15-29,0,0,0
2025-05-04,46,DPD3-14,0,0,0
2025-05-04,48,Current,20,20,0
2025-05-04,48,DPD15-29,28,28,0
2025-05-04,48,DPD3-14,21,21,0
2025-05-04,48,DPD30-59,13,13,0
2025-05-04,48,DPD60-89,0,0,0
2025-05-04,48,DPD90+,0,0,0
2025-05-04,54,Current,9,9,0
2025-05-04,56,Current,0,0,0
2025-05-04,6,Current,0,0,0
2025-05-03,100,Current,0,0,0
2025-05-03,100,DPD60-89,0,0,0
2025-05-03,102,Current,0,0,0
2025-05-03,104,Current,0,0,0
2025-05-03,20,Current,0,0,0
2025-05-03,20,DPD15-29,157,157,0
2025-05-03,20,DPD3-14,61,60,1
2025-05-03,20,DPD30-59,84,84,0
2025-05-03,20,DPD60-89,0,0,0
2025-05-03,20,DPD90+,0,0,0
2025-05-03,22,Current,0,0,0
2025-05-03,24,Current,42,42,0
2025-05-03,24,DPD15-29,67,67,0
2025-05-03,24,DPD3-14,47,47,0
2025-05-03,24,DPD30-59,52,52,0
2025-05-03,24,DPD60-89,0,0,0
2025-05-03,24,DPD90+,0,0,0
2025-05-03,26,Current,0,0,0
2025-05-03,26,DPD15-29,10,10,0
2025-05-03,26,DPD3-14,5,5,0
2025-05-03,26,DPD30-59,5,5,0
2025-05-03,26,DPD60-89,0,0,0
2025-05-03,26,DPD90+,0,0,0
2025-05-03,32,Current,0,0,0
2025-05-03,32,DPD15-29,63,63,0
2025-05-03,32,DPD3-14,41,41,0
2025-05-03,32,DPD30-59,47,47,0
2025-05-03,32,DPD60-89,0,0,0
2025-05-03,32,DPD90+,0,0,0
2025-05-03,34,Current,0,0,0
2025-05-03,34,DPD15-29,24,24,0
2025-05-03,34,DPD3-14,10,10,0
2025-05-03,34,DPD30-59,21,21,0
2025-05-03,34,DPD60-89,0,0,0
2025-05-03,34,DPD90+,0,0,0
2025-05-03,36,Current,0,0,0
2025-05-03,36,DPD15-29,14,14,0
2025-05-03,36,DPD3-14,9,9,0
2025-05-03,36,DPD30-59,11,11,0
2025-05-03,36,DPD60-89,0,0,0
2025-05-03,36,DPD90+,0,0,0
2025-05-03,38,Current,2,2,0
2025-05-03,38,DPD15-29,11,11,0
2025-05-03,38,DPD3-14,10,10,0
2025-05-03,38,DPD30-59,12,12,0
2025-05-03,38,DPD60-89,0,0,0
2025-05-03,38,DPD90+,0,0,0
2025-05-03,40,Current,0,0,0
2025-05-03,40,DPD15-29,9,9,0
2025-05-03,40,DPD3-14,8,8,0
2025-05-03,40,DPD30-59,5,5,0
2025-05-03,40,DPD60-89,0,0,0
2025-05-03,40,DPD90+,0,0,0
2025-05-03,42,Current,0,0,0
2025-05-03,42,DPD15-29,6,6,0
2025-05-03,42,DPD3-14,3,3,0
2025-05-03,42,DPD30-59,6,6,0
2025-05-03,42,DPD60-89,0,0,0
2025-05-03,42,DPD90+,0,0,0
2025-05-03,44,Current,37,37,0
2025-05-03,44,DPD15-29,12,12,0
2025-05-03,44,DPD3-14,9,9,0
2025-05-03,44,DPD30-59,7,7,0
2025-05-03,44,DPD60-89,0,0,0
2025-05-03,44,DPD90+,0,0,0
2025-05-03,46,Current,0,0,0
2025-05-03,46,DPD15-29,2,2,0
2025-05-03,48,Current,17,17,0
2025-05-03,48,DPD15-29,32,31,1
2025-05-03,48,DPD3-14,15,15,0
2025-05-03,48,DPD30-59,9,9,0
2025-05-03,48,DPD60-89,0,0,0
2025-05-03,48,DPD90+,0,0,0
2025-05-03,54,Current,6,6,0
2025-05-03,56,Current,0,0,0
2025-05-03,6,Current,0,0,0
2025-05-02,100,Current,0,0,0
2025-05-02,100,DPD60-89,0,0,0
2025-05-02,102,Current,0,0,0
2025-05-02,104,Current,0,0,0
2025-05-02,20,Current,0,0,0
2025-05-02,20,DPD15-29,143,143,0
2025-05-02,20,DPD3-14,192,191,1
2025-05-02,20,DPD30-59,78,78,0
2025-05-02,20,DPD60-89,0,0,0
2025-05-02,20,DPD90+,0,0,0
2025-05-02,22,Current,0,0,0
2025-05-02,24,Current,67,67,0
2025-05-02,24,DPD15-29,88,88,0
2025-05-02,24,DPD3-14,119,119,0
2025-05-02,24,DPD30-59,48,48,0
2025-05-02,24,DPD60-89,0,0,0
2025-05-02,24,DPD90+,0,0,0
2025-05-02,26,Current,0,0,0
2025-05-02,26,DPD15-29,12,12,0
2025-05-02,26,DPD3-14,10,10,0
2025-05-02,26,DPD30-59,4,4,0
2025-05-02,26,DPD60-89,0,0,0
2025-05-02,26,DPD90+,0,0,0
2025-05-02,32,Current,0,0,0
2025-05-02,32,DPD15-29,65,65,0
2025-05-02,32,DPD3-14,96,96,0
2025-05-02,32,DPD30-59,39,39,0
2025-05-02,32,DPD60-89,0,0,0
2025-05-02,32,DPD90+,0,0,0
2025-05-02,34,Current,0,0,0
2025-05-02,34,DPD15-29,28,28,0
2025-05-02,34,DPD3-14,25,25,0
2025-05-02,34,DPD30-59,15,15,0
2025-05-02,34,DPD60-89,0,0,0
2025-05-02,34,DPD90+,0,0,0
2025-05-02,36,Current,0,0,0
2025-05-02,36,DPD15-29,13,13,0
2025-05-02,36,DPD3-14,24,24,0
2025-05-02,36,DPD30-59,13,13,0
2025-05-02,36,DPD60-89,0,0,0
2025-05-02,36,DPD90+,0,0,0
2025-05-02,38,Current,4,4,0
2025-05-02,38,DPD15-29,15,15,0
2025-05-02,38,DPD3-14,21,21,0
2025-05-02,38,DPD30-59,15,15,0
2025-05-02,38,DPD60-89,0,0,0
2025-05-02,38,DPD90+,0,0,0
2025-05-02,40,Current,0,0,0
2025-05-02,40,DPD15-29,16,16,0
2025-05-02,40,DPD3-14,19,19,0
2025-05-02,40,DPD30-59,9,9,0
2025-05-02,40,DPD60-89,0,0,0
2025-05-02,40,DPD90+,0,0,0
2025-05-02,42,Current,1,1,0
2025-05-02,42,DPD15-29,5,5,0
2025-05-02,42,DPD3-14,9,9,0
2025-05-02,42,DPD30-59,2,2,0
2025-05-02,42,DPD60-89,0,0,0
2025-05-02,42,DPD90+,0,0,0
2025-05-02,44,Current,46,46,0
2025-05-02,44,DPD15-29,16,16,0
2025-05-02,44,DPD3-14,26,26,0
2025-05-02,44,DPD30-59,12,12,0
2025-05-02,44,DPD60-89,0,0,0
2025-05-02,44,DPD90+,0,0,0
2025-05-02,46,Current,0,0,0
2025-05-02,46,DPD15-29,0,0,0
2025-05-02,48,Current,43,43,0
2025-05-02,48,DPD15-29,25,25,0
2025-05-02,48,DPD3-14,25,25,0
2025-05-02,48,DPD30-59,13,13,0
2025-05-02,48,DPD60-89,0,0,0
2025-05-02,48,DPD90+,0,0,0
2025-05-02,54,Current,16,16,0
2025-05-02,56,Current,0,0,0
2025-05-02,6,Current,0,0,0
2025-05-01,100,Current,0,0,0
2025-05-01,100,DPD60-89,0,0,0
2025-05-01,102,Current,0,0,0
2025-05-01,104,Current,0,0,0
2025-05-01,20,Current,1,1,0
2025-05-01,20,DPD15-29,159,159,0
2025-05-01,20,DPD3-14,139,139,0
2025-05-01,20,DPD30-59,75,75,0
2025-05-01,20,DPD60-89,0,0,0
2025-05-01,20,DPD90+,0,0,0
2025-05-01,22,Current,0,0,0
2025-05-01,24,Current,48,48,0
2025-05-01,24,DPD15-29,78,78,0
2025-05-01,24,DPD3-14,74,74,0
2025-05-01,24,DPD30-59,52,52,0
2025-05-01,24,DPD60-89,0,0,0
2025-05-01,24,DPD90+,0,0,0
2025-05-01,26,Current,0,0,0
2025-05-01,26,DPD15-29,11,11,0
2025-05-01,26,DPD3-14,7,7,0
2025-05-01,26,DPD30-59,6,6,0
2025-05-01,26,DPD60-89,0,0,0
2025-05-01,26,DPD90+,0,0,0
2025-05-01,32,Current,0,0,0
2025-05-01,32,DPD15-29,73,73,0
2025-05-01,32,DPD3-14,80,80,0
2025-05-01,32,DPD30-59,43,43,0
2025-05-01,32,DPD60-89,0,0,0
2025-05-01,32,DPD90+,0,0,0
2025-05-01,34,Current,0,0,0
2025-05-01,34,DPD15-29,18,18,0
2025-05-01,34,DPD3-14,25,25,0
2025-05-01,34,DPD30-59,15,15,0
2025-05-01,34,DPD60-89,0,0,0
2025-05-01,34,DPD90+,0,0,0
2025-05-01,36,Current,0,0,0
2025-05-01,36,DPD15-29,13,13,0
2025-05-01,36,DPD3-14,22,22,0
2025-05-01,36,DPD30-59,10,10,0
2025-05-01,36,DPD60-89,0,0,0
2025-05-01,36,DPD90+,0,0,0
2025-05-01,38,Current,10,10,0
2025-05-01,38,DPD15-29,18,18,0
2025-05-01,38,DPD3-14,19,19,0
2025-05-01,38,DPD30-59,10,10,0
2025-05-01,38,DPD60-89,0,0,0
2025-05-01,38,DPD90+,0,0,0
2025-05-01,40,Current,0,0,0
2025-05-01,40,DPD15-29,10,10,0
2025-05-01,40,DPD3-14,19,19,0
2025-05-01,40,DPD30-59,5,5,0
2025-05-01,40,DPD60-89,0,0,0
2025-05-01,40,DPD90+,0,0,0
2025-05-01,42,Current,0,0,0
2025-05-01,42,DPD15-29,7,7,0
2025-05-01,42,DPD3-14,5,5,0
2025-05-01,42,DPD30-59,4,4,0
2025-05-01,42,DPD60-89,0,0,0
2025-05-01,42,DPD90+,0,0,0
2025-05-01,44,Current,0,0,0
2025-05-01,44,DPD15-29,19,19,0
2025-05-01,44,DPD3-14,17,17,0
2025-05-01,44,DPD30-59,8,8,0
2025-05-01,44,DPD60-89,0,0,0
2025-05-01,44,DPD90+,0,0,0
2025-05-01,46,Current,0,0,0
2025-05-01,46,DPD15-29,2,2,0
2025-05-01,48,Current,67,67,0
2025-05-01,48,DPD15-29,26,25,1
2025-05-01,48,DPD3-14,31,30,1
2025-05-01,48,DPD30-59,10,10,0
2025-05-01,48,DPD60-89,0,0,0
2025-05-01,48,DPD90+,0,0,0
2025-05-01,54,Current,12,12,0
2025-05-01,56,Current,8,8,0
2025-05-01,6,Current,0,0,0
2025-04-30,100,Current,0,0,0
2025-04-30,100,DPD60-89,0,0,0
2025-04-30,102,Current,0,0,0
2025-04-30,104,Current,0,0,0
2025-04-30,20,Current,0,0,0
2025-04-30,20,DPD15-29,107,107,0
2025-04-30,20,DPD3-14,78,77,1
2025-04-30,20,DPD30-59,67,67,0
2025-04-30,20,DPD60-89,0,0,0
2025-04-30,20,DPD90+,0,0,0
2025-04-30,22,Current,0,0,0
2025-04-30,24,Current,41,41,0
2025-04-30,24,DPD15-29,60,60,0
2025-04-30,24,DPD3-14,41,41,0
2025-04-30,24,DPD30-59,42,42,0
2025-04-30,24,DPD60-89,0,0,0
2025-04-30,24,DPD90+,0,0,0
2025-04-30,26,Current,0,0,0
2025-04-30,26,DPD15-29,10,10,0
2025-04-30,26,DPD3-14,8,8,0
2025-04-30,26,DPD30-59,4,4,0
2025-04-30,26,DPD60-89,0,0,0
2025-04-30,26,DPD90+,0,0,0
2025-04-30,32,Current,0,0,0
2025-04-30,32,DPD15-29,44,44,0
2025-04-30,32,DPD3-14,44,44,0
2025-04-30,32,DPD30-59,31,31,0
2025-04-30,32,DPD60-89,0,0,0
2025-04-30,32,DPD90+,0,0,0
2025-04-30,34,Current,0,0,0
2025-04-30,34,DPD15-29,21,21,0
2025-04-30,34,DPD3-14,19,19,0
2025-04-30,34,DPD30-59,12,12,0
2025-04-30,34,DPD60-89,0,0,0
2025-04-30,34,DPD90+,0,0,0
2025-04-30,36,Current,0,0,0
2025-04-30,36,DPD15-29,6,6,0
2025-04-30,36,DPD3-14,9,9,0
2025-04-30,36,DPD30-59,13,13,0
2025-04-30,36,DPD60-89,0,0,0
2025-04-30,36,DPD90+,0,0,0
2025-04-30,38,Current,15,15,0
2025-04-30,38,DPD15-29,15,15,0
2025-04-30,38,DPD3-14,19,19,0
2025-04-30,38,DPD30-59,14,14,0
2025-04-30,38,DPD60-89,0,0,0
2025-04-30,38,DPD90+,0,0,0
2025-04-30,40,Current,0,0,0
2025-04-30,40,DPD15-29,9,9,0
2025-04-30,40,DPD3-14,7,7,0
2025-04-30,40,DPD30-59,8,8,0
2025-04-30,40,DPD60-89,0,0,0
2025-04-30,40,DPD90+,0,0,0
2025-04-30,42,Current,0,0,0
2025-04-30,42,DPD15-29,4,4,0
2025-04-30,42,DPD3-14,5,5,0
2025-04-30,42,DPD30-59,3,3,0
2025-04-30,42,DPD60-89,0,0,0
2025-04-30,42,DPD90+,0,0,0
2025-04-30,44,Current,0,0,0
2025-04-30,44,DPD15-29,11,11,0
2025-04-30,44,DPD3-14,13,13,0
2025-04-30,44,DPD30-59,11,11,0
2025-04-30,44,DPD60-89,0,0,0
2025-04-30,44,DPD90+,0,0,0
2025-04-30,46,Current,0,0,0
2025-04-30,46,DPD15-29,0,0,0
2025-04-30,48,Current,68,68,0
2025-04-30,48,DPD15-29,15,15,0
2025-04-30,48,DPD3-14,16,16,0
2025-04-30,48,DPD30-59,13,13,0
2025-04-30,48,DPD60-89,0,0,0
2025-04-30,48,DPD90+,0,0,0
2025-04-30,54,Current,11,11,0
2025-04-30,56,Current,7,7,0
2025-04-30,6,Current,0,0,0
2025-04-29,100,Current,0,0,0
2025-04-29,100,DPD3-14,0,0,0
2025-04-29,100,DPD60-89,0,0,0
2025-04-29,102,Current,0,0,0
2025-04-29,102,DPD3-14,0,0,0
2025-04-29,104,Current,0,0,0
2025-04-29,20,Current,0,0,0
2025-04-29,20,DPD15-29,118,118,0
2025-04-29,20,DPD3-14,104,104,0
2025-04-29,20,DPD30-59,89,89,0
2025-04-29,20,DPD60-89,0,0,0
2025-04-29,20,DPD90+,0,0,0
2025-04-29,22,Current,0,0,0
2025-04-29,24,Current,56,56,0
2025-04-29,24,DPD15-29,65,65,0
2025-04-29,24,DPD3-14,62,62,0
2025-04-29,24,DPD30-59,62,62,0
2025-04-29,24,DPD60-89,0,0,0
2025-04-29,24,DPD90+,0,0,0
2025-04-29,26,Current,0,0,0
2025-04-29,26,DPD15-29,8,8,0
2025-04-29,26,DPD3-14,5,5,0
2025-04-29,26,DPD30-59,7,7,0
2025-04-29,26,DPD60-89,0,0,0
2025-04-29,26,DPD90+,0,0,0
2025-04-29,32,Current,0,0,0
2025-04-29,32,DPD15-29,57,57,0
2025-04-29,32,DPD3-14,60,59,1
2025-04-29,32,DPD30-59,48,48,0
2025-04-29,32,DPD60-89,0,0,0
2025-04-29,32,DPD90+,0,0,0
2025-04-29,34,Current,0,0,0
2025-04-29,34,DPD15-29,12,12,0
2025-04-29,34,DPD3-14,21,21,0
2025-04-29,34,DPD30-59,19,19,0
2025-04-29,34,DPD60-89,0,0,0
2025-04-29,34,DPD90+,0,0,0
2025-04-29,36,Current,0,0,0
2025-04-29,36,DPD15-29,7,7,0
2025-04-29,36,DPD3-14,10,10,0
2025-04-29,36,DPD30-59,13,13,0
2025-04-29,36,DPD60-89,0,0,0
2025-04-29,36,DPD90+,0,0,0
2025-04-29,38,Current,9,9,0
2025-04-29,38,DPD15-29,13,13,0
2025-04-29,38,DPD3-14,17,17,0
2025-04-29,38,DPD30-59,8,8,0
2025-04-29,38,DPD60-89,0,0,0
2025-04-29,38,DPD90+,0,0,0
2025-04-29,40,Current,0,0,0
2025-04-29,40,DPD15-29,9,9,0
2025-04-29,40,DPD3-14,14,14,0
2025-04-29,40,DPD30-59,8,8,0
2025-04-29,40,DPD60-89,0,0,0
2025-04-29,40,DPD90+,0,0,0
2025-04-29,42,Current,0,0,0
2025-04-29,42,DPD15-29,3,3,0
2025-04-29,42,DPD3-14,3,3,0
2025-04-29,42,DPD30-59,7,7,0
2025-04-29,42,DPD60-89,0,0,0
2025-04-29,42,DPD90+,0,0,0
2025-04-29,44,Current,0,0,0
2025-04-29,44,DPD15-29,11,11,0
2025-04-29,44,DPD3-14,12,12,0
2025-04-29,44,DPD30-59,7,7,0
2025-04-29,44,DPD60-89,0,0,0
2025-04-29,44,DPD90+,0,0,0
2025-04-29,46,Current,0,0,0
2025-04-29,46,DPD15-29,2,2,0
2025-04-29,48,Current,50,50,0
2025-04-29,48,DPD15-29,26,25,1
2025-04-29,48,DPD3-14,22,22,0
2025-04-29,48,DPD30-59,11,11,0
2025-04-29,48,DPD60-89,0,0,0
2025-04-29,48,DPD90+,0,0,0
2025-04-29,54,Current,0,0,0
2025-04-29,56,Current,3,3,0
2025-04-29,6,Current,0,0,0
2025-04-28,100,Current,0,0,0
2025-04-28,100,DPD60-89,0,0,0
2025-04-28,102,Current,0,0,0
2025-04-28,102,DPD3-14,0,0,0
2025-04-28,104,Current,0,0,0
2025-04-28,20,Current,8,4,4
2025-04-28,20,DPD15-29,93,93,0
2025-04-28,20,DPD3-14,108,107,1
2025-04-28,20,DPD30-59,91,91,0
2025-04-28,20,DPD60-89,0,0,0
2025-04-28,20,DPD90+,0,0,0
2025-04-28,22,Current,0,0,0
2025-04-28,24,Current,99,86,13
2025-04-28,24,DPD15-29,52,52,0
2025-04-28,24,DPD3-14,61,61,0
2025-04-28,24,DPD30-59,46,46,0
2025-04-28,24,DPD60-89,0,0,0
2025-04-28,24,DPD90+,0,0,0
2025-04-28,26,Current,1,0,1
2025-04-28,26,DPD15-29,10,10,0
2025-04-28,26,DPD3-14,8,8,0
2025-04-28,26,DPD30-59,2,2,0
2025-04-28,26,DPD60-89,0,0,0
2025-04-28,26,DPD90+,0,0,0
2025-04-28,32,Current,10,4,6
2025-04-28,32,DPD15-29,38,38,0
2025-04-28,32,DPD3-14,49,49,0
2025-04-28,32,DPD30-59,41,41,0
2025-04-28,32,DPD60-89,0,0,0
2025-04-28,32,DPD90+,0,0,0
2025-04-28,34,Current,1,1,0
2025-04-28,34,DPD15-29,15,15,0
2025-04-28,34,DPD3-14,19,19,0
2025-04-28,34,DPD30-59,19,19,0
2025-04-28,34,DPD60-89,0,0,0
2025-04-28,34,DPD90+,0,0,0
2025-04-28,36,Current,0,0,0
2025-04-28,36,DPD15-29,9,9,0
2025-04-28,36,DPD3-14,12,12,0
2025-04-28,36,DPD30-59,14,14,0
2025-04-28,36,DPD60-89,0,0,0
2025-04-28,36,DPD90+,0,0,0
2025-04-28,38,Current,20,18,2
2025-04-28,38,DPD15-29,13,13,0
2025-04-28,38,DPD3-14,19,19,0
2025-04-28,38,DPD30-59,14,14,0
2025-04-28,38,DPD60-89,0,0,0
2025-04-28,38,DPD90+,0,0,0
2025-04-28,40,Current,1,0,1
2025-04-28,40,DPD15-29,6,6,0
2025-04-28,40,DPD3-14,9,9,0
2025-04-28,40,DPD30-59,9,9,0
2025-04-28,40,DPD60-89,0,0,0
2025-04-28,40,DPD90+,0,0,0
2025-04-28,42,Current,0,0,0
2025-04-28,42,DPD15-29,4,4,0
2025-04-28,42,DPD3-14,2,2,0
2025-04-28,42,DPD30-59,4,4,0
2025-04-28,42,DPD60-89,0,0,0
2025-04-28,42,DPD90+,0,0,0
2025-04-28,44,Current,5,1,4
2025-04-28,44,DPD15-29,8,8,0
2025-04-28,44,DPD3-14,9,9,0
2025-04-28,44,DPD30-59,7,7,0
2025-04-28,44,DPD60-89,0,0,0
2025-04-28,44,DPD90+,0,0,0
2025-04-28,46,Current,0,0,0
2025-04-28,46,DPD15-29,0,0,0
2025-04-28,48,Current,85,81,4
2025-04-28,48,DPD15-29,12,12,0
2025-04-28,48,DPD3-14,21,21,0
2025-04-28,48,DPD30-59,12,12,0
2025-04-28,48,DPD60-89,0,0,0
2025-04-28,48,DPD90+,0,0,0
2025-04-28,54,Current,10,10,0
2025-04-28,56,Current,9,9,0
2025-04-28,6,Current,0,0,0
2025-04-27,100,Current,0,0,0
2025-04-27,100,DPD60-89,0,0,0
2025-04-27,102,Current,0,0,0
2025-04-27,104,Current,0,0,0
2025-04-27,20,Current,0,0,0
2025-04-27,20,DPD15-29,158,158,0
2025-04-27,20,DPD3-14,115,115,0
2025-04-27,20,DPD30-59,87,87,0
2025-04-27,20,DPD60-89,0,0,0
2025-04-27,20,DPD90+,0,0,0
2025-04-27,22,Current,0,0,0
2025-04-27,24,Current,67,67,0
2025-04-27,24,DPD15-29,72,72,0
2025-04-27,24,DPD3-14,78,78,0
2025-04-27,24,DPD30-59,64,64,0
2025-04-27,24,DPD60-89,0,0,0
2025-04-27,24,DPD90+,0,0,0
2025-04-27,26,Current,0,0,0
2025-04-27,26,DPD15-29,10,10,0
2025-04-27,26,DPD3-14,5,5,0
2025-04-27,26,DPD30-59,7,7,0
2025-04-27,26,DPD60-89,0,0,0
2025-04-27,26,DPD90+,0,0,0
2025-04-27,32,Current,0,0,0
2025-04-27,32,DPD15-29,69,69,0
2025-04-27,32,DPD3-14,69,69,0
2025-04-27,32,DPD30-59,52,52,0
2025-04-27,32,DPD60-89,0,0,0
2025-04-27,32,DPD90+,0,0,0
2025-04-27,34,Current,0,0,0
2025-04-27,34,DPD15-29,17,17,0
2025-04-27,34,DPD3-14,20,20,0
2025-04-27,34,DPD30-59,17,17,0
2025-04-27,34,DPD60-89,0,0,0
2025-04-27,34,DPD90+,0,0,0
2025-04-27,36,Current,0,0,0
2025-04-27,36,DPD15-29,7,7,0
2025-04-27,36,DPD3-14,16,16,0
2025-04-27,36,DPD30-59,11,11,0
2025-04-27,36,DPD60-89,0,0,0
2025-04-27,36,DPD90+,0,0,0
2025-04-27,38,Current,13,13,0
2025-04-27,38,DPD15-29,19,19,0
2025-04-27,38,DPD3-14,17,17,0
2025-04-27,38,DPD30-59,11,11,0
2025-04-27,38,DPD60-89,0,0,0
2025-04-27,38,DPD90+,0,0,0
2025-04-27,40,Current,0,0,0
2025-04-27,40,DPD15-29,11,11,0
2025-04-27,40,DPD3-14,9,9,0
2025-04-27,40,DPD30-59,7,7,0
2025-04-27,40,DPD60-89,0,0,0
2025-04-27,40,DPD90+,0,0,0
2025-04-27,42,Current,0,0,0
2025-04-27,42,DPD15-29,3,3,0
2025-04-27,42,DPD3-14,2,2,0
2025-04-27,42,DPD30-59,4,4,0
2025-04-27,42,DPD60-89,0,0,0
2025-04-27,42,DPD90+,0,0,0
2025-04-27,44,Current,0,0,0
2025-04-27,44,DPD15-29,12,12,0
2025-04-27,44,DPD3-14,15,15,0
2025-04-27,44,DPD30-59,8,8,0
2025-04-27,44,DPD60-89,0,0,0
2025-04-27,44,DPD90+,0,0,0
2025-04-27,46,Current,0,0,0
2025-04-27,46,DPD15-29,2,2,0
2025-04-27,48,Current,26,26,0
2025-04-27,48,DPD15-29,34,33,1
2025-04-27,48,DPD3-14,22,22,0
2025-04-27,48,DPD30-59,18,18,0
2025-04-27,48,DPD60-89,0,0,0
2025-04-27,48,DPD90+,0,0,0
2025-04-27,54,Current,1,1,0
2025-04-27,56,Current,6,6,0
2025-04-27,6,Current,0,0,0
2025-04-26,100,Current,0,0,0
2025-04-26,100,DPD60-89,0,0,0
2025-04-26,102,Current,0,0,0
2025-04-26,104,Current,0,0,0
2025-04-26,20,Current,0,0,0
2025-04-26,20,DPD15-29,85,85,0
2025-04-26,20,DPD3-14,194,193,1
2025-04-26,20,DPD30-59,89,89,0
2025-04-26,20,DPD60-89,0,0,0
2025-04-26,20,DPD90+,0,0,0
2025-04-26,22,Current,0,0,0
2025-04-26,24,Current,53,53,0
2025-04-26,24,DPD15-29,57,57,0
2025-04-26,24,DPD3-14,110,110,0
2025-04-26,24,DPD30-59,47,47,0
2025-04-26,24,DPD60-89,0,0,0
2025-04-26,24,DPD90+,0,0,0
2025-04-26,26,Current,0,0,0
2025-04-26,26,DPD15-29,9,9,0
2025-04-26,26,DPD3-14,13,13,0
2025-04-26,26,DPD30-59,2,2,0
2025-04-26,26,DPD60-89,0,0,0
2025-04-26,26,DPD90+,0,0,0
2025-04-26,32,Current,0,0,0
2025-04-26,32,DPD15-29,45,45,0
2025-04-26,32,DPD3-14,77,77,0
2025-04-26,32,DPD30-59,42,42,0
2025-04-26,32,DPD60-89,0,0,0
2025-04-26,32,DPD90+,0,0,0
2025-04-26,34,Current,0,0,0
2025-04-26,34,DPD15-29,16,16,0
2025-04-26,34,DPD3-14,30,30,0
2025-04-26,34,DPD30-59,18,18,0
2025-04-26,34,DPD60-89,0,0,0
2025-04-26,34,DPD90+,0,0,0
2025-04-26,36,Current,0,0,0
2025-04-26,36,DPD15-29,10,10,0
2025-04-26,36,DPD3-14,22,22,0
2025-04-26,36,DPD30-59,16,16,0
2025-04-26,36,DPD60-89,0,0,0
2025-04-26,36,DPD90+,0,0,0
2025-04-26,38,Current,6,6,0
2025-04-26,38,DPD15-29,14,14,0
2025-04-26,38,DPD3-14,32,31,1
2025-04-26,38,DPD30-59,12,12,0
2025-04-26,38,DPD60-89,0,0,0
2025-04-26,38,DPD90+,0,0,0
2025-04-26,40,Current,0,0,0
2025-04-26,40,DPD15-29,7,7,0
2025-04-26,40,DPD3-14,17,17,0
2025-04-26,40,DPD30-59,6,6,0
2025-04-26,40,DPD60-89,0,0,0
2025-04-26,40,DPD90+,0,0,0
2025-04-26,42,Current,0,0,0
2025-04-26,42,DPD15-29,4,4,0
2025-04-26,42,DPD3-14,8,8,0
2025-04-26,42,DPD30-59,3,3,0
2025-04-26,42,DPD60-89,0,0,0
2025-04-26,42,DPD90+,0,0,0
2025-04-26,44,Current,0,0,0
2025-04-26,44,DPD15-29,9,9,0
2025-04-26,44,DPD3-14,26,26,0
2025-04-26,44,DPD30-59,7,7,0
2025-04-26,44,DPD60-89,0,0,0
2025-04-26,44,DPD90+,0,0,0
2025-04-26,46,Current,0,0,0
2025-04-26,46,DPD15-29,0,0,0
2025-04-26,48,Current,30,30,0
2025-04-26,48,DPD15-29,10,10,0
2025-04-26,48,DPD3-14,27,26,1
2025-04-26,48,DPD30-59,13,13,0
2025-04-26,48,DPD60-89,0,0,0
2025-04-26,48,DPD90+,0,0,0
2025-04-26,54,Current,2,2,0
2025-04-26,56,Current,1,1,0
2025-04-26,6,Current,0,0,0
2025-04-25,100,Current,0,0,0
2025-04-25,100,DPD60-89,0,0,0
2025-04-25,102,Current,0,0,0
2025-04-25,104,Current,0,0,0
2025-04-25,20,Current,3,3,0
2025-04-25,20,DPD15-29,182,181,1
2025-04-25,20,DPD3-14,90,90,0
2025-04-25,20,DPD30-59,92,92,0
2025-04-25,20,DPD60-89,0,0,0
2025-04-25,20,DPD90+,0,0,0
2025-04-25,22,Current,0,0,0
2025-04-25,24,Current,77,77,0
2025-04-25,24,DPD15-29,83,83,0
2025-04-25,24,DPD3-14,75,75,0
2025-04-25,24,DPD30-59,67,67,0
2025-04-25,24,DPD60-89,0,0,0
2025-04-25,24,DPD90+,0,0,0
2025-04-25,26,Current,0,0,0
2025-04-25,26,DPD15-29,13,13,0
2025-04-25,26,DPD3-14,7,7,0
2025-04-25,26,DPD30-59,6,6,0
2025-04-25,26,DPD60-89,0,0,0
2025-04-25,26,DPD90+,0,0,0
2025-04-25,32,Current,0,0,0
2025-04-25,32,DPD15-29,85,85,0
2025-04-25,32,DPD3-14,55,55,0
2025-04-25,32,DPD30-59,58,58,0
2025-04-25,32,DPD60-89,0,0,0
2025-04-25,32,DPD90+,0,0,0
2025-04-25,34,Current,0,0,0
2025-04-25,34,DPD15-29,16,16,0
2025-04-25,34,DPD3-14,18,18,0
2025-04-25,34,DPD30-59,18,18,0
2025-04-25,34,DPD60-89,0,0,0
2025-04-25,34,DPD90+,0,0,0
2025-04-25,36,Current,0,0,0
2025-04-25,36,DPD15-29,9,9,0
2025-04-25,36,DPD3-14,7,7,0
2025-04-25,36,DPD30-59,13,13,0
2025-04-25,36,DPD60-89,0,0,0
2025-04-25,36,DPD90+,0,0,0
2025-04-25,38,Current,12,12,0
2025-04-25,38,DPD15-29,23,23,0
2025-04-25,38,DPD3-14,22,22,0
2025-04-25,38,DPD30-59,9,9,0
2025-04-25,38,DPD60-89,0,0,0
2025-04-25,38,DPD90+,0,0,0
2025-04-25,40,Current,2,2,0
2025-04-25,40,DPD15-29,12,12,0
2025-04-25,40,DPD3-14,8,8,0
2025-04-25,40,DPD30-59,7,7,0
2025-04-25,40,DPD60-89,0,0,0
2025-04-25,40,DPD90+,0,0,0
2025-04-25,42,Current,0,0,0
2025-04-25,42,DPD15-29,5,5,0
2025-04-25,42,DPD3-14,1,1,0
2025-04-25,42,DPD30-59,3,3,0
2025-04-25,42,DPD60-89,0,0,0
2025-04-25,42,DPD90+,0,0,0
2025-04-25,44,Current,0,0,0
2025-04-25,44,DPD15-29,18,18,0
2025-04-25,44,DPD3-14,24,24,0
2025-04-25,44,DPD30-59,7,7,0
2025-04-25,44,DPD60-89,0,0,0
2025-04-25,44,DPD90+,0,0,0
2025-04-25,46,Current,0,0,0
2025-04-25,46,DPD15-29,2,2,0
2025-04-25,48,Current,48,48,0
2025-04-25,48,DPD15-29,35,35,0
2025-04-25,48,DPD3-14,15,15,0
2025-04-25,48,DPD30-59,17,17,0
2025-04-25,48,DPD60-89,0,0,0
2025-04-25,48,DPD90+,0,0,0
2025-04-25,54,Current,2,2,0
2025-04-25,56,Current,1,1,0
2025-04-25,6,Current,0,0,0
2025-04-24,100,Current,0,0,0
2025-04-24,100,DPD60-89,0,0,0
2025-04-24,102,Current,0,0,0
2025-04-24,104,Current,0,0,0
2025-04-24,20,Current,0,0,0
2025-04-24,20,DPD15-29,97,96,1
2025-04-24,20,DPD3-14,135,135,0
2025-04-24,20,DPD30-59,97,97,0
2025-04-24,20,DPD60-89,0,0,0
2025-04-24,20,DPD90+,0,0,0
2025-04-24,22,Current,0,0,0
2025-04-24,24,Current,61,61,0
2025-04-24,24,DPD15-29,50,50,0
2025-04-24,24,DPD3-14,93,93,0
2025-04-24,24,DPD30-59,53,53,0
2025-04-24,24,DPD60-89,0,0,0
2025-04-24,24,DPD90+,0,0,0
2025-04-24,26,Current,0,0,0
2025-04-24,26,DPD15-29,7,7,0
2025-04-24,26,DPD3-14,13,13,0
2025-04-24,26,DPD30-59,4,4,0
2025-04-24,26,DPD60-89,0,0,0
2025-04-24,26,DPD90+,0,0,0
2025-04-24,32,Current,1,1,0
2025-04-24,32,DPD15-29,56,56,0
2025-04-24,32,DPD3-14,58,58,0
2025-04-24,32,DPD30-59,40,40,0
2025-04-24,32,DPD60-89,0,0,0
2025-04-24,32,DPD90+,0,0,0
2025-04-24,34,Current,0,0,0
2025-04-24,34,DPD15-29,19,19,0
2025-04-24,34,DPD3-14,19,19,0
2025-04-24,34,DPD30-59,19,19,0
2025-04-24,34,DPD60-89,0,0,0
2025-04-24,34,DPD90+,0,0,0
2025-04-24,36,Current,0,0,0
2025-04-24,36,DPD15-29,9,9,0
2025-04-24,36,DPD3-14,14,14,0
2025-04-24,36,DPD30-59,13,13,0
2025-04-24,36,DPD60-89,0,0,0
2025-04-24,36,DPD90+,0,0,0
2025-04-24,38,Current,6,6,0
2025-04-24,38,DPD15-29,15,15,0
2025-04-24,38,DPD3-14,23,22,1
2025-04-24,38,DPD30-59,13,13,0
2025-04-24,38,DPD60-89,0,0,0
2025-04-24,38,DPD90+,0,0,0
2025-04-24,40,Current,0,0,0
2025-04-24,40,DPD15-29,7,7,0
2025-04-24,40,DPD3-14,16,16,0
2025-04-24,40,DPD30-59,4,4,0
2025-04-24,40,DPD60-89,0,0,0
2025-04-24,40,DPD90+,0,0,0
2025-04-24,42,Current,0,0,0
2025-04-24,42,DPD15-29,4,4,0
2025-04-24,42,DPD3-14,4,4,0
2025-04-24,42,DPD30-59,4,4,0
2025-04-24,42,DPD60-89,0,0,0
2025-04-24,42,DPD90+,0,0,0
2025-04-24,44,Current,0,0,0
2025-04-24,44,DPD15-29,10,10,0
2025-04-24,44,DPD3-14,19,19,0
2025-04-24,44,DPD30-59,6,6,0
2025-04-24,44,DPD60-89,0,0,0
2025-04-24,44,DPD90+,0,0,0
2025-04-24,46,Current,0,0,0
2025-04-24,46,DPD15-29,0,0,0
2025-04-24,48,Current,39,39,0
2025-04-24,48,DPD15-29,15,15,0
2025-04-24,48,DPD3-14,37,36,1
2025-04-24,48,DPD30-59,13,13,0
2025-04-24,48,DPD60-89,0,0,0
2025-04-24,48,DPD90+,0,0,0
2025-04-24,54,Current,8,8,0
2025-04-24,56,Current,1,1,0
2025-04-24,6,Current,0,0,0
2025-04-23,100,Current,0,0,0
2025-04-23,100,DPD60-89,0,0,0
2025-04-23,102,Current,0,0,0
2025-04-23,104,Current,0,0,0
2025-04-23,20,Current,11,1,10
2025-04-23,20,DPD15-29,200,199,1
2025-04-23,20,DPD3-14,104,104,0
2025-04-23,20,DPD30-59,75,75,0
2025-04-23,20,DPD60-89,0,0,0
2025-04-23,20,DPD90+,0,0,0
2025-04-23,22,Current,0,0,0
2025-04-23,24,Current,64,48,16
2025-04-23,24,DPD15-29,82,82,0
2025-04-23,24,DPD3-14,58,58,0
2025-04-23,24,DPD30-59,58,58,0
2025-04-23,24,DPD60-89,0,0,0
2025-04-23,24,DPD90+,0,0,0
2025-04-23,26,Current,2,0,2
2025-04-23,26,DPD15-29,12,12,0
2025-04-23,26,DPD3-14,9,9,0
2025-04-23,26,DPD30-59,3,3,0
2025-04-23,26,DPD60-89,0,0,0
2025-04-23,26,DPD90+,0,0,0
2025-04-23,32,Current,12,5,7
2025-04-23,32,DPD15-29,95,95,0
2025-04-23,32,DPD3-14,33,33,0
2025-04-23,32,DPD30-59,38,38,0
2025-04-23,32,DPD60-89,0,0,0
2025-04-23,32,DPD90+,0,0,0
2025-04-23,34,Current,0,0,0
2025-04-23,34,DPD15-29,20,20,0
2025-04-23,34,DPD3-14,20,20,0
2025-04-23,34,DPD30-59,13,13,0
2025-04-23,34,DPD60-89,0,0,0
2025-04-23,34,DPD90+,0,0,0
2025-04-23,36,Current,0,0,0
2025-04-23,36,DPD15-29,12,12,0
2025-04-23,36,DPD3-14,12,12,0
2025-04-23,36,DPD30-59,12,12,0
2025-04-23,36,DPD60-89,0,0,0
2025-04-23,36,DPD90+,0,0,0
2025-04-23,38,Current,6,2,4
2025-04-23,38,DPD15-29,26,26,0
2025-04-23,38,DPD3-14,13,13,0
2025-04-23,38,DPD30-59,8,8,0
2025-04-23,38,DPD60-89,0,0,0
2025-04-23,38,DPD90+,0,0,0
2025-04-23,40,Current,1,0,1
2025-04-23,40,DPD15-29,12,12,0
2025-04-23,40,DPD3-14,5,5,0
2025-04-23,40,DPD30-59,6,6,0
2025-04-23,40,DPD60-89,0,0,0
2025-04-23,40,DPD90+,0,0,0
2025-04-23,42,Current,0,0,0
2025-04-23,42,DPD15-29,5,5,0
2025-04-23,42,DPD3-14,3,3,0
2025-04-23,42,DPD30-59,1,1,0
2025-04-23,42,DPD60-89,0,0,0
2025-04-23,42,DPD90+,0,0,0
2025-04-23,44,Current,5,1,4
2025-04-23,44,DPD15-29,18,18,0
2025-04-23,44,DPD3-14,13,13,0
2025-04-23,44,DPD30-59,6,6,0
2025-04-23,44,DPD60-89,0,0,0
2025-04-23,44,DPD90+,0,0,0
2025-04-23,46,Current,0,0,0
2025-04-23,46,DPD15-29,2,2,0
2025-04-23,48,Current,74,68,6
2025-04-23,48,DPD15-29,33,33,0
2025-04-23,48,DPD3-14,25,25,0
2025-04-23,48,DPD30-59,14,14,0
2025-04-23,48,DPD60-89,0,0,0
2025-04-23,48,DPD90+,0,0,0
2025-04-23,54,Current,7,7,0
2025-04-23,56,Current,0,0,0
2025-04-23,6,Current,0,0,0
2025-04-22,100,Current,0,0,0
2025-04-22,100,DPD60-89,0,0,0
2025-04-22,102,Current,0,0,0
2025-04-22,104,Current,0,0,0
2025-04-22,20,Current,0,0,0
2025-04-22,20,DPD15-29,94,94,0
2025-04-22,20,DPD3-14,112,112,0
2025-04-22,20,DPD30-59,98,98,0
2025-04-22,20,DPD60-89,0,0,0
2025-04-22,20,DPD90+,0,0,0
2025-04-22,22,Current,0,0,0
2025-04-22,22,DPD15-29,0,0,0
2025-04-22,24,Current,100,100,0
2025-04-22,24,DPD15-29,59,59,0
2025-04-22,24,DPD3-14,82,82,0
2025-04-22,24,DPD30-59,52,52,0
2025-04-22,24,DPD60-89,0,0,0
2025-04-22,24,DPD90+,0,0,0
2025-04-22,26,Current,0,0,0
2025-04-22,26,DPD15-29,6,6,0
2025-04-22,26,DPD3-14,6,6,0
2025-04-22,26,DPD30-59,4,4,0
2025-04-22,26,DPD60-89,0,0,0
2025-04-22,26,DPD90+,0,0,0
2025-04-22,32,Current,0,0,0
2025-04-22,32,DPD15-29,50,50,0
2025-04-22,32,DPD3-14,43,43,0
2025-04-22,32,DPD30-59,45,45,0
2025-04-22,32,DPD60-89,0,0,0
2025-04-22,32,DPD90+,0,0,0
2025-04-22,34,Current,0,0,0
2025-04-22,34,DPD15-29,21,21,0
2025-04-22,34,DPD3-14,21,21,0
2025-04-22,34,DPD30-59,21,21,0
2025-04-22,34,DPD60-89,0,0,0
2025-04-22,34,DPD90+,0,0,0
2025-04-22,36,Current,0,0,0
2025-04-22,36,DPD15-29,13,13,0
2025-04-22,36,DPD3-14,15,15,0
2025-04-22,36,DPD30-59,12,12,0
2025-04-22,36,DPD60-89,0,0,0
2025-04-22,36,DPD90+,0,0,0
2025-04-22,38,Current,6,6,0
2025-04-22,38,DPD15-29,13,13,0
2025-04-22,38,DPD3-14,12,12,0
2025-04-22,38,DPD30-59,13,13,0
2025-04-22,38,DPD60-89,0,0,0
2025-04-22,38,DPD90+,0,0,0
2025-04-22,40,Current,0,0,0
2025-04-22,40,DPD15-29,8,8,0
2025-04-22,40,DPD3-14,12,12,0
2025-04-22,40,DPD30-59,4,4,0
2025-04-22,40,DPD60-89,0,0,0
2025-04-22,40,DPD90+,0,0,0
2025-04-22,42,Current,0,0,0
2025-04-22,42,DPD15-29,4,4,0
2025-04-22,42,DPD3-14,2,2,0
2025-04-22,42,DPD30-59,4,4,0
2025-04-22,42,DPD60-89,0,0,0
2025-04-22,42,DPD90+,0,0,0
2025-04-22,44,Current,0,0,0
2025-04-22,44,DPD15-29,5,5,0
2025-04-22,44,DPD3-14,21,21,0
2025-04-22,44,DPD30-59,9,9,0
2025-04-22,44,DPD60-89,0,0,0
2025-04-22,44,DPD90+,0,0,0
2025-04-22,46,Current,0,0,0
2025-04-22,46,DPD15-29,0,0,0
2025-04-22,48,Current,25,25,0
2025-04-22,48,DPD15-29,14,14,0
2025-04-22,48,DPD3-14,28,27,1
2025-04-22,48,DPD30-59,17,17,0
2025-04-22,48,DPD60-89,0,0,0
2025-04-22,48,DPD90+,0,0,0
2025-04-22,54,Current,9,9,0
2025-04-22,6,Current,0,0,0
2025-04-21,100,Current,0,0,0
2025-04-21,100,DPD60-89,0,0,0
2025-04-21,102,Current,0,0,0
2025-04-21,104,Current,0,0,0
2025-04-21,20,Current,0,0,0
2025-04-21,20,DPD15-29,222,221,1
2025-04-21,20,DPD3-14,198,198,0
2025-04-21,20,DPD30-59,78,78,0
2025-04-21,20,DPD60-89,0,0,0
2025-04-21,20,DPD90+,0,0,0
2025-04-21,22,Current,0,0,0
2025-04-21,24,Current,118,118,0
2025-04-21,24,DPD15-29,96,96,0
2025-04-21,24,DPD3-14,120,120,0
2025-04-21,24,DPD30-59,64,64,0
2025-04-21,24,DPD60-89,0,0,0
2025-04-21,24,DPD90+,0,0,0
2025-04-21,26,Current,0,0,0
2025-04-21,26,DPD15-29,13,13,0
2025-04-21,26,DPD3-14,15,15,0
2025-04-21,26,DPD30-59,4,4,0
2025-04-21,26,DPD60-89,0,0,0
2025-04-21,26,DPD90+,0,0,0
2025-04-21,32,Current,0,0,0
2025-04-21,32,DPD15-29,100,100,0
2025-04-21,32,DPD3-14,71,71,0
2025-04-21,32,DPD30-59,43,43,0
2025-04-21,32,DPD60-89,0,0,0
2025-04-21,32,DPD90+,0,0,0
2025-04-21,34,Current,0,0,0
2025-04-21,34,DPD15-29,27,27,0
2025-04-21,34,DPD3-14,38,38,0
2025-04-21,34,DPD30-59,12,12,0
2025-04-21,34,DPD60-89,0,0,0
2025-04-21,34,DPD90+,0,0,0
2025-04-21,36,Current,0,0,0
2025-04-21,36,DPD15-29,13,13,0
2025-04-21,36,DPD3-14,21,21,0
2025-04-21,36,DPD30-59,11,11,0
2025-04-21,36,DPD60-89,0,0,0
2025-04-21,36,DPD90+,0,0,0
2025-04-21,38,Current,15,15,0
2025-04-21,38,DPD15-29,32,32,0
2025-04-21,38,DPD3-14,25,25,0
2025-04-21,38,DPD30-59,14,14,0
2025-04-21,38,DPD60-89,0,0,0
2025-04-21,38,DPD90+,0,0,0
2025-04-21,40,Current,0,0,0
2025-04-21,40,DPD15-29,14,14,0
2025-04-21,40,DPD3-14,16,16,0
2025-04-21,40,DPD30-59,6,6,0
2025-04-21,40,DPD60-89,0,0,0
2025-04-21,40,DPD90+,0,0,0
2025-04-21,42,Current,0,0,0
2025-04-21,42,DPD15-29,5,5,0
2025-04-21,42,DPD3-14,12,12,0
2025-04-21,42,DPD30-59,1,1,0
2025-04-21,42,DPD60-89,0,0,0
2025-04-21,42,DPD90+,0,0,0
2025-04-21,44,Current,0,0,0
2025-04-21,44,DPD15-29,21,21,0
2025-04-21,44,DPD3-14,27,27,0
2025-04-21,44,DPD30-59,6,6,0
2025-04-21,44,DPD60-89,0,0,0
2025-04-21,44,DPD90+,0,0,0
2025-04-21,46,Current,0,0,0
2025-04-21,46,DPD3-14,0,0,0
2025-04-21,48,Current,50,50,0
2025-04-21,48,DPD15-29,31,31,0
2025-04-21,48,DPD3-14,23,23,0
2025-04-21,48,DPD30-59,15,15,0
2025-04-21,48,DPD60-89,0,0,0
2025-04-21,48,DPD90+,0,0,0
2025-04-21,54,Current,10,10,0
2025-04-21,6,Current,0,0,0
2025-04-20,100,Current,0,0,0
2025-04-20,100,DPD60-89,0,0,0
2025-04-20,102,Current,0,0,0
2025-04-20,104,Current,0,0,0
2025-04-20,20,Current,0,0,0
2025-04-20,20,DPD15-29,104,104,0
2025-04-20,20,DPD3-14,108,108,0
2025-04-20,20,DPD30-59,98,98,0
2025-04-20,20,DPD60-89,0,0,0
2025-04-20,20,DPD90+,0,0,0
2025-04-20,22,Current,0,0,0
2025-04-20,22,DPD15-29,0,0,0
2025-04-20,24,Current,73,73,0
2025-04-20,24,DPD15-29,62,62,0
2025-04-20,24,DPD3-14,90,90,0
2025-04-20,24,DPD30-59,54,54,0
2025-04-20,24,DPD60-89,0,0,0
2025-04-20,24,DPD90+,0,0,0
2025-04-20,26,Current,0,0,0
2025-04-20,26,DPD15-29,5,5,0
2025-04-20,26,DPD3-14,6,6,0
2025-04-20,26,DPD30-59,4,4,0
2025-04-20,26,DPD60-89,0,0,0
2025-04-20,26,DPD90+,0,0,0
2025-04-20,32,Current,1,1,0
2025-04-20,32,DPD15-29,52,52,0
2025-04-20,32,DPD3-14,57,57,0
2025-04-20,32,DPD30-59,50,50,0
2025-04-20,32,DPD60-89,0,0,0
2025-04-20,32,DPD90+,0,0,0
2025-04-20,34,Current,0,0,0
2025-04-20,34,DPD15-29,20,20,0
2025-04-20,34,DPD3-14,21,21,0
2025-04-20,34,DPD30-59,22,22,0
2025-04-20,34,DPD60-89,0,0,0
2025-04-20,34,DPD90+,0,0,0
2025-04-20,36,Current,0,0,0
2025-04-20,36,DPD15-29,12,12,0
2025-04-20,36,DPD3-14,12,12,0
2025-04-20,36,DPD30-59,14,14,0
2025-04-20,36,DPD60-89,0,0,0
2025-04-20,36,DPD90+,0,0,0
2025-04-20,38,Current,3,3,0
2025-04-20,38,DPD15-29,13,13,0
2025-04-20,38,DPD3-14,11,11,0
2025-04-20,38,DPD30-59,15,15,0
2025-04-20,38,DPD60-89,0,0,0
2025-04-20,38,DPD90+,0,0,0
2025-04-20,40,Current,0,0,0
2025-04-20,40,DPD15-29,6,6,0
2025-04-20,40,DPD3-14,14,14,0
2025-04-20,40,DPD30-59,5,5,0
2025-04-20,40,DPD60-89,0,0,0
2025-04-20,40,DPD90+,0,0,0
2025-04-20,42,Current,0,0,0
2025-04-20,42,DPD15-29,4,4,0
2025-04-20,42,DPD3-14,4,4,0
2025-04-20,42,DPD30-59,4,4,0
2025-04-20,42,DPD60-89,0,0,0
2025-04-20,42,DPD90+,0,0,0
2025-04-20,44,Current,0,0,0
2025-04-20,44,DPD15-29,7,7,0
2025-04-20,44,DPD3-14,17,17,0
2025-04-20,44,DPD30-59,10,10,0
2025-04-20,44,DPD60-89,0,0,0
2025-04-20,44,DPD90+,0,0,0
2025-04-20,46,Current,0,0,0
2025-04-20,46,DPD3-14,0,0,0
2025-04-20,48,Current,18,18,0
2025-04-20,48,DPD15-29,10,10,0
2025-04-20,48,DPD3-14,27,27,0
2025-04-20,48,DPD30-59,16,16,0
2025-04-20,48,DPD60-89,0,0,0
2025-04-20,48,DPD90+,0,0,0
2025-04-20,54,Current,1,1,0
2025-04-20,6,Current,0,0,0
2025-04-19,100,Current,0,0,0
2025-04-19,100,DPD60-89,0,0,0
2025-04-19,102,Current,0,0,0
2025-04-19,104,Current,0,0,0
2025-04-19,20,Current,0,0,0
2025-04-19,20,DPD15-29,227,226,1
2025-04-19,20,DPD3-14,183,182,1
2025-04-19,20,DPD30-59,80,80,0
2025-04-19,20,DPD60-89,0,0,0
2025-04-19,20,DPD90+,0,0,0
2025-04-19,22,Current,0,0,0
2025-04-19,24,Current,68,68,0
2025-04-19,24,DPD15-29,99,99,0
2025-04-19,24,DPD3-14,107,107,0
2025-04-19,24,DPD30-59,64,64,0
2025-04-19,24,DPD60-89,0,0,0
2025-04-19,24,DPD90+,0,0,0
2025-04-19,26,Current,0,0,0
2025-04-19,26,DPD15-29,15,15,0
2025-04-19,26,DPD3-14,14,14,0
2025-04-19,26,DPD30-59,4,4,0
2025-04-19,26,DPD60-89,0,0,0
2025-04-19,26,DPD90+,0,0,0
2025-04-19,32,Current,1,1,0
2025-04-19,32,DPD15-29,109,109,0
2025-04-19,32,DPD3-14,82,82,0
2025-04-19,32,DPD30-59,44,44,0
2025-04-19,32,DPD60-89,0,0,0
2025-04-19,32,DPD90+,0,0,0
2025-04-19,34,Current,0,0,0
2025-04-19,34,DPD15-29,28,28,0
2025-04-19,34,DPD3-14,30,30,0
2025-04-19,34,DPD30-59,13,13,0
2025-04-19,34,DPD60-89,0,0,0
2025-04-19,34,DPD90+,0,0,0
2025-04-19,36,Current,0,0,0
2025-04-19,36,DPD15-29,18,18,0
2025-04-19,36,DPD3-14,18,18,0
2025-04-19,36,DPD30-59,11,11,0
2025-04-19,36,DPD60-89,0,0,0
2025-04-19,36,DPD90+,0,0,0
2025-04-19,38,Current,5,5,0
2025-04-19,38,DPD15-29,29,29,0
2025-04-19,38,DPD3-14,34,34,0
2025-04-19,38,DPD30-59,16,16,0
2025-04-19,38,DPD60-89,0,0,0
2025-04-19,38,DPD90+,0,0,0
2025-04-19,40,Current,0,0,0
2025-04-19,40,DPD15-29,14,14,0
2025-04-19,40,DPD3-14,15,15,0
2025-04-19,40,DPD30-59,4,4,0
2025-04-19,40,DPD60-89,0,0,0
2025-04-19,40,DPD90+,0,0,0
2025-04-19,42,Current,0,0,0
2025-04-19,42,DPD15-29,5,5,0
2025-04-19,42,DPD3-14,15,15,0
2025-04-19,42,DPD30-59,1,1,0
2025-04-19,42,DPD60-89,0,0,0
2025-04-19,42,DPD90+,0,0,0
2025-04-19,44,Current,0,0,0
2025-04-19,44,DPD15-29,27,27,0
2025-04-19,44,DPD3-14,33,33,0
2025-04-19,44,DPD30-59,9,9,0
2025-04-19,44,DPD60-89,0,0,0
2025-04-19,44,DPD90+,0,0,0
2025-04-19,46,Current,0,0,0
2025-04-19,46,DPD3-14,0,0,0
2025-04-19,48,Current,16,16,0
2025-04-19,48,DPD15-29,27,27,0
2025-04-19,48,DPD3-14,21,21,0
2025-04-19,48,DPD30-59,14,14,0
2025-04-19,48,DPD60-89,0,0,0
2025-04-19,48,DPD90+,0,0,0
2025-04-19,54,Current,4,4,0
2025-04-19,6,Current,0,0,0
2025-04-18,100,Current,0,0,0
2025-04-18,100,DPD60-89,0,0,0
2025-04-18,102,Current,0,0,0
2025-04-18,104,Current,0,0,0
2025-04-18,20,Current,0,0,0
2025-04-18,20,DPD15-29,112,112,0
2025-04-18,20,DPD3-14,91,91,0
2025-04-18,20,DPD30-59,96,96,0
2025-04-18,20,DPD60-89,0,0,0
2025-04-18,20,DPD90+,0,0,0
2025-04-18,22,Current,0,0,0
2025-04-18,22,DPD15-29,0,0,0
2025-04-18,24,Current,88,88,0
2025-04-18,24,DPD15-29,74,74,0
2025-04-18,24,DPD3-14,51,51,0
2025-04-18,24,DPD30-59,50,50,0
2025-04-18,24,DPD60-89,0,0,0
2025-04-18,24,DPD90+,0,0,0
2025-04-18,26,Current,0,0,0
2025-04-18,26,DPD15-29,7,7,0
2025-04-18,26,DPD3-14,6,6,0
2025-04-18,26,DPD30-59,5,5,0
2025-04-18,26,DPD60-89,0,0,0
2025-04-18,26,DPD90+,0,0,0
2025-04-18,32,Current,0,0,0
2025-04-18,32,DPD15-29,59,59,0
2025-04-18,32,DPD3-14,35,35,0
2025-04-18,32,DPD30-59,52,52,0
2025-04-18,32,DPD60-89,0,0,0
2025-04-18,32,DPD90+,0,0,0
2025-04-18,34,Current,0,0,0
2025-04-18,34,DPD15-29,19,19,0
2025-04-18,34,DPD3-14,18,18,0
2025-04-18,34,DPD30-59,23,23,0
2025-04-18,34,DPD60-89,0,0,0
2025-04-18,34,DPD90+,0,0,0
2025-04-18,36,Current,0,0,0
2025-04-18,36,DPD15-29,16,16,0
2025-04-18,36,DPD3-14,7,7,0
2025-04-18,36,DPD30-59,14,14,0
2025-04-18,36,DPD60-89,0,0,0
2025-04-18,36,DPD90+,0,0,0
2025-04-18,38,Current,8,8,0
2025-04-18,38,DPD15-29,16,16,0
2025-04-18,38,DPD3-14,14,14,0
2025-04-18,38,DPD30-59,14,14,0
2025-04-18,38,DPD60-89,0,0,0
2025-04-18,38,DPD90+,0,0,0
2025-04-18,40,Current,4,4,0
2025-04-18,40,DPD15-29,9,9,0
2025-04-18,40,DPD3-14,6,6,0
2025-04-18,40,DPD30-59,5,5,0
2025-04-18,40,DPD60-89,0,0,0
2025-04-18,40,DPD90+,0,0,0
2025-04-18,42,Current,0,0,0
2025-04-18,42,DPD15-29,8,8,0
2025-04-18,42,DPD3-14,2,2,0
2025-04-18,42,DPD30-59,3,3,0
2025-04-18,42,DPD60-89,0,0,0
2025-04-18,42,DPD90+,0,0,0
2025-04-18,44,Current,0,0,0
2025-04-18,44,DPD15-29,10,10,0
2025-04-18,44,DPD3-14,10,10,0
2025-04-18,44,DPD30-59,9,9,0
2025-04-18,44,DPD60-89,0,0,0
2025-04-18,44,DPD90+,0,0,0
2025-04-18,46,Current,0,0,0
2025-04-18,46,DPD3-14,2,2,0
2025-04-18,48,Current,33,33,0
2025-04-18,48,DPD15-29,16,16,0
2025-04-18,48,DPD3-14,24,24,0
2025-04-18,48,DPD30-59,17,17,0
2025-04-18,48,DPD60-89,0,0,0
2025-04-18,48,DPD90+,0,0,0
2025-04-18,54,Current,3,3,0
2025-04-18,6,Current,0,0,0
2025-04-17,100,Current,0,0,0
2025-04-17,100,DPD3-14,0,0,0
2025-04-17,100,DPD60-89,0,0,0
2025-04-17,102,Current,0,0,0
2025-04-17,104,Current,0,0,0
2025-04-17,20,Current,15,15,0
2025-04-17,20,DPD15-29,234,232,2
2025-04-17,20,DPD3-14,92,92,0
2025-04-17,20,DPD30-59,88,88,0
2025-04-17,20,DPD60-89,2,2,0
2025-04-17,20,DPD90+,9,9,0
2025-04-17,22,Current,0,0,0
2025-04-17,24,Current,103,103,0
2025-04-17,24,DPD15-29,114,114,0
2025-04-17,24,DPD3-14,56,56,0
2025-04-17,24,DPD30-59,70,70,0
2025-04-17,24,DPD60-89,0,0,0
2025-04-17,24,DPD90+,0,0,0
2025-04-17,26,Current,2,2,0
2025-04-17,26,DPD15-29,16,16,0
2025-04-17,26,DPD3-14,7,7,0
2025-04-17,26,DPD30-59,5,5,0
2025-04-17,26,DPD60-89,0,0,0
2025-04-17,26,DPD90+,0,0,0
2025-04-17,32,Current,3,3,0
2025-04-17,32,DPD15-29,134,134,0
2025-04-17,32,DPD3-14,37,37,0
2025-04-17,32,DPD30-59,48,48,0
2025-04-17,32,DPD60-89,0,0,0
2025-04-17,32,DPD90+,1,1,0
2025-04-17,34,Current,2,2,0
2025-04-17,34,DPD15-29,41,41,0
2025-04-17,34,DPD3-14,18,18,0
2025-04-17,34,DPD30-59,14,14,0
2025-04-17,34,DPD60-89,1,1,0
2025-04-17,34,DPD90+,1,1,0
2025-04-17,36,Current,1,1,0
2025-04-17,36,DPD15-29,20,20,0
2025-04-17,36,DPD3-14,13,13,0
2025-04-17,36,DPD30-59,14,14,0
2025-04-17,36,DPD60-89,0,0,0
2025-04-17,36,DPD90+,2,2,0
2025-04-17,38,Current,14,14,0
2025-04-17,38,DPD15-29,32,31,1
2025-04-17,38,DPD3-14,13,13,0
2025-04-17,38,DPD30-59,15,15,0
2025-04-17,38,DPD60-89,0,0,0
2025-04-17,38,DPD90+,1,1,0
2025-04-17,40,Current,1,1,0
2025-04-17,40,DPD15-29,21,21,0
2025-04-17,40,DPD3-14,6,6,0
2025-04-17,40,DPD30-59,3,3,0
2025-04-17,40,DPD60-89,0,0,0
2025-04-17,40,DPD90+,0,0,0
2025-04-17,42,Current,1,1,0
2025-04-17,42,DPD15-29,5,5,0
2025-04-17,42,DPD3-14,3,3,0
2025-04-17,42,DPD30-59,0,0,0
2025-04-17,42,DPD60-89,0,0,0
2025-04-17,42,DPD90+,0,0,0
2025-04-17,44,Current,2,2,0
2025-04-17,44,DPD15-29,32,32,0
2025-04-17,44,DPD3-14,12,12,0
2025-04-17,44,DPD30-59,10,10,0
2025-04-17,44,DPD60-89,0,0,0
2025-04-17,44,DPD90+,2,2,0
2025-04-17,46,Current,0,0,0
2025-04-17,46,DPD3-14,0,0,0
2025-04-17,48,Current,23,23,0
2025-04-17,48,DPD15-29,27,27,0
2025-04-17,48,DPD3-14,26,25,1
2025-04-17,48,DPD30-59,15,15,0
2025-04-17,48,DPD60-89,1,1,0
2025-04-17,48,DPD90+,1,1,0
2025-04-17,54,Current,7,7,0
2025-04-17,6,Current,0,0,0
2025-04-16,100,Current,0,0,0
2025-04-16,100,DPD3-14,0,0,0
2025-04-16,100,DPD60-89,0,0,0
2025-04-16,102,Current,0,0,0
2025-04-16,104,Current,0,0,0
2025-04-16,20,Current,0,0,0
2025-04-16,20,DPD15-29,120,120,0
2025-04-16,20,DPD3-14,106,106,0
2025-04-16,20,DPD30-59,111,111,0
2025-04-16,20,DPD60-89,0,0,0
2025-04-16,20,DPD90+,0,0,0
2025-04-16,22,Current,0,0,0
2025-04-16,22,DPD15-29,0,0,0
2025-04-16,24,Current,89,89,0
2025-04-16,24,DPD15-29,78,78,0
2025-04-16,24,DPD3-14,70,70,0
2025-04-16,24,DPD30-59,53,53,0
2025-04-16,24,DPD60-89,0,0,0
2025-04-16,24,DPD90+,0,0,0
2025-04-16,26,Current,0,0,0
2025-04-16,26,DPD15-29,7,7,0
2025-04-16,26,DPD3-14,8,8,0
2025-04-16,26,DPD30-59,6,6,0
2025-04-16,26,DPD60-89,0,0,0
2025-04-16,26,DPD90+,0,0,0
2025-04-16,32,Current,0,0,0
2025-04-16,32,DPD15-29,66,66,0
2025-04-16,32,DPD3-14,26,26,0
2025-04-16,32,DPD30-59,58,58,0
2025-04-16,32,DPD60-89,0,0,0
2025-04-16,32,DPD90+,0,0,0
2025-04-16,34,Current,0,0,0
2025-04-16,34,DPD15-29,25,25,0
2025-04-16,34,DPD3-14,12,12,0
2025-04-16,34,DPD30-59,24,24,0
2025-04-16,34,DPD60-89,0,0,0
2025-04-16,34,DPD90+,0,0,0
2025-04-16,36,Current,0,0,0
2025-04-16,36,DPD15-29,14,14,0
2025-04-16,36,DPD3-14,9,9,0
2025-04-16,36,DPD30-59,16,16,0
2025-04-16,36,DPD60-89,0,0,0
2025-04-16,36,DPD90+,0,0,0
2025-04-16,38,Current,10,10,0
2025-04-16,38,DPD15-29,17,17,0
2025-04-16,38,DPD3-14,17,17,0
2025-04-16,38,DPD30-59,15,15,0
2025-04-16,38,DPD60-89,0,0,0
2025-04-16,38,DPD90+,0,0,0
2025-04-16,40,Current,0,0,0
2025-04-16,40,DPD15-29,10,10,0
2025-04-16,40,DPD3-14,6,6,0
2025-04-16,40,DPD30-59,8,8,0
2025-04-16,40,DPD60-89,0,0,0
2025-04-16,40,DPD90+,0,0,0
2025-04-16,42,Current,0,0,0
2025-04-16,42,DPD15-29,9,9,0
2025-04-16,42,DPD3-14,4,4,0
2025-04-16,42,DPD30-59,3,3,0
2025-04-16,42,DPD60-89,0,0,0
2025-04-16,42,DPD90+,0,0,0
2025-04-16,44,Current,0,0,0
2025-04-16,44,DPD15-29,14,14,0
2025-04-16,44,DPD3-14,8,8,0
2025-04-16,44,DPD30-59,14,14,0
2025-04-16,44,DPD60-89,0,0,0
2025-04-16,44,DPD90+,0,0,0
2025-04-16,46,Current,0,0,0
2025-04-16,46,DPD3-14,0,0,0
2025-04-16,48,Current,24,24,0
2025-04-16,48,DPD15-29,19,19,0
2025-04-16,48,DPD3-14,33,33,0
2025-04-16,48,DPD30-59,16,16,0
2025-04-16,48,DPD60-89,0,0,0
2025-04-16,48,DPD90+,0,0,0
2025-04-16,54,Current,2,2,0
2025-04-16,6,Current,0,0,0
2025-04-15,100,Current,0,0,0
2025-04-15,100,DPD3-14,0,0,0
2025-04-15,100,DPD60-89,0,0,0
2025-04-15,102,Current,0,0,0
2025-04-15,104,Current,0,0,0
2025-04-15,20,Current,0,0,0
2025-04-15,20,DPD15-29,230,228,2
2025-04-15,20,DPD3-14,63,63,0
2025-04-15,20,DPD30-59,92,92,0
2025-04-15,20,DPD60-89,0,0,0
2025-04-15,20,DPD90+,0,0,0
2025-04-15,22,Current,0,0,0
2025-04-15,24,Current,81,80,1
2025-04-15,24,DPD15-29,102,102,0
2025-04-15,24,DPD3-14,46,46,0
2025-04-15,24,DPD30-59,73,73,0
2025-04-15,24,DPD60-89,0,0,0
2025-04-15,24,DPD90+,0,0,0
2025-04-15,26,Current,0,0,0
2025-04-15,26,DPD15-29,16,16,0
2025-04-15,26,DPD3-14,3,3,0
2025-04-15,26,DPD30-59,4,4,0
2025-04-15,26,DPD60-89,0,0,0
2025-04-15,26,DPD90+,0,0,0
2025-04-15,32,Current,0,0,0
2025-04-15,32,DPD15-29,115,115,0
2025-04-15,32,DPD3-14,22,22,0
2025-04-15,32,DPD30-59,60,60,0
2025-04-15,32,DPD60-89,0,0,0
2025-04-15,32,DPD90+,0,0,0
2025-04-15,34,Current,1,1,0
2025-04-15,34,DPD15-29,40,40,0
2025-04-15,34,DPD3-14,13,13,0
2025-04-15,34,DPD30-59,18,18,0
2025-04-15,34,DPD60-89,0,0,0
2025-04-15,34,DPD90+,0,0,0
2025-04-15,36,Current,0,0,0
2025-04-15,36,DPD15-29,23,23,0
2025-04-15,36,DPD3-14,3,3,0
2025-04-15,36,DPD30-59,14,14,0
2025-04-15,36,DPD60-89,0,0,0
2025-04-15,36,DPD90+,0,0,0
2025-04-15,38,Current,9,9,0
2025-04-15,38,DPD15-29,35,34,1
2025-04-15,38,DPD3-14,7,7,0
2025-04-15,38,DPD30-59,16,16,0
2025-04-15,38,DPD60-89,0,0,0
2025-04-15,38,DPD90+,0,0,0
2025-04-15,40,Current,0,0,0
2025-04-15,40,DPD15-29,16,16,0
2025-04-15,40,DPD3-14,4,4,0
2025-04-15,40,DPD30-59,4,4,0
2025-04-15,40,DPD60-89,0,0,0
2025-04-15,40,DPD90+,0,0,0
2025-04-15,42,Current,0,0,0
2025-04-15,42,DPD15-29,5,5,0
2025-04-15,42,DPD3-14,1,1,0
2025-04-15,42,DPD30-59,3,3,0
2025-04-15,42,DPD60-89,0,0,0
2025-04-15,42,DPD90+,0,0,0
2025-04-15,44,Current,4,4,0
2025-04-15,44,DPD15-29,19,19,0
2025-04-15,44,DPD3-14,7,7,0
2025-04-15,44,DPD30-59,10,10,0
2025-04-15,44,DPD60-89,0,0,0
2025-04-15,44,DPD90+,0,0,0
2025-04-15,46,Current,0,0,0
2025-04-15,46,DPD3-14,0,0,0
2025-04-15,48,Current,18,18,0
2025-04-15,48,DPD15-29,25,25,0
2025-04-15,48,DPD3-14,9,8,1
2025-04-15,48,DPD30-59,15,15,0
2025-04-15,48,DPD60-89,0,0,0
2025-04-15,48,DPD90+,0,0,0
2025-04-15,54,Current,0,0,0
2025-04-15,6,Current,0,0,0
2025-04-14,100,Current,0,0,0
2025-04-14,100,DPD3-14,0,0,0
2025-04-14,100,DPD60-89,0,0,0
2025-04-14,102,Current,0,0,0
2025-04-14,104,Current,0,0,0
2025-04-14,20,Current,0,0,0
2025-04-14,20,DPD15-29,172,172,0
2025-04-14,20,DPD3-14,82,81,1
2025-04-14,20,DPD30-59,114,114,0
2025-04-14,20,DPD60-89,0,0,0
2025-04-14,20,DPD90+,0,0,0
2025-04-14,22,Current,0,0,0
2025-04-14,22,DPD15-29,1,1,0
2025-04-14,24,Current,138,138,0
2025-04-14,24,DPD15-29,112,112,0
2025-04-14,24,DPD3-14,75,75,0
2025-04-14,24,DPD30-59,56,56,0
2025-04-14,24,DPD60-89,0,0,0
2025-04-14,24,DPD90+,0,0,0
2025-04-14,26,Current,0,0,0
2025-04-14,26,DPD15-29,15,15,0
2025-04-14,26,DPD3-14,7,7,0
2025-04-14,26,DPD30-59,4,4,0
2025-04-14,26,DPD60-89,0,0,0
2025-04-14,26,DPD90+,0,0,0
2025-04-14,32,Current,0,0,0
2025-04-14,32,DPD15-29,89,89,0
2025-04-14,32,DPD3-14,32,32,0
2025-04-14,32,DPD30-59,55,55,0
2025-04-14,32,DPD60-89,0,0,0
2025-04-14,32,DPD90+,0,0,0
2025-04-14,34,Current,0,0,0
2025-04-14,34,DPD15-29,34,34,0
2025-04-14,34,DPD3-14,12,12,0
2025-04-14,34,DPD30-59,21,21,0
2025-04-14,34,DPD60-89,0,0,0
2025-04-14,34,DPD90+,0,0,0
2025-04-14,36,Current,0,0,0
2025-04-14,36,DPD15-29,20,20,0
2025-04-14,36,DPD3-14,9,9,0
2025-04-14,36,DPD30-59,15,15,0
2025-04-14,36,DPD60-89,0,0,0
2025-04-14,36,DPD90+,0,0,0
2025-04-14,38,Current,5,5,0
2025-04-14,38,DPD15-29,23,23,0
2025-04-14,38,DPD3-14,18,18,0
2025-04-14,38,DPD30-59,19,19,0
2025-04-14,38,DPD60-89,0,0,0
2025-04-14,38,DPD90+,0,0,0
2025-04-14,40,Current,0,0,0
2025-04-14,40,DPD15-29,13,13,0
2025-04-14,40,DPD3-14,10,10,0
2025-04-14,40,DPD30-59,9,9,0
2025-04-14,40,DPD60-89,0,0,0
2025-04-14,40,DPD90+,0,0,0
2025-04-14,42,Current,0,0,0
2025-04-14,42,DPD15-29,11,11,0
2025-04-14,42,DPD3-14,4,4,0
2025-04-14,42,DPD30-59,5,5,0
2025-04-14,42,DPD60-89,0,0,0
2025-04-14,42,DPD90+,0,0,0
2025-04-14,44,Current,3,3,0
2025-04-14,44,DPD15-29,19,19,0
2025-04-14,44,DPD3-14,16,16,0
2025-04-14,44,DPD30-59,13,13,0
2025-04-14,44,DPD60-89,0,0,0
2025-04-14,44,DPD90+,0,0,0
2025-04-14,46,Current,0,0,0
2025-04-14,46,DPD3-14,0,0,0
2025-04-14,48,Current,18,18,0
2025-04-14,48,DPD15-29,25,25,0
2025-04-14,48,DPD3-14,13,13,0
2025-04-14,48,DPD30-59,15,15,0
2025-04-14,48,DPD60-89,0,0,0
2025-04-14,48,DPD90+,0,0,0
2025-04-14,54,Current,0,0,0
2025-04-14,6,Current,0,0,0
2025-04-13,100,Current,0,0,0
2025-04-13,100,DPD3-14,0,0,0
2025-04-13,100,DPD60-89,0,0,0
2025-04-13,102,Current,0,0,0
2025-04-13,104,Current,0,0,0
2025-04-13,20,Current,1,1,0
2025-04-13,20,DPD15-29,246,244,2
2025-04-13,20,DPD3-14,65,65,0
2025-04-13,20,DPD30-59,84,84,0
2025-04-13,20,DPD60-89,0,0,0
2025-04-13,20,DPD90+,0,0,0
2025-04-13,22,Current,0,0,0
2025-04-13,22,DPD15-29,0,0,0
2025-04-13,24,Current,74,74,0
2025-04-13,24,DPD15-29,128,128,0
2025-04-13,24,DPD3-14,59,59,0
2025-04-13,24,DPD30-59,72,72,0
2025-04-13,24,DPD60-89,0,0,0
2025-04-13,24,DPD90+,0,0,0
2025-04-13,26,Current,0,0,0
2025-04-13,26,DPD15-29,17,17,0
2025-04-13,26,DPD3-14,3,3,0
2025-04-13,26,DPD30-59,4,4,0
2025-04-13,26,DPD60-89,0,0,0
2025-04-13,26,DPD90+,0,0,0
2025-04-13,32,Current,0,0,0
2025-04-13,32,DPD15-29,126,126,0
2025-04-13,32,DPD3-14,32,32,0
2025-04-13,32,DPD30-59,65,65,0
2025-04-13,32,DPD60-89,0,0,0
2025-04-13,32,DPD90+,0,0,0
2025-04-13,34,Current,0,0,0
2025-04-13,34,DPD15-29,44,44,0
2025-04-13,34,DPD3-14,7,7,0
2025-04-13,34,DPD30-59,17,17,0
2025-04-13,34,DPD60-89,0,0,0
2025-04-13,34,DPD90+,0,0,0
2025-04-13,36,Current,0,0,0
2025-04-13,36,DPD15-29,22,22,0
2025-04-13,36,DPD3-14,7,7,0
2025-04-13,36,DPD30-59,15,15,0
2025-04-13,36,DPD60-89,0,0,0
2025-04-13,36,DPD90+,0,0,0
2025-04-13,38,Current,5,5,0
2025-04-13,38,DPD15-29,38,37,1
2025-04-13,38,DPD3-14,9,9,0
2025-04-13,38,DPD30-59,17,17,0
2025-04-13,38,DPD60-89,0,0,0
2025-04-13,38,DPD90+,0,0,0
2025-04-13,40,Current,0,0,0
2025-04-13,40,DPD15-29,18,18,0
2025-04-13,40,DPD3-14,6,6,0
2025-04-13,40,DPD30-59,6,6,0
2025-04-13,40,DPD60-89,0,0,0
2025-04-13,40,DPD90+,0,0,0
2025-04-13,42,Current,0,0,0
2025-04-13,42,DPD15-29,5,5,0
2025-04-13,42,DPD3-14,1,1,0
2025-04-13,42,DPD30-59,3,3,0
2025-04-13,42,DPD60-89,0,0,0
2025-04-13,42,DPD90+,0,0,0
2025-04-13,44,Current,1,1,0
2025-04-13,44,DPD15-29,20,20,0
2025-04-13,44,DPD3-14,7,7,0
2025-04-13,44,DPD30-59,11,11,0
2025-04-13,44,DPD60-89,0,0,0
2025-04-13,44,DPD90+,0,0,0
2025-04-13,46,Current,0,0,0
2025-04-13,46,DPD3-14,2,2,0
2025-04-13,48,Current,13,13,0
2025-04-13,48,DPD15-29,28,28,0
2025-04-13,48,DPD3-14,13,13,0
2025-04-13,48,DPD30-59,19,19,0
2025-04-13,48,DPD60-89,0,0,0
2025-04-13,48,DPD90+,0,0,0
2025-04-13,54,Current,0,0,0
2025-04-13,6,Current,0,0,0
2025-04-12,100,Current,0,0,0
2025-04-12,100,DPD3-14,0,0,0
2025-04-12,100,DPD60-89,0,0,0
2025-04-12,102,Current,0,0,0
2025-04-12,104,Current,0,0,0
2025-04-12,20,Current,0,0,0
2025-04-12,20,DPD15-29,188,188,0
2025-04-12,20,DPD3-14,114,112,2
2025-04-12,20,DPD30-59,117,117,0
2025-04-12,20,DPD60-89,0,0,0
2025-04-12,20,DPD90+,0,0,0
2025-04-12,22,Current,0,0,0
2025-04-12,22,DPD15-29,1,1,0
2025-04-12,24,Current,73,73,0
2025-04-12,24,DPD15-29,121,121,0
2025-04-12,24,DPD3-14,76,76,0
2025-04-12,24,DPD30-59,60,60,0
2025-04-12,24,DPD60-89,0,0,0
2025-04-12,24,DPD90+,0,0,0
2025-04-12,26,Current,0,0,0
2025-04-12,26,DPD15-29,15,15,0
2025-04-12,26,DPD3-14,5,5,0
2025-04-12,26,DPD30-59,4,4,0
2025-04-12,26,DPD60-89,0,0,0
2025-04-12,26,DPD90+,0,0,0
2025-04-12,32,Current,0,0,0
2025-04-12,32,DPD15-29,98,98,0
2025-04-12,32,DPD3-14,71,71,0
2025-04-12,32,DPD30-59,54,54,0
2025-04-12,32,DPD60-89,0,0,0
2025-04-12,32,DPD90+,0,0,0
2025-04-12,34,Current,0,0,0
2025-04-12,34,DPD15-29,38,38,0
2025-04-12,34,DPD3-14,16,16,0
2025-04-12,34,DPD30-59,21,21,0
2025-04-12,34,DPD60-89,0,0,0
2025-04-12,34,DPD90+,0,0,0
2025-04-12,36,Current,0,0,0
2025-04-12,36,DPD15-29,23,23,0
2025-04-12,36,DPD3-14,14,14,0
2025-04-12,36,DPD30-59,16,16,0
2025-04-12,36,DPD60-89,0,0,0
2025-04-12,36,DPD90+,0,0,0
2025-04-12,38,Current,1,1,0
2025-04-12,38,DPD15-29,22,22,0
2025-04-12,38,DPD3-14,23,23,0
2025-04-12,38,DPD30-59,19,19,0
2025-04-12,38,DPD60-89,0,0,0
2025-04-12,38,DPD90+,0,0,0
2025-04-12,40,Current,0,0,0
2025-04-12,40,DPD15-29,15,15,0
2025-04-12,40,DPD3-14,12,12,0
2025-04-12,40,DPD30-59,9,9,0
2025-04-12,40,DPD60-89,0,0,0
2025-04-12,40,DPD90+,0,0,0
2025-04-12,42,Current,0,0,0
2025-04-12,42,DPD15-29,11,11,0
2025-04-12,42,DPD3-14,4,4,0
2025-04-12,42,DPD30-59,5,5,0
2025-04-12,42,DPD60-89,0,0,0
2025-04-12,42,DPD90+,0,0,0
2025-04-12,44,Current,1,1,0
2025-04-12,44,DPD15-29,19,19,0
2025-04-12,44,DPD3-14,28,28,0
2025-04-12,44,DPD30-59,12,12,0
2025-04-12,44,DPD60-89,0,0,0
2025-04-12,44,DPD90+,0,0,0
2025-04-12,46,Current,0,0,0
2025-04-12,46,DPD3-14,1,1,0
2025-04-12,48,Current,12,12,0
2025-04-12,48,DPD15-29,31,31,0
2025-04-12,48,DPD3-14,20,20,0
2025-04-12,48,DPD30-59,16,16,0
2025-04-12,48,DPD60-89,0,0,0
2025-04-12,48,DPD90+,0,0,0
2025-04-12,54,Current,0,0,0
2025-04-12,6,Current,0,0,0
2025-04-11,100,Current,0,0,0
2025-04-11,100,DPD3-14,0,0,0
2025-04-11,100,DPD60-89,0,0,0
2025-04-11,102,Current,0,0,0
2025-04-11,104,Current,0,0,0
2025-04-11,20,Current,0,0,0
2025-04-11,20,DPD15-29,170,168,2
2025-04-11,20,DPD3-14,76,76,0
2025-04-11,20,DPD30-59,88,88,0
2025-04-11,20,DPD60-89,0,0,0
2025-04-11,20,DPD90+,0,0,0
2025-04-11,22,Current,0,0,0
2025-04-11,22,DPD15-29,0,0,0
2025-04-11,24,Current,114,114,0
2025-04-11,24,DPD15-29,105,105,0
2025-04-11,24,DPD3-14,43,43,0
2025-04-11,24,DPD30-59,72,72,0
2025-04-11,24,DPD60-89,0,0,0
2025-04-11,24,DPD90+,0,0,0
2025-04-11,26,Current,0,0,0
2025-04-11,26,DPD15-29,13,13,0
2025-04-11,26,DPD3-14,3,3,0
2025-04-11,26,DPD30-59,3,3,0
2025-04-11,26,DPD60-89,0,0,0
2025-04-11,26,DPD90+,0,0,0
2025-04-11,32,Current,0,0,0
2025-04-11,32,DPD15-29,90,90,0
2025-04-11,32,DPD3-14,26,26,0
2025-04-11,32,DPD30-59,66,66,0
2025-04-11,32,DPD60-89,0,0,0
2025-04-11,32,DPD90+,0,0,0
2025-04-11,34,Current,0,0,0
2025-04-11,34,DPD15-29,33,33,0
2025-04-11,34,DPD3-14,9,9,0
2025-04-11,34,DPD30-59,20,20,0
2025-04-11,34,DPD60-89,0,0,0
2025-04-11,34,DPD90+,0,0,0
2025-04-11,36,Current,1,1,0
2025-04-11,36,DPD15-29,17,17,0
2025-04-11,36,DPD3-14,6,6,0
2025-04-11,36,DPD30-59,15,15,0
2025-04-11,36,DPD60-89,0,0,0
2025-04-11,36,DPD90+,0,0,0
2025-04-11,38,Current,9,9,0
2025-04-11,38,DPD15-29,29,28,1
2025-04-11,38,DPD3-14,11,11,0
2025-04-11,38,DPD30-59,18,18,0
2025-04-11,38,DPD60-89,0,0,0
2025-04-11,38,DPD90+,0,0,0
2025-04-11,40,Current,0,0,0
2025-04-11,40,DPD15-29,15,15,0
2025-04-11,40,DPD3-14,4,4,0
2025-04-11,40,DPD30-59,8,8,0
2025-04-11,40,DPD60-89,0,0,0
2025-04-11,40,DPD90+,0,0,0
2025-04-11,42,Current,0,0,0
2025-04-11,42,DPD15-29,2,2,0
2025-04-11,42,DPD3-14,2,2,0
2025-04-11,42,DPD30-59,3,3,0
2025-04-11,42,DPD60-89,0,0,0
2025-04-11,42,DPD90+,0,0,0
2025-04-11,44,Current,6,6,0
2025-04-11,44,DPD15-29,18,18,0
2025-04-11,44,DPD3-14,5,5,0
2025-04-11,44,DPD30-59,12,12,0
2025-04-11,44,DPD60-89,0,0,0
2025-04-11,44,DPD90+,0,0,0
2025-04-11,46,Current,0,0,0
2025-04-11,46,DPD3-14,2,2,0
2025-04-11,48,Current,23,23,0
2025-04-11,48,DPD15-29,23,23,0
2025-04-11,48,DPD3-14,29,29,0
2025-04-11,48,DPD30-59,18,18,0
2025-04-11,48,DPD60-89,0,0,0
2025-04-11,48,DPD90+,0,0,0
2025-04-11,54,Current,0,0,0
2025-04-11,6,Current,0,0,0
2025-04-10,100,Current,0,0,0
2025-04-10,100,DPD3-14,0,0,0
2025-04-10,100,DPD60-89,0,0,0
2025-04-10,102,Current,0,0,0
2025-04-10,104,Current,0,0,0
2025-04-10,20,Current,1,1,0
2025-04-10,20,DPD15-29,199,199,0
2025-04-10,20,DPD3-14,50,49,1
2025-04-10,20,DPD30-59,124,124,0
2025-04-10,20,DPD60-89,0,0,0
2025-04-10,20,DPD90+,0,0,0
2025-04-10,22,Current,0,0,0
2025-04-10,22,DPD3-14,0,0,0
2025-04-10,24,Current,94,94,0
2025-04-10,24,DPD15-29,111,111,0
2025-04-10,24,DPD3-14,36,36,0
2025-04-10,24,DPD30-59,70,70,0
2025-04-10,24,DPD60-89,0,0,0
2025-04-10,24,DPD90+,0,0,0
2025-04-10,26,Current,0,0,0
2025-04-10,26,DPD15-29,17,17,0
2025-04-10,26,DPD3-14,4,4,0
2025-04-10,26,DPD30-59,5,5,0
2025-04-10,26,DPD60-89,0,0,0
2025-04-10,26,DPD90+,0,0,0
2025-04-10,32,Current,0,0,0
2025-04-10,32,DPD15-29,92,92,0
2025-04-10,32,DPD3-14,23,23,0
2025-04-10,32,DPD30-59,59,59,0
2025-04-10,32,DPD60-89,0,0,0
2025-04-10,32,DPD90+,0,0,0
2025-04-10,34,Current,0,0,0
2025-04-10,34,DPD15-29,38,38,0
2025-04-10,34,DPD3-14,13,13,0
2025-04-10,34,DPD30-59,22,22,0
2025-04-10,34,DPD60-89,0,0,0
2025-04-10,34,DPD90+,0,0,0
2025-04-10,36,Current,0,0,0
2025-04-10,36,DPD15-29,24,24,0
2025-04-10,36,DPD3-14,13,13,0
2025-04-10,36,DPD30-59,16,16,0
2025-04-10,36,DPD60-89,0,0,0
2025-04-10,36,DPD90+,0,0,0
2025-04-10,38,Current,3,3,0
2025-04-10,38,DPD15-29,23,23,0
2025-04-10,38,DPD3-14,11,11,0
2025-04-10,38,DPD30-59,18,18,0
2025-04-10,38,DPD60-89,0,0,0
2025-04-10,38,DPD90+,0,0,0
2025-04-10,40,Current,1,1,0
2025-04-10,40,DPD15-29,15,15,0
2025-04-10,40,DPD3-14,3,3,0
2025-04-10,40,DPD30-59,10,10,0
2025-04-10,40,DPD60-89,0,0,0
2025-04-10,40,DPD90+,0,0,0
2025-04-10,42,Current,0,0,0
2025-04-10,42,DPD15-29,10,10,0
2025-04-10,42,DPD3-14,1,1,0
2025-04-10,42,DPD30-59,4,4,0
2025-04-10,42,DPD60-89,0,0,0
2025-04-10,42,DPD90+,0,0,0
2025-04-10,44,Current,0,0,0
2025-04-10,44,DPD15-29,19,19,0
2025-04-10,44,DPD3-14,7,7,0
2025-04-10,44,DPD30-59,13,13,0
2025-04-10,44,DPD60-89,0,0,0
2025-04-10,44,DPD90+,0,0,0
2025-04-10,46,Current,0,0,0
2025-04-10,46,DPD3-14,0,0,0
2025-04-10,48,Current,13,13,0
2025-04-10,48,DPD15-29,29,29,0
2025-04-10,48,DPD3-14,12,12,0
2025-04-10,48,DPD30-59,22,22,0
2025-04-10,48,DPD60-89,0,0,0
2025-04-10,48,DPD90+,0,0,0
2025-04-10,6,Current,0,0,0
2025-04-09,100,Current,0,0,0
2025-04-09,100,DPD3-14,0,0,0
2025-04-09,100,DPD60-89,0,0,0
2025-04-09,102,Current,0,0,0
2025-04-09,104,Current,0,0,0
2025-04-09,20,Current,4,4,0
2025-04-09,20,DPD15-29,170,169,1
2025-04-09,20,DPD3-14,51,51,0
2025-04-09,20,DPD30-59,82,82,0
2025-04-09,20,DPD60-89,0,0,0
2025-04-09,20,DPD90+,0,0,0
2025-04-09,22,Current,0,0,0
2025-04-09,22,DPD3-14,0,0,0
2025-04-09,24,Current,80,80,0
2025-04-09,24,DPD15-29,103,103,0
2025-04-09,24,DPD3-14,40,40,0
2025-04-09,24,DPD30-59,66,66,0
2025-04-09,24,DPD60-89,0,0,0
2025-04-09,24,DPD90+,0,0,0
2025-04-09,26,Current,0,0,0
2025-04-09,26,DPD15-29,14,14,0
2025-04-09,26,DPD3-14,7,6,1
2025-04-09,26,DPD30-59,2,2,0
2025-04-09,26,DPD60-89,0,0,0
2025-04-09,26,DPD90+,0,0,0
2025-04-09,32,Current,1,1,0
2025-04-09,32,DPD15-29,89,89,0
2025-04-09,32,DPD3-14,15,15,0
2025-04-09,32,DPD30-59,57,57,0
2025-04-09,32,DPD60-89,0,0,0
2025-04-09,32,DPD90+,0,0,0
2025-04-09,34,Current,0,0,0
2025-04-09,34,DPD15-29,30,30,0
2025-04-09,34,DPD3-14,5,5,0
2025-04-09,34,DPD30-59,19,19,0
2025-04-09,34,DPD60-89,0,0,0
2025-04-09,34,DPD90+,0,0,0
2025-04-09,36,Current,0,0,0
2025-04-09,36,DPD15-29,18,18,0
2025-04-09,36,DPD3-14,5,5,0
2025-04-09,36,DPD30-59,16,16,0
2025-04-09,36,DPD60-89,0,0,0
2025-04-09,36,DPD90+,0,0,0
2025-04-09,38,Current,1,1,0
2025-04-09,38,DPD15-29,31,30,1
2025-04-09,38,DPD3-14,10,10,0
2025-04-09,38,DPD30-59,18,18,0
2025-04-09,38,DPD60-89,0,0,0
2025-04-09,38,DPD90+,0,0,0
2025-04-09,40,Current,0,0,0
2025-04-09,40,DPD15-29,17,17,0
2025-04-09,40,DPD3-14,0,0,0
2025-04-09,40,DPD30-59,6,6,0
2025-04-09,40,DPD60-89,0,0,0
2025-04-09,40,DPD90+,0,0,0
2025-04-09,42,Current,0,0,0
2025-04-09,42,DPD15-29,3,3,0
2025-04-09,42,DPD3-14,2,2,0
2025-04-09,42,DPD30-59,2,2,0
2025-04-09,42,DPD60-89,0,0,0
2025-04-09,42,DPD90+,0,0,0
2025-04-09,44,Current,0,0,0
2025-04-09,44,DPD15-29,19,19,0
2025-04-09,44,DPD3-14,4,4,0
2025-04-09,44,DPD30-59,8,8,0
2025-04-09,44,DPD60-89,0,0,0
2025-04-09,44,DPD90+,0,0,0
2025-04-09,46,Current,0,0,0
2025-04-09,46,DPD3-14,0,0,0
2025-04-09,48,Current,9,9,0
2025-04-09,48,DPD15-29,25,25,0
2025-04-09,48,DPD3-14,23,23,0
2025-04-09,48,DPD30-59,17,17,0
2025-04-09,48,DPD60-89,0,0,0
2025-04-09,48,DPD90+,0,0,0
2025-04-09,6,Current,0,0,0
2025-04-08,100,Current,0,0,0
2025-04-08,100,DPD3-14,0,0,0
2025-04-08,100,DPD60-89,0,0,0
2025-04-08,102,Current,0,0,0
2025-04-08,104,Current,0,0,0
2025-04-08,20,Current,0,0,0
2025-04-08,20,DPD15-29,183,183,0
2025-04-08,20,DPD3-14,170,170,0
2025-04-08,20,DPD30-59,93,93,0
2025-04-08,20,DPD60-89,0,0,0
2025-04-08,20,DPD90+,0,0,0
2025-04-08,22,Current,0,0,0
2025-04-08,22,DPD3-14,0,0,0
2025-04-08,24,Current,101,101,0
2025-04-08,24,DPD15-29,108,108,0
2025-04-08,24,DPD3-14,83,83,0
2025-04-08,24,DPD30-59,57,57,0
2025-04-08,24,DPD60-89,0,0,0
2025-04-08,24,DPD90+,0,0,0
2025-04-08,26,Current,0,0,0
2025-04-08,26,DPD15-29,17,17,0
2025-04-08,26,DPD3-14,8,8,0
2025-04-08,26,DPD30-59,3,3,0
2025-04-08,26,DPD60-89,0,0,0
2025-04-08,26,DPD90+,0,0,0
2025-04-08,32,Current,0,0,0
2025-04-08,32,DPD15-29,89,89,0
2025-04-08,32,DPD3-14,69,69,0
2025-04-08,32,DPD30-59,51,51,0
2025-04-08,32,DPD60-89,0,0,0
2025-04-08,32,DPD90+,0,0,0
2025-04-08,34,Current,0,0,0
2025-04-08,34,DPD15-29,35,35,0
2025-04-08,34,DPD3-14,21,21,0
2025-04-08,34,DPD30-59,17,17,0
2025-04-08,34,DPD60-89,0,0,0
2025-04-08,34,DPD90+,0,0,0
2025-04-08,36,Current,0,0,0
2025-04-08,36,DPD15-29,24,24,0
2025-04-08,36,DPD3-14,22,22,0
2025-04-08,36,DPD30-59,14,14,0
2025-04-08,36,DPD60-89,0,0,0
2025-04-08,36,DPD90+,0,0,0
2025-04-08,38,Current,7,7,0
2025-04-08,38,DPD15-29,29,29,0
2025-04-08,38,DPD3-14,25,25,0
2025-04-08,38,DPD30-59,12,12,0
2025-04-08,38,DPD60-89,0,0,0
2025-04-08,38,DPD90+,0,0,0
2025-04-08,40,Current,0,0,0
2025-04-08,40,DPD15-29,11,11,0
2025-04-08,40,DPD3-14,6,6,0
2025-04-08,40,DPD30-59,12,12,0
2025-04-08,40,DPD60-89,0,0,0
2025-04-08,40,DPD90+,0,0,0
2025-04-08,42,Current,0,0,0
2025-04-08,42,DPD15-29,9,9,0
2025-04-08,42,DPD3-14,4,4,0
2025-04-08,42,DPD30-59,2,2,0
2025-04-08,42,DPD60-89,0,0,0
2025-04-08,42,DPD90+,0,0,0
2025-04-08,44,Current,3,3,0
2025-04-08,44,DPD15-29,18,18,0
2025-04-08,44,DPD3-14,10,10,0
2025-04-08,44,DPD30-59,14,14,0
2025-04-08,44,DPD60-89,0,0,0
2025-04-08,44,DPD90+,0,0,0
2025-04-08,46,Current,0,0,0
2025-04-08,46,DPD3-14,0,0,0
2025-04-08,48,Current,19,19,0
2025-04-08,48,DPD15-29,23,23,0
2025-04-08,48,DPD3-14,15,15,0
2025-04-08,48,DPD30-59,15,15,0
2025-04-08,48,DPD60-89,0,0,0
2025-04-08,48,DPD90+,0,0,0
2025-04-08,6,Current,0,0,0
2025-04-07,100,Current,0,0,0
2025-04-07,100,DPD3-14,0,0,0
2025-04-07,100,DPD60-89,0,0,0
2025-04-07,102,Current,0,0,0
2025-04-07,104,Current,0,0,0
2025-04-07,20,Current,0,0,0
2025-04-07,20,DPD15-29,167,166,1
2025-04-07,20,DPD3-14,134,134,0
2025-04-07,20,DPD30-59,71,71,0
2025-04-07,20,DPD60-89,0,0,0
2025-04-07,20,DPD90+,0,0,0
2025-04-07,22,Current,0,0,0
2025-04-07,22,DPD3-14,1,1,0
2025-04-07,24,Current,164,164,0
2025-04-07,24,DPD15-29,108,108,0
2025-04-07,24,DPD3-14,90,90,0
2025-04-07,24,DPD30-59,63,63,0
2025-04-07,24,DPD60-89,0,0,0
2025-04-07,24,DPD90+,0,0,0
2025-04-07,26,Current,0,0,0
2025-04-07,26,DPD15-29,16,16,0
2025-04-07,26,DPD3-14,7,6,1
2025-04-07,26,DPD30-59,1,1,0
2025-04-07,26,DPD60-89,0,0,0
2025-04-07,26,DPD90+,0,0,0
2025-04-07,32,Current,0,0,0
2025-04-07,32,DPD15-29,76,76,0
2025-04-07,32,DPD3-14,78,78,0
2025-04-07,32,DPD30-59,51,51,0
2025-04-07,32,DPD60-89,0,0,0
2025-04-07,32,DPD90+,0,0,0
2025-04-07,34,Current,2,2,0
2025-04-07,34,DPD15-29,31,31,0
2025-04-07,34,DPD3-14,21,21,0
2025-04-07,34,DPD30-59,21,21,0
2025-04-07,34,DPD60-89,0,0,0
2025-04-07,34,DPD90+,0,0,0
2025-04-07,36,Current,0,0,0
2025-04-07,36,DPD15-29,21,21,0
2025-04-07,36,DPD3-14,17,17,0
2025-04-07,36,DPD30-59,16,16,0
2025-04-07,36,DPD60-89,0,0,0
2025-04-07,36,DPD90+,0,0,0
2025-04-07,38,Current,12,12,0
2025-04-07,38,DPD15-29,31,30,1
2025-04-07,38,DPD3-14,21,21,0
2025-04-07,38,DPD30-59,15,15,0
2025-04-07,38,DPD60-89,0,0,0
2025-04-07,38,DPD90+,0,0,0
2025-04-07,40,Current,0,0,0
2025-04-07,40,DPD15-29,16,16,0
2025-04-07,40,DPD3-14,10,10,0
2025-04-07,40,DPD30-59,5,5,0
2025-04-07,40,DPD60-89,0,0,0
2025-04-07,40,DPD90+,0,0,0
2025-04-07,42,Current,0,0,0
2025-04-07,42,DPD15-29,3,3,0
2025-04-07,42,DPD3-14,7,7,0
2025-04-07,42,DPD30-59,2,2,0
2025-04-07,42,DPD60-89,0,0,0
2025-04-07,42,DPD90+,0,0,0
2025-04-07,44,Current,4,4,0
2025-04-07,44,DPD15-29,19,19,0
2025-04-07,44,DPD3-14,26,26,0
2025-04-07,44,DPD30-59,9,9,0
2025-04-07,44,DPD60-89,0,0,0
2025-04-07,44,DPD90+,0,0,0
2025-04-07,46,Current,0,0,0
2025-04-07,46,DPD3-14,1,1,0
2025-04-07,48,Current,31,31,0
2025-04-07,48,DPD15-29,28,28,0
2025-04-07,48,DPD3-14,26,26,0
2025-04-07,48,DPD30-59,13,13,0
2025-04-07,48,DPD60-89,0,0,0
2025-04-07,48,DPD90+,0,0,0
2025-04-07,6,Current,0,0,0
2025-04-06,100,Current,0,0,0
2025-04-06,100,DPD3-14,0,0,0
2025-04-06,100,DPD60-89,0,0,0
2025-04-06,102,Current,0,0,0
2025-04-06,104,Current,0,0,0
2025-04-06,20,Current,0,0,0
2025-04-06,20,DPD15-29,171,171,0
2025-04-06,20,DPD3-14,55,54,1
2025-04-06,20,DPD30-59,88,88,0
2025-04-06,20,DPD60-89,0,0,0
2025-04-06,20,DPD90+,0,0,0
2025-04-06,22,Current,0,0,0
2025-04-06,22,DPD3-14,0,0,0
2025-04-06,24,Current,54,54,0
2025-04-06,24,DPD15-29,100,100,0
2025-04-06,24,DPD3-14,40,40,0
2025-04-06,24,DPD30-59,59,59,0
2025-04-06,24,DPD60-89,0,0,0
2025-04-06,24,DPD90+,0,0,0
2025-04-06,26,Current,0,0,0
2025-04-06,26,DPD15-29,19,19,0
2025-04-06,26,DPD3-14,2,2,0
2025-04-06,26,DPD30-59,2,2,0
2025-04-06,26,DPD60-89,0,0,0
2025-04-06,26,DPD90+,0,0,0
2025-04-06,32,Current,0,0,0
2025-04-06,32,DPD15-29,73,73,0
2025-04-06,32,DPD3-14,17,17,0
2025-04-06,32,DPD30-59,42,42,0
2025-04-06,32,DPD60-89,0,0,0
2025-04-06,32,DPD90+,0,0,0
2025-04-06,34,Current,0,0,0
2025-04-06,34,DPD15-29,28,28,0
2025-04-06,34,DPD3-14,6,6,0
2025-04-06,34,DPD30-59,17,17,0
2025-04-06,34,DPD60-89,0,0,0
2025-04-06,34,DPD90+,0,0,0
2025-04-06,36,Current,0,0,0
2025-04-06,36,DPD15-29,21,21,0
2025-04-06,36,DPD3-14,7,7,0
2025-04-06,36,DPD30-59,14,14,0
2025-04-06,36,DPD60-89,0,0,0
2025-04-06,36,DPD90+,0,0,0
2025-04-06,38,Current,8,8,0
2025-04-06,38,DPD15-29,24,24,0
2025-04-06,38,DPD3-14,7,7,0
2025-04-06,38,DPD30-59,8,8,0
2025-04-06,38,DPD60-89,0,0,0
2025-04-06,38,DPD90+,0,0,0
2025-04-06,40,Current,0,0,0
2025-04-06,40,DPD15-29,14,14,0
2025-04-06,40,DPD3-14,6,6,0
2025-04-06,40,DPD30-59,12,12,0
2025-04-06,40,DPD60-89,0,0,0
2025-04-06,40,DPD90+,0,0,0
2025-04-06,42,Current,0,0,0
2025-04-06,42,DPD15-29,6,6,0
2025-04-06,42,DPD3-14,2,2,0
2025-04-06,42,DPD30-59,3,3,0
2025-04-06,42,DPD60-89,0,0,0
2025-04-06,42,DPD90+,0,0,0
2025-04-06,44,Current,11,11,0
2025-04-06,44,DPD15-29,18,18,0
2025-04-06,44,DPD3-14,3,3,0
2025-04-06,44,DPD30-59,16,16,0
2025-04-06,44,DPD60-89,0,0,0
2025-04-06,44,DPD90+,0,0,0
2025-04-06,46,Current,0,0,0
2025-04-06,46,DPD3-14,0,0,0
2025-04-06,48,Current,17,17,0
2025-04-06,48,DPD15-29,20,19,1
2025-04-06,48,DPD3-14,12,12,0
2025-04-06,48,DPD30-59,13,13,0
2025-04-06,48,DPD60-89,0,0,0
2025-04-06,48,DPD90+,0,0,0
2025-04-06,6,Current,0,0,0
2025-04-05,100,Current,0,0,0
2025-04-05,100,DPD30-59,1,1,0
2025-04-05,102,Current,0,0,0
2025-04-05,104,Current,0,0,0
2025-04-05,20,Current,0,0,0
2025-04-05,20,DPD15-29,153,153,0
2025-04-05,20,DPD3-14,141,141,0
2025-04-05,20,DPD30-59,72,72,0
2025-04-05,20,DPD60-89,0,0,0
2025-04-05,20,DPD90+,0,0,0
2025-04-05,22,Current,0,0,0
2025-04-05,22,DPD3-14,0,0,0
2025-04-05,24,Current,55,54,1
2025-04-05,24,DPD15-29,99,99,0
2025-04-05,24,DPD3-14,82,82,0
2025-04-05,24,DPD30-59,65,65,0
2025-04-05,24,DPD60-89,0,0,0
2025-04-05,24,DPD90+,0,0,0
2025-04-05,26,Current,0,0,0
2025-04-05,26,DPD15-29,16,16,0
2025-04-05,26,DPD3-14,2,2,0
2025-04-05,26,DPD30-59,1,1,0
2025-04-05,26,DPD60-89,0,0,0
2025-04-05,26,DPD90+,0,0,0
2025-04-05,32,Current,0,0,0
2025-04-05,32,DPD15-29,74,74,0
2025-04-05,32,DPD3-14,72,72,0
2025-04-05,32,DPD30-59,45,45,0
2025-04-05,32,DPD60-89,1,1,0
2025-04-05,32,DPD90+,0,0,0
2025-04-05,34,Current,1,1,0
2025-04-05,34,DPD15-29,33,33,0
2025-04-05,34,DPD3-14,16,16,0
2025-04-05,34,DPD30-59,23,23,0
2025-04-05,34,DPD60-89,0,0,0
2025-04-05,34,DPD90+,0,0,0
2025-04-05,36,Current,0,0,0
2025-04-05,36,DPD15-29,22,22,0
2025-04-05,36,DPD3-14,14,14,0
2025-04-05,36,DPD30-59,18,18,0
2025-04-05,36,DPD60-89,0,0,0
2025-04-05,36,DPD90+,0,0,0
2025-04-05,38,Current,12,12,0
2025-04-05,38,DPD15-29,27,26,1
2025-04-05,38,DPD3-14,23,23,0
2025-04-05,38,DPD30-59,15,15,0
2025-04-05,38,DPD60-89,0,0,0
2025-04-05,38,DPD90+,0,0,0
2025-04-05,40,Current,0,0,0
2025-04-05,40,DPD15-29,16,16,0
2025-04-05,40,DPD3-14,14,14,0
2025-04-05,40,DPD30-59,6,6,0
2025-04-05,40,DPD60-89,0,0,0
2025-04-05,40,DPD90+,0,0,0
2025-04-05,42,Current,0,0,0
2025-04-05,42,DPD15-29,2,2,0
2025-04-05,42,DPD3-14,6,6,0
2025-04-05,42,DPD30-59,2,2,0
2025-04-05,42,DPD60-89,0,0,0
2025-04-05,42,DPD90+,0,0,0
2025-04-05,44,Current,9,9,0
2025-04-05,44,DPD15-29,18,18,0
2025-04-05,44,DPD3-14,24,24,0
2025-04-05,44,DPD30-59,8,8,0
2025-04-05,44,DPD60-89,0,0,0
2025-04-05,44,DPD90+,0,0,0
2025-04-05,46,Current,0,0,0
2025-04-05,46,DPD3-14,1,1,0
2025-04-05,48,Current,15,15,0
2025-04-05,48,DPD15-29,27,27,0
2025-04-05,48,DPD3-14,25,25,0
2025-04-05,48,DPD30-59,13,13,0
2025-04-05,48,DPD60-89,0,0,0
2025-04-05,48,DPD90+,0,0,0
2025-04-05,6,Current,0,0,0
2025-04-04,100,Current,0,0,0
2025-04-04,100,DPD30-59,0,0,0
2025-04-04,102,Current,0,0,0
2025-04-04,104,Current,0,0,0
2025-04-04,20,Current,0,0,0
2025-04-04,20,DPD15-29,172,172,0
2025-04-04,20,DPD3-14,25,25,0
2025-04-04,20,DPD30-59,82,82,0
2025-04-04,20,DPD60-89,0,0,0
2025-04-04,20,DPD90+,0,0,0
2025-04-04,22,Current,0,0,0
2025-04-04,22,DPD3-14,0,0,0
2025-04-04,24,Current,106,105,1
2025-04-04,24,DPD15-29,94,94,0
2025-04-04,24,DPD3-14,7,7,0
2025-04-04,24,DPD30-59,60,60,0
2025-04-04,24,DPD60-89,0,0,0
2025-04-04,24,DPD90+,0,0,0
2025-04-04,26,Current,0,0,0
2025-04-04,26,DPD15-29,18,18,0
2025-04-04,26,DPD3-14,1,1,0
2025-04-04,26,DPD30-59,0,0,0
2025-04-04,26,DPD60-89,0,0,0
2025-04-04,26,DPD90+,0,0,0
2025-04-04,32,Current,0,0,0
2025-04-04,32,DPD15-29,58,58,0
2025-04-04,32,DPD3-14,19,19,0
2025-04-04,32,DPD30-59,40,40,0
2025-04-04,32,DPD60-89,0,0,0
2025-04-04,32,DPD90+,0,0,0
2025-04-04,34,Current,0,0,0
2025-04-04,34,DPD15-29,26,26,0
2025-04-04,34,DPD3-14,5,5,0
2025-04-04,34,DPD30-59,17,17,0
2025-04-04,34,DPD60-89,0,0,0
2025-04-04,34,DPD90+,0,0,0
2025-04-04,36,Current,0,0,0
2025-04-04,36,DPD15-29,16,16,0
2025-04-04,36,DPD3-14,1,1,0
2025-04-04,36,DPD30-59,13,13,0
2025-04-04,36,DPD60-89,0,0,0
2025-04-04,36,DPD90+,0,0,0
2025-04-04,38,Current,11,11,0
2025-04-04,38,DPD15-29,25,25,0
2025-04-04,38,DPD3-14,6,6,0
2025-04-04,38,DPD30-59,10,10,0
2025-04-04,38,DPD60-89,0,0,0
2025-04-04,38,DPD90+,0,0,0
2025-04-04,40,Current,0,0,0
2025-04-04,40,DPD15-29,13,13,0
2025-04-04,40,DPD3-14,3,3,0
2025-04-04,40,DPD30-59,12,12,0
2025-04-04,40,DPD60-89,0,0,0
2025-04-04,40,DPD90+,0,0,0
2025-04-04,42,Current,0,0,0
2025-04-04,42,DPD15-29,6,6,0
2025-04-04,42,DPD3-14,6,6,0
2025-04-04,42,DPD30-59,2,2,0
2025-04-04,42,DPD60-89,0,0,0
2025-04-04,42,DPD90+,0,0,0
2025-04-04,44,Current,12,12,0
2025-04-04,44,DPD15-29,17,17,0
2025-04-04,44,DPD3-14,2,2,0
2025-04-04,44,DPD30-59,16,16,0
2025-04-04,44,DPD60-89,0,0,0
2025-04-04,44,DPD90+,0,0,0
2025-04-04,46,Current,0,0,0
2025-04-04,46,DPD3-14,0,0,0
2025-04-04,48,Current,23,23,0
2025-04-04,48,DPD15-29,27,26,1
2025-04-04,48,DPD3-14,6,6,0
2025-04-04,48,DPD30-59,14,14,0
2025-04-04,48,DPD60-89,0,0,0
2025-04-04,48,DPD90+,0,0,0
2025-04-04,6,Current,0,0,0
2025-04-03,100,Current,0,0,0
2025-04-03,100,DPD30-59,1,1,0
2025-04-03,102,Current,0,0,0
2025-04-03,104,Current,0,0,0
2025-04-03,20,Current,1,1,0
2025-04-03,20,DPD15-29,136,136,0
2025-04-03,20,DPD3-14,176,176,0
2025-04-03,20,DPD30-59,68,68,0
2025-04-03,20,DPD60-89,0,0,0
2025-04-03,20,DPD90+,2,2,0
2025-04-03,22,Current,0,0,0
2025-04-03,22,DPD3-14,0,0,0
2025-04-03,24,Current,96,96,0
2025-04-03,24,DPD15-29,95,95,0
2025-04-03,24,DPD3-14,86,86,0
2025-04-03,24,DPD30-59,62,62,0
2025-04-03,24,DPD60-89,0,0,0
2025-04-03,24,DPD90+,1,1,0
2025-04-03,26,Current,0,0,0
2025-04-03,26,DPD15-29,9,9,0
2025-04-03,26,DPD3-14,9,9,0
2025-04-03,26,DPD30-59,2,2,0
2025-04-03,26,DPD60-89,0,0,0
2025-04-03,26,DPD90+,0,0,0
2025-04-03,32,Current,0,0,0
2025-04-03,32,DPD15-29,59,59,0
2025-04-03,32,DPD3-14,85,85,0
2025-04-03,32,DPD30-59,46,46,0
2025-04-03,32,DPD60-89,0,0,0
2025-04-03,32,DPD90+,0,0,0
2025-04-03,34,Current,1,1,0
2025-04-03,34,DPD15-29,27,27,0
2025-04-03,34,DPD3-14,33,33,0
2025-04-03,34,DPD30-59,18,18,0
2025-04-03,34,DPD60-89,0,0,0
2025-04-03,34,DPD90+,0,0,0
2025-04-03,36,Current,0,0,0
2025-04-03,36,DPD15-29,13,13,0
2025-04-03,36,DPD3-14,18,18,0
2025-04-03,36,DPD30-59,17,17,0
2025-04-03,36,DPD60-89,0,0,0
2025-04-03,36,DPD90+,0,0,0
2025-04-03,38,Current,4,4,0
2025-04-03,38,DPD15-29,23,23,0
2025-04-03,38,DPD3-14,25,25,0
2025-04-03,38,DPD30-59,14,14,0
2025-04-03,38,DPD60-89,0,0,0
2025-04-03,38,DPD90+,0,0,0
2025-04-03,40,Current,0,0,0
2025-04-03,40,DPD15-29,13,13,0
2025-04-03,40,DPD3-14,8,8,0
2025-04-03,40,DPD30-59,5,5,0
2025-04-03,40,DPD60-89,0,0,0
2025-04-03,40,DPD90+,0,0,0
2025-04-03,42,Current,0,0,0
2025-04-03,42,DPD15-29,2,2,0
2025-04-03,42,DPD3-14,7,7,0
2025-04-03,42,DPD30-59,2,2,0
2025-04-03,42,DPD60-89,0,0,0
2025-04-03,42,DPD90+,0,0,0
2025-04-03,44,Current,7,7,0
2025-04-03,44,DPD15-29,15,15,0
2025-04-03,44,DPD3-14,15,15,0
2025-04-03,44,DPD30-59,9,9,0
2025-04-03,44,DPD60-89,0,0,0
2025-04-03,44,DPD90+,0,0,0
2025-04-03,46,Current,0,0,0
2025-04-03,48,Current,11,11,0
2025-04-03,48,DPD15-29,26,26,0
2025-04-03,48,DPD3-14,20,20,0
2025-04-03,48,DPD30-59,12,12,0
2025-04-03,48,DPD60-89,0,0,0
2025-04-03,48,DPD90+,0,0,0
2025-04-03,6,Current,0,0,0
2025-04-02,100,Current,0,0,0
2025-04-02,100,DPD30-59,0,0,0
2025-04-02,102,Current,0,0,0
2025-04-02,104,Current,0,0,0
2025-04-02,20,Current,12,12,0
2025-04-02,20,DPD15-29,186,186,0
2025-04-02,20,DPD3-14,81,80,1
2025-04-02,20,DPD30-59,90,90,0
2025-04-02,20,DPD60-89,6,6,0
2025-04-02,20,DPD90+,8,8,0
2025-04-02,22,Current,0,0,0
2025-04-02,22,DPD3-14,1,1,0
2025-04-02,24,Current,92,92,0
2025-04-02,24,DPD15-29,91,91,0
2025-04-02,24,DPD3-14,51,51,0
2025-04-02,24,DPD30-59,52,52,0
2025-04-02,24,DPD60-89,0,0,0
2025-04-02,24,DPD90+,0,0,0
2025-04-02,26,Current,2,2,0
2025-04-02,26,DPD15-29,17,17,0
2025-04-02,26,DPD3-14,6,6,0
2025-04-02,26,DPD30-59,2,2,0
2025-04-02,26,DPD60-89,0,0,0
2025-04-02,26,DPD90+,0,0,0
2025-04-02,32,Current,2,2,0
2025-04-02,32,DPD15-29,58,58,0
2025-04-02,32,DPD3-14,43,43,0
2025-04-02,32,DPD30-59,38,38,0
2025-04-02,32,DPD60-89,1,1,0
2025-04-02,32,DPD90+,3,3,0
2025-04-02,34,Current,2,2,0
2025-04-02,34,DPD15-29,28,28,0
2025-04-02,34,DPD3-14,12,12,0
2025-04-02,34,DPD30-59,13,13,0
2025-04-02,34,DPD60-89,1,1,0
2025-04-02,34,DPD90+,1,1,0
2025-04-02,36,Current,0,0,0
2025-04-02,36,DPD15-29,16,16,0
2025-04-02,36,DPD3-14,8,8,0
2025-04-02,36,DPD30-59,14,14,0
2025-04-02,36,DPD60-89,0,0,0
2025-04-02,36,DPD90+,2,2,0
2025-04-02,38,Current,3,3,0
2025-04-02,38,DPD15-29,22,22,0
2025-04-02,38,DPD3-14,15,15,0
2025-04-02,38,DPD30-59,10,10,0
2025-04-02,38,DPD60-89,1,1,0
2025-04-02,38,DPD90+,1,1,0
2025-04-02,40,Current,1,1,0
2025-04-02,40,DPD15-29,17,17,0
2025-04-02,40,DPD3-14,13,13,0
2025-04-02,40,DPD30-59,11,11,0
2025-04-02,40,DPD60-89,1,1,0
2025-04-02,40,DPD90+,0,0,0
2025-04-02,42,Current,1,1,0
2025-04-02,42,DPD15-29,6,6,0
2025-04-02,42,DPD3-14,5,5,0
2025-04-02,42,DPD30-59,5,5,0
2025-04-02,42,DPD60-89,0,0,0
2025-04-02,42,DPD90+,1,1,0
2025-04-02,44,Current,6,6,0
2025-04-02,44,DPD15-29,18,18,0
2025-04-02,44,DPD3-14,11,11,0
2025-04-02,44,DPD30-59,16,16,0
2025-04-02,44,DPD60-89,1,1,0
2025-04-02,44,DPD90+,1,1,0
2025-04-02,46,Current,0,0,0
2025-04-02,48,Current,13,13,0
2025-04-02,48,DPD15-29,26,25,1
2025-04-02,48,DPD3-14,11,11,0
2025-04-02,48,DPD30-59,13,13,0
2025-04-02,48,DPD60-89,1,1,0
2025-04-02,48,DPD90+,1,1,0
2025-04-02,6,Current,0,0,0
2025-04-01,100,Current,0,0,0
2025-04-01,100,DPD30-59,1,1,0
2025-04-01,102,Current,0,0,0
2025-04-01,104,Current,0,0,0
2025-04-01,20,Current,0,0,0
2025-04-01,20,DPD15-29,127,127,0
2025-04-01,20,DPD3-14,211,210,1
2025-04-01,20,DPD30-59,77,77,0
2025-04-01,20,DPD60-89,0,0,0
2025-04-01,20,DPD90+,0,0,0
2025-04-01,22,Current,0,0,0
2025-04-01,22,DPD3-14,0,0,0
2025-04-01,24,Current,144,144,0
2025-04-01,24,DPD15-29,90,90,0
2025-04-01,24,DPD3-14,122,122,0
2025-04-01,24,DPD30-59,68,68,0
2025-04-01,24,DPD60-89,0,0,0
2025-04-01,24,DPD90+,0,0,0
2025-04-01,26,Current,0,0,0
2025-04-01,26,DPD15-29,10,10,0
2025-04-01,26,DPD3-14,12,12,0
2025-04-01,26,DPD30-59,2,2,0
2025-04-01,26,DPD60-89,0,0,0
2025-04-01,26,DPD90+,0,0,0
2025-04-01,32,Current,0,0,0
2025-04-01,32,DPD15-29,51,51,0
2025-04-01,32,DPD3-14,101,100,1
2025-04-01,32,DPD30-59,58,58,0
2025-04-01,32,DPD60-89,0,0,0
2025-04-01,32,DPD90+,0,0,0
2025-04-01,34,Current,3,3,0
2025-04-01,34,DPD15-29,26,26,0
2025-04-01,34,DPD3-14,37,37,0
2025-04-01,34,DPD30-59,19,19,0
2025-04-01,34,DPD60-89,0,0,0
2025-04-01,34,DPD90+,0,0,0
2025-04-01,36,Current,0,0,0
2025-04-01,36,DPD15-29,13,13,0
2025-04-01,36,DPD3-14,28,28,0
2025-04-01,36,DPD30-59,19,19,0
2025-04-01,36,DPD60-89,0,0,0
2025-04-01,36,DPD90+,0,0,0
2025-04-01,38,Current,11,11,0
2025-04-01,38,DPD15-29,23,23,0
2025-04-01,38,DPD3-14,32,32,0
2025-04-01,38,DPD30-59,16,16,0
2025-04-01,38,DPD60-89,0,0,0
2025-04-01,38,DPD90+,0,0,0
2025-04-01,40,Current,0,0,0
2025-04-01,40,DPD15-29,17,17,0
2025-04-01,40,DPD3-14,12,12,0
2025-04-01,40,DPD30-59,7,7,0
2025-04-01,40,DPD60-89,0,0,0
2025-04-01,40,DPD90+,0,0,0
2025-04-01,42,Current,0,0,0
2025-04-01,42,DPD15-29,3,3,0
2025-04-01,42,DPD3-14,7,7,0
2025-04-01,42,DPD30-59,4,4,0
2025-04-01,42,DPD60-89,0,0,0
2025-04-01,42,DPD90+,0,0,0
2025-04-01,44,Current,0,0,0
2025-04-01,44,DPD15-29,15,15,0
2025-04-01,44,DPD3-14,25,25,0
2025-04-01,44,DPD30-59,9,9,0
2025-04-01,44,DPD60-89,0,0,0
2025-04-01,44,DPD90+,0,0,0
2025-04-01,46,Current,0,0,0
2025-04-01,48,Current,27,27,0
2025-04-01,48,DPD15-29,22,22,0
2025-04-01,48,DPD3-14,30,30,0
2025-04-01,48,DPD30-59,13,13,0
2025-04-01,48,DPD60-89,0,0,0
2025-04-01,48,DPD90+,0,0,0
2025-04-01,6,Current,0,0,0
2025-03-31,100,Current,0,0,0
2025-03-31,100,DPD30-59,0,0,0
2025-03-31,102,Current,0,0,0
2025-03-31,104,Current,0,0,0
2025-03-31,20,Current,1,1,0
2025-03-31,20,DPD15-29,184,184,0
2025-03-31,20,DPD3-14,157,157,0
2025-03-31,20,DPD30-59,67,67,0
2025-03-31,20,DPD60-89,0,0,0
2025-03-31,20,DPD90+,1,1,0
2025-03-31,22,Current,0,0,0
2025-03-31,22,DPD3-14,1,1,0
2025-03-31,24,Current,173,173,0
2025-03-31,24,DPD15-29,89,89,0
2025-03-31,24,DPD3-14,100,100,0
2025-03-31,24,DPD30-59,41,41,0
2025-03-31,24,DPD60-89,0,0,0
2025-03-31,24,DPD90+,0,0,0
2025-03-31,26,Current,0,0,0
2025-03-31,26,DPD15-29,17,17,0
2025-03-31,26,DPD3-14,12,12,0
2025-03-31,26,DPD30-59,0,0,0
2025-03-31,26,DPD60-89,0,0,0
2025-03-31,26,DPD90+,0,0,0
2025-03-31,32,Current,0,0,0
2025-03-31,32,DPD15-29,65,65,0
2025-03-31,32,DPD3-14,88,88,0
2025-03-31,32,DPD30-59,25,25,0
2025-03-31,32,DPD60-89,0,0,0
2025-03-31,32,DPD90+,0,0,0
2025-03-31,34,Current,6,6,0
2025-03-31,34,DPD15-29,24,24,0
2025-03-31,34,DPD3-14,31,31,0
2025-03-31,34,DPD30-59,16,16,0
2025-03-31,34,DPD60-89,1,1,0
2025-03-31,34,DPD90+,0,0,0
2025-03-31,36,Current,1,1,0
2025-03-31,36,DPD15-29,16,16,0
2025-03-31,36,DPD3-14,23,23,0
2025-03-31,36,DPD30-59,9,9,0
2025-03-31,36,DPD60-89,0,0,0
2025-03-31,36,DPD90+,0,0,0
2025-03-31,38,Current,33,33,0
2025-03-31,38,DPD15-29,27,27,0
2025-03-31,38,DPD3-14,29,28,1
2025-03-31,38,DPD30-59,5,5,0
2025-03-31,38,DPD60-89,0,0,0
2025-03-31,38,DPD90+,0,0,0
2025-03-31,40,Current,0,0,0
2025-03-31,40,DPD15-29,19,19,0
2025-03-31,40,DPD3-14,20,20,0
2025-03-31,40,DPD30-59,9,9,0
2025-03-31,40,DPD60-89,0,0,0
2025-03-31,40,DPD90+,2,2,0
2025-03-31,42,Current,0,0,0
2025-03-31,42,DPD15-29,7,7,0
2025-03-31,42,DPD3-14,7,7,0
2025-03-31,42,DPD30-59,3,3,0
2025-03-31,42,DPD60-89,0,0,0
2025-03-31,42,DPD90+,0,0,0
2025-03-31,44,Current,6,6,0
2025-03-31,44,DPD15-29,19,19,0
2025-03-31,44,DPD3-14,19,19,0
2025-03-31,44,DPD30-59,16,16,0
2025-03-31,44,DPD60-89,0,0,0
2025-03-31,44,DPD90+,0,0,0
2025-03-31,46,Current,0,0,0
2025-03-31,48,Current,81,81,0
2025-03-31,48,DPD15-29,28,27,1
2025-03-31,48,DPD3-14,31,30,1
2025-03-31,48,DPD30-59,11,11,0
2025-03-31,48,DPD60-89,0,0,0
2025-03-31,48,DPD90+,0,0,0
2025-03-31,6,Current,0,0,0
2025-03-30,100,Current,0,0,0
2025-03-30,100,DPD30-59,1,1,0
2025-03-30,102,Current,0,0,0
2025-03-30,104,Current,0,0,0
2025-03-30,20,Current,1,1,0
2025-03-30,20,DPD15-29,138,138,0
2025-03-30,20,DPD3-14,97,96,1
2025-03-30,20,DPD30-59,71,71,0
2025-03-30,20,DPD60-89,0,0,0
2025-03-30,20,DPD90+,0,0,0
2025-03-30,22,Current,0,0,0
2025-03-30,22,DPD3-14,0,0,0
2025-03-30,24,Current,41,41,0
2025-03-30,24,DPD15-29,82,82,0
2025-03-30,24,DPD3-14,58,58,0
2025-03-30,24,DPD30-59,59,59,0
2025-03-30,24,DPD60-89,0,0,0
2025-03-30,24,DPD90+,0,0,0
2025-03-30,26,Current,0,0,0
2025-03-30,26,DPD15-29,11,11,0
2025-03-30,26,DPD3-14,10,10,0
2025-03-30,26,DPD30-59,2,2,0
2025-03-30,26,DPD60-89,0,0,0
2025-03-30,26,DPD90+,0,0,0
2025-03-30,32,Current,0,0,0
2025-03-30,32,DPD15-29,54,54,0
2025-03-30,32,DPD3-14,47,47,0
2025-03-30,32,DPD30-59,47,47,0
2025-03-30,32,DPD60-89,0,0,0
2025-03-30,32,DPD90+,0,0,0
2025-03-30,34,Current,0,0,0
2025-03-30,34,DPD15-29,30,30,0
2025-03-30,34,DPD3-14,19,19,0
2025-03-30,34,DPD30-59,15,15,0
2025-03-30,34,DPD60-89,0,0,0
2025-03-30,34,DPD90+,0,0,0
2025-03-30,36,Current,1,1,0
2025-03-30,36,DPD15-29,13,13,0
2025-03-30,36,DPD3-14,9,9,0
2025-03-30,36,DPD30-59,18,18,0
2025-03-30,36,DPD60-89,0,0,0
2025-03-30,36,DPD90+,0,0,0
2025-03-30,38,Current,9,9,0
2025-03-30,38,DPD15-29,28,28,0
2025-03-30,38,DPD3-14,14,14,0
2025-03-30,38,DPD30-59,14,14,0
2025-03-30,38,DPD60-89,0,0,0
2025-03-30,38,DPD90+,0,0,0
2025-03-30,40,Current,0,0,0
2025-03-30,40,DPD15-29,16,16,0
2025-03-30,40,DPD3-14,8,8,0
2025-03-30,40,DPD30-59,8,8,0
2025-03-30,40,DPD60-89,0,0,0
2025-03-30,40,DPD90+,0,0,0
2025-03-30,42,Current,0,0,0
2025-03-30,42,DPD15-29,4,4,0
2025-03-30,42,DPD3-14,6,6,0
2025-03-30,42,DPD30-59,4,4,0
2025-03-30,42,DPD60-89,0,0,0
2025-03-30,42,DPD90+,0,0,0
2025-03-30,44,Current,0,0,0
2025-03-30,44,DPD15-29,15,15,0
2025-03-30,44,DPD3-14,10,10,0
2025-03-30,44,DPD30-59,7,7,0
2025-03-30,44,DPD60-89,0,0,0
2025-03-30,44,DPD90+,0,0,0
2025-03-30,46,Current,0,0,0
2025-03-30,48,Current,35,35,0
2025-03-30,48,DPD15-29,29,29,0
2025-03-30,48,DPD3-14,21,21,0
2025-03-30,48,DPD30-59,12,12,0
2025-03-30,48,DPD60-89,0,0,0
2025-03-30,48,DPD90+,0,0,0
2025-03-30,6,Current,0,0,0
2025-03-29,100,Current,0,0,0
2025-03-29,100,DPD30-59,0,0,0
2025-03-29,102,Current,0,0,0
2025-03-29,102,DPD3-14,0,0,0
2025-03-29,104,Current,0,0,0
2025-03-29,20,Current,0,0,0
2025-03-29,20,DPD15-29,128,128,0
2025-03-29,20,DPD3-14,134,134,0
2025-03-29,20,DPD30-59,75,75,0
2025-03-29,20,DPD60-89,0,0,0
2025-03-29,20,DPD90+,0,0,0
2025-03-29,22,Current,0,0,0
2025-03-29,24,Current,38,38,0
2025-03-29,24,DPD15-29,71,71,0
2025-03-29,24,DPD3-14,86,86,0
2025-03-29,24,DPD30-59,39,39,0
2025-03-29,24,DPD60-89,0,0,0
2025-03-29,24,DPD90+,0,0,0
2025-03-29,26,Current,0,0,0
2025-03-29,26,DPD15-29,9,9,0
2025-03-29,26,DPD3-14,5,5,0
2025-03-29,26,DPD30-59,0,0,0
2025-03-29,26,DPD60-89,0,0,0
2025-03-29,26,DPD90+,0,0,0
2025-03-29,32,Current,0,0,0
2025-03-29,32,DPD15-29,56,56,0
2025-03-29,32,DPD3-14,74,74,0
2025-03-29,32,DPD30-59,25,25,0
2025-03-29,32,DPD60-89,0,0,0
2025-03-29,32,DPD90+,0,0,0
2025-03-29,34,Current,0,0,0
2025-03-29,34,DPD15-29,23,23,0
2025-03-29,34,DPD3-14,30,30,0
2025-03-29,34,DPD30-59,12,12,0
2025-03-29,34,DPD60-89,0,0,0
2025-03-29,34,DPD90+,0,0,0
2025-03-29,36,Current,0,0,0
2025-03-29,36,DPD15-29,12,12,0
2025-03-29,36,DPD3-14,13,13,0
2025-03-29,36,DPD30-59,6,6,0
2025-03-29,36,DPD60-89,0,0,0
2025-03-29,36,DPD90+,0,0,0
2025-03-29,38,Current,5,5,0
2025-03-29,38,DPD15-29,21,21,0
2025-03-29,38,DPD3-14,18,18,0
2025-03-29,38,DPD30-59,5,5,0
2025-03-29,38,DPD60-89,0,0,0
2025-03-29,38,DPD90+,0,0,0
2025-03-29,40,Current,0,0,0
2025-03-29,40,DPD15-29,8,8,0
2025-03-29,40,DPD3-14,12,12,0
2025-03-29,40,DPD30-59,8,8,0
2025-03-29,40,DPD60-89,0,0,0
2025-03-29,40,DPD90+,0,0,0
2025-03-29,42,Current,0,0,0
2025-03-29,42,DPD15-29,6,6,0
2025-03-29,42,DPD3-14,5,5,0
2025-03-29,42,DPD30-59,1,1,0
2025-03-29,42,DPD60-89,0,0,0
2025-03-29,42,DPD90+,0,0,0
2025-03-29,44,Current,0,0,0
2025-03-29,44,DPD15-29,9,9,0
2025-03-29,44,DPD3-14,14,14,0
2025-03-29,44,DPD30-59,13,13,0
2025-03-29,44,DPD60-89,0,0,0
2025-03-29,44,DPD90+,0,0,0
2025-03-29,46,Current,0,0,0
2025-03-29,48,Current,23,23,0
2025-03-29,48,DPD15-29,28,27,1
2025-03-29,48,DPD3-14,32,32,0
2025-03-29,48,DPD30-59,11,11,0
2025-03-29,48,DPD60-89,0,0,0
2025-03-29,48,DPD90+,0,0,0
2025-03-29,6,Current,0,0,0
2025-03-28,100,Current,0,0,0
2025-03-28,100,DPD30-59,1,1,0
2025-03-28,102,Current,0,0,0
2025-03-28,102,DPD3-14,1,1,0
2025-03-28,104,Current,0,0,0
2025-03-28,20,Current,0,0,0
2025-03-28,20,DPD15-29,156,156,0
2025-03-28,20,DPD3-14,123,122,1
2025-03-28,20,DPD30-59,101,101,0
2025-03-28,20,DPD60-89,0,0,0
2025-03-28,20,DPD90+,0,0,0
2025-03-28,22,Current,0,0,0
2025-03-28,24,Current,78,78,0
2025-03-28,24,DPD15-29,78,78,0
2025-03-28,24,DPD3-14,71,71,0
2025-03-28,24,DPD30-59,70,70,0
2025-03-28,24,DPD60-89,0,0,0
2025-03-28,24,DPD90+,0,0,0
2025-03-28,26,Current,0,0,0
2025-03-28,26,DPD15-29,8,8,0
2025-03-28,26,DPD3-14,10,10,0
2025-03-28,26,DPD30-59,4,4,0
2025-03-28,26,DPD60-89,0,0,0
2025-03-28,26,DPD90+,0,0,0
2025-03-28,32,Current,0,0,0
2025-03-28,32,DPD15-29,66,66,0
2025-03-28,32,DPD3-14,46,46,0
2025-03-28,32,DPD30-59,55,55,0
2025-03-28,32,DPD60-89,0,0,0
2025-03-28,32,DPD90+,0,0,0
2025-03-28,34,Current,0,0,0
2025-03-28,34,DPD15-29,28,28,0
2025-03-28,34,DPD3-14,18,18,0
2025-03-28,34,DPD30-59,19,19,0
2025-03-28,34,DPD60-89,0,0,0
2025-03-28,34,DPD90+,0,0,0
2025-03-28,36,Current,0,0,0
2025-03-28,36,DPD15-29,17,17,0
2025-03-28,36,DPD3-14,5,5,0
2025-03-28,36,DPD30-59,22,22,0
2025-03-28,36,DPD60-89,0,0,0
2025-03-28,36,DPD90+,0,0,0
2025-03-28,38,Current,13,13,0
2025-03-28,38,DPD15-29,27,27,0
2025-03-28,38,DPD3-14,21,21,0
2025-03-28,38,DPD30-59,19,19,0
2025-03-28,38,DPD60-89,0,0,0
2025-03-28,38,DPD90+,0,0,0
2025-03-28,40,Current,0,0,0
2025-03-28,40,DPD15-29,16,16,0
2025-03-28,40,DPD3-14,12,12,0
2025-03-28,40,DPD30-59,8,8,0
2025-03-28,40,DPD60-89,0,0,0
2025-03-28,40,DPD90+,0,0,0
2025-03-28,42,Current,0,0,0
2025-03-28,42,DPD15-29,4,4,0
2025-03-28,42,DPD3-14,4,4,0
2025-03-28,42,DPD30-59,4,4,0
2025-03-28,42,DPD60-89,0,0,0
2025-03-28,42,DPD90+,0,0,0
2025-03-28,44,Current,1,1,0
2025-03-28,44,DPD15-29,21,21,0
2025-03-28,44,DPD3-14,16,16,0
2025-03-28,44,DPD30-59,11,11,0
2025-03-28,44,DPD60-89,0,0,0
2025-03-28,44,DPD90+,0,0,0
2025-03-28,46,Current,0,0,0
2025-03-28,46,DPD15-29,0,0,0
2025-03-28,48,Current,48,48,0
2025-03-28,48,DPD15-29,31,31,0
2025-03-28,48,DPD3-14,22,22,0
2025-03-28,48,DPD30-59,14,14,0
2025-03-28,48,DPD60-89,0,0,0
2025-03-28,48,DPD90+,0,0,0
2025-03-28,6,Current,0,0,0
2025-03-27,100,Current,0,0,0
2025-03-27,100,DPD30-59,0,0,0
2025-03-27,102,Current,0,0,0
2025-03-27,102,DPD3-14,0,0,0
2025-03-27,104,Current,0,0,0
2025-03-27,20,Current,1,1,0
2025-03-27,20,DPD15-29,137,137,0
2025-03-27,20,DPD3-14,124,124,0
2025-03-27,20,DPD30-59,60,60,0
2025-03-27,20,DPD60-89,0,0,0
2025-03-27,20,DPD90+,1,1,0
2025-03-27,22,Current,0,0,0
2025-03-27,24,Current,122,122,0
2025-03-27,24,DPD15-29,77,77,0
2025-03-27,24,DPD3-14,95,95,0
2025-03-27,24,DPD30-59,40,40,0
2025-03-27,24,DPD60-89,0,0,0
2025-03-27,24,DPD90+,0,0,0
2025-03-27,26,Current,0,0,0
2025-03-27,26,DPD15-29,12,12,0
2025-03-27,26,DPD3-14,7,7,0
2025-03-27,26,DPD30-59,0,0,0
2025-03-27,26,DPD60-89,0,0,0
2025-03-27,26,DPD90+,0,0,0
2025-03-27,32,Current,0,0,0
2025-03-27,32,DPD15-29,75,75,0
2025-03-27,32,DPD3-14,84,84,0
2025-03-27,32,DPD30-59,22,22,0
2025-03-27,32,DPD60-89,1,1,0
2025-03-27,32,DPD90+,0,0,0
2025-03-27,34,Current,3,3,0
2025-03-27,34,DPD15-29,25,25,0
2025-03-27,34,DPD3-14,29,29,0
2025-03-27,34,DPD30-59,11,11,0
2025-03-27,34,DPD60-89,2,2,0
2025-03-27,34,DPD90+,0,0,0
2025-03-27,36,Current,0,0,0
2025-03-27,36,DPD15-29,8,8,0
2025-03-27,36,DPD3-14,16,16,0
2025-03-27,36,DPD30-59,7,7,0
2025-03-27,36,DPD60-89,1,1,0
2025-03-27,36,DPD90+,0,0,0
2025-03-27,38,Current,31,31,0
2025-03-27,38,DPD15-29,26,26,0
2025-03-27,38,DPD3-14,23,23,0
2025-03-27,38,DPD30-59,7,7,0
2025-03-27,38,DPD60-89,0,0,0
2025-03-27,38,DPD90+,0,0,0
2025-03-27,40,Current,0,0,0
2025-03-27,40,DPD15-29,12,12,0
2025-03-27,40,DPD3-14,12,12,0
2025-03-27,40,DPD30-59,6,6,0
2025-03-27,40,DPD60-89,0,0,0
2025-03-27,40,DPD90+,2,2,0
2025-03-27,42,Current,0,0,0
2025-03-27,42,DPD15-29,3,3,0
2025-03-27,42,DPD3-14,6,6,0
2025-03-27,42,DPD30-59,4,4,0
2025-03-27,42,DPD60-89,0,0,0
2025-03-27,42,DPD90+,1,1,0
2025-03-27,44,Current,6,6,0
2025-03-27,44,DPD15-29,17,17,0
2025-03-27,44,DPD3-14,19,19,0
2025-03-27,44,DPD30-59,7,7,0
2025-03-27,44,DPD60-89,0,0,0
2025-03-27,44,DPD90+,0,0,0
2025-03-27,46,Current,0,0,0
2025-03-27,46,DPD15-29,1,1,0
2025-03-27,48,Current,71,71,0
2025-03-27,48,DPD15-29,28,27,1
2025-03-27,48,DPD3-14,27,27,0
2025-03-27,48,DPD30-59,15,15,0
2025-03-27,48,DPD60-89,0,0,0
2025-03-27,48,DPD90+,0,0,0
2025-03-27,6,Current,0,0,0
2025-03-26,100,Current,0,0,0
2025-03-26,100,DPD30-59,1,1,0
2025-03-26,102,Current,0,0,0
2025-03-26,104,Current,0,0,0
2025-03-26,20,Current,1,1,0
2025-03-26,20,DPD15-29,171,170,1
2025-03-26,20,DPD3-14,216,215,1
2025-03-26,20,DPD30-59,91,91,0
2025-03-26,20,DPD60-89,0,0,0
2025-03-26,20,DPD90+,2,2,0
2025-03-26,22,Current,0,0,0
2025-03-26,22,DPD15-29,0,0,0
2025-03-26,24,Current,60,58,2
2025-03-26,24,DPD15-29,85,85,0
2025-03-26,24,DPD3-14,127,127,0
2025-03-26,24,DPD30-59,72,72,0
2025-03-26,24,DPD60-89,0,0,0
2025-03-26,24,DPD90+,0,0,0
2025-03-26,26,Current,0,0,0
2025-03-26,26,DPD15-29,12,12,0
2025-03-26,26,DPD3-14,24,24,0
2025-03-26,26,DPD30-59,5,5,0
2025-03-26,26,DPD60-89,0,0,0
2025-03-26,26,DPD90+,0,0,0
2025-03-26,32,Current,0,0,0
2025-03-26,32,DPD15-29,76,76,0
2025-03-26,32,DPD3-14,81,81,0
2025-03-26,32,DPD30-59,49,49,0
2025-03-26,32,DPD60-89,0,0,0
2025-03-26,32,DPD90+,0,0,0
2025-03-26,34,Current,0,0,0
2025-03-26,34,DPD15-29,32,32,0
2025-03-26,34,DPD3-14,29,29,0
2025-03-26,34,DPD30-59,18,18,0
2025-03-26,34,DPD60-89,0,0,0
2025-03-26,34,DPD90+,0,0,0
2025-03-26,36,Current,0,0,0
2025-03-26,36,DPD15-29,18,18,0
2025-03-26,36,DPD3-14,26,26,0
2025-03-26,36,DPD30-59,20,20,0
2025-03-26,36,DPD60-89,0,0,0
2025-03-26,36,DPD90+,0,0,0
2025-03-26,38,Current,9,9,0
2025-03-26,38,DPD15-29,27,27,0
2025-03-26,38,DPD3-14,36,35,1
2025-03-26,38,DPD30-59,13,13,0
2025-03-26,38,DPD60-89,0,0,0
2025-03-26,38,DPD90+,0,0,0
2025-03-26,40,Current,1,1,0
2025-03-26,40,DPD15-29,16,16,0
2025-03-26,40,DPD3-14,24,24,0
2025-03-26,40,DPD30-59,11,11,0
2025-03-26,40,DPD60-89,0,0,0
2025-03-26,40,DPD90+,0,0,0
2025-03-26,42,Current,0,0,0
2025-03-26,42,DPD15-29,6,6,0
2025-03-26,42,DPD3-14,10,10,0
2025-03-26,42,DPD30-59,3,3,0
2025-03-26,42,DPD60-89,0,0,0
2025-03-26,42,DPD90+,0,0,0
2025-03-26,44,Current,0,0,0
2025-03-26,44,DPD15-29,23,23,0
2025-03-26,44,DPD3-14,25,25,0
2025-03-26,44,DPD30-59,9,9,0
2025-03-26,44,DPD60-89,0,0,0
2025-03-26,44,DPD90+,0,0,0
2025-03-26,46,Current,0,0,0
2025-03-26,46,DPD15-29,0,0,0
2025-03-26,48,Current,33,33,0
2025-03-26,48,DPD15-29,27,27,0
2025-03-26,48,DPD3-14,34,33,1
2025-03-26,48,DPD30-59,12,12,0
2025-03-26,48,DPD60-89,0,0,0
2025-03-26,48,DPD90+,0,0,0
2025-03-26,6,Current,0,0,0
2025-03-25,100,Current,0,0,0
2025-03-25,100,DPD30-59,0,0,0
2025-03-25,102,Current,0,0,0
2025-03-25,104,Current,0,0,0
2025-03-25,20,Current,0,0,0
2025-03-25,20,DPD15-29,139,139,0
2025-03-25,20,DPD3-14,96,96,0
2025-03-25,20,DPD30-59,67,67,0
2025-03-25,20,DPD60-89,0,0,0
2025-03-25,20,DPD90+,0,0,0
2025-03-25,22,Current,0,0,0
2025-03-25,22,DPD15-29,1,1,0
2025-03-25,22,DPD3-14,0,0,0
2025-03-25,24,Current,82,82,0
2025-03-25,24,DPD15-29,87,87,0
2025-03-25,24,DPD3-14,70,70,0
2025-03-25,24,DPD30-59,37,37,0
2025-03-25,24,DPD60-89,0,0,0
2025-03-25,24,DPD90+,0,0,0
2025-03-25,26,Current,0,0,0
2025-03-25,26,DPD15-29,12,12,0
2025-03-25,26,DPD3-14,9,9,0
2025-03-25,26,DPD30-59,0,0,0
2025-03-25,26,DPD60-89,0,0,0
2025-03-25,26,DPD90+,0,0,0
2025-03-25,32,Current,0,0,0
2025-03-25,32,DPD15-29,86,86,0
2025-03-25,32,DPD3-14,61,61,0
2025-03-25,32,DPD30-59,25,25,0
2025-03-25,32,DPD60-89,0,0,0
2025-03-25,32,DPD90+,0,0,0
2025-03-25,34,Current,0,0,0
2025-03-25,34,DPD15-29,32,32,0
2025-03-25,34,DPD3-14,14,14,0
2025-03-25,34,DPD30-59,15,15,0
2025-03-25,34,DPD60-89,0,0,0
2025-03-25,34,DPD90+,0,0,0
2025-03-25,36,Current,0,0,0
2025-03-25,36,DPD15-29,8,8,0
2025-03-25,36,DPD3-14,14,14,0
2025-03-25,36,DPD30-59,8,8,0
2025-03-25,36,DPD60-89,0,0,0
2025-03-25,36,DPD90+,0,0,0
2025-03-25,38,Current,8,8,0
2025-03-25,38,DPD15-29,27,27,0
2025-03-25,38,DPD3-14,23,23,0
2025-03-25,38,DPD30-59,9,9,0
2025-03-25,38,DPD60-89,0,0,0
2025-03-25,38,DPD90+,0,0,0
2025-03-25,40,Current,0,0,0
2025-03-25,40,DPD15-29,14,14,0
2025-03-25,40,DPD3-14,7,7,0
2025-03-25,40,DPD30-59,9,9,0
2025-03-25,40,DPD60-89,0,0,0
2025-03-25,40,DPD90+,0,0,0
2025-03-25,42,Current,0,0,0
2025-03-25,42,DPD15-29,3,3,0
2025-03-25,42,DPD3-14,1,1,0
2025-03-25,42,DPD30-59,4,4,0
2025-03-25,42,DPD60-89,0,0,0
2025-03-25,42,DPD90+,0,0,0
2025-03-25,44,Current,0,0,0
2025-03-25,44,DPD15-29,16,16,0
2025-03-25,44,DPD3-14,12,12,0
2025-03-25,44,DPD30-59,10,10,0
2025-03-25,44,DPD60-89,0,0,0
2025-03-25,44,DPD90+,0,0,0
2025-03-25,46,Current,0,0,0
2025-03-25,46,DPD15-29,2,2,0
2025-03-25,48,Current,24,24,0
2025-03-25,48,DPD15-29,27,27,0
2025-03-25,48,DPD3-14,17,17,0
2025-03-25,48,DPD30-59,16,16,0
2025-03-25,48,DPD60-89,0,0,0
2025-03-25,48,DPD90+,0,0,0
2025-03-25,6,Current,0,0,0
2025-03-24,100,Current,0,0,0
2025-03-24,100,DPD30-59,1,1,0
2025-03-24,102,Current,0,0,0
2025-03-24,104,Current,0,0,0
2025-03-24,20,Current,0,0,0
2025-03-24,20,DPD15-29,157,156,1
2025-03-24,20,DPD3-14,155,155,0
2025-03-24,20,DPD30-59,98,98,0
2025-03-24,20,DPD60-89,0,0,0
2025-03-24,20,DPD90+,0,0,0
2025-03-24,22,Current,0,0,0
2025-03-24,22,DPD15-29,0,0,0
2025-03-24,24,Current,124,124,0
2025-03-24,24,DPD15-29,76,76,0
2025-03-24,24,DPD3-14,109,109,0
2025-03-24,24,DPD30-59,77,77,0
2025-03-24,24,DPD60-89,0,0,0
2025-03-24,24,DPD90+,0,0,0
2025-03-24,26,Current,0,0,0
2025-03-24,26,DPD15-29,11,11,0
2025-03-24,26,DPD3-14,16,16,0
2025-03-24,26,DPD30-59,6,6,0
2025-03-24,26,DPD60-89,0,0,0
2025-03-24,26,DPD90+,0,0,0
2025-03-24,32,Current,0,0,0
2025-03-24,32,DPD15-29,91,91,0
2025-03-24,32,DPD3-14,65,65,0
2025-03-24,32,DPD30-59,51,51,0
2025-03-24,32,DPD60-89,0,0,0
2025-03-24,32,DPD90+,0,0,0
2025-03-24,34,Current,0,0,0
2025-03-24,34,DPD15-29,36,36,0
2025-03-24,34,DPD3-14,20,20,0
2025-03-24,34,DPD30-59,19,19,0
2025-03-24,34,DPD60-89,0,0,0
2025-03-24,34,DPD90+,0,0,0
2025-03-24,36,Current,0,0,0
2025-03-24,36,DPD15-29,18,18,0
2025-03-24,36,DPD3-14,26,26,0
2025-03-24,36,DPD30-59,22,22,0
2025-03-24,36,DPD60-89,0,0,0
2025-03-24,36,DPD90+,0,0,0
2025-03-24,38,Current,14,14,0
2025-03-24,38,DPD15-29,32,32,0
2025-03-24,38,DPD3-14,26,25,1
2025-03-24,38,DPD30-59,14,14,0
2025-03-24,38,DPD60-89,0,0,0
2025-03-24,38,DPD90+,0,0,0
2025-03-24,40,Current,0,0,0
2025-03-24,40,DPD15-29,15,15,0
2025-03-24,40,DPD3-14,9,9,0
2025-03-24,40,DPD30-59,7,7,0
2025-03-24,40,DPD60-89,0,0,0
2025-03-24,40,DPD90+,0,0,0
2025-03-24,42,Current,0,0,0
2025-03-24,42,DPD15-29,6,6,0
2025-03-24,42,DPD3-14,4,4,0
2025-03-24,42,DPD30-59,4,4,0
2025-03-24,42,DPD60-89,0,0,0
2025-03-24,42,DPD90+,0,0,0
2025-03-24,44,Current,0,0,0
2025-03-24,44,DPD15-29,24,24,0
2025-03-24,44,DPD3-14,23,23,0
2025-03-24,44,DPD30-59,9,9,0
2025-03-24,44,DPD60-89,0,0,0
2025-03-24,44,DPD90+,0,0,0
2025-03-24,46,Current,0,0,0
2025-03-24,46,DPD15-29,0,0,0
2025-03-24,48,Current,36,36,0
2025-03-24,48,DPD15-29,28,28,0
2025-03-24,48,DPD3-14,37,36,1
2025-03-24,48,DPD30-59,10,10,0
2025-03-24,48,DPD60-89,0,0,0
2025-03-24,48,DPD90+,0,0,0
2025-03-24,6,Current,0,0,0
2025-03-23,100,Current,0,0,0
2025-03-23,100,DPD30-59,0,0,0
2025-03-23,102,Current,0,0,0
2025-03-23,104,Current,0,0,0
2025-03-23,20,Current,0,0,0
2025-03-23,20,DPD15-29,149,149,0
2025-03-23,20,DPD3-14,105,105,0
2025-03-23,20,DPD30-59,73,73,0
2025-03-23,20,DPD60-89,0,0,0
2025-03-23,20,DPD90+,0,0,0
2025-03-23,22,Current,0,0,0
2025-03-23,22,DPD15-29,1,1,0
2025-03-23,24,Current,60,60,0
2025-03-23,24,DPD15-29,85,85,0
2025-03-23,24,DPD3-14,70,70,0
2025-03-23,24,DPD30-59,32,32,0
2025-03-23,24,DPD60-89,0,0,0
2025-03-23,24,DPD90+,0,0,0
2025-03-23,26,Current,0,0,0
2025-03-23,26,DPD15-29,14,14,0
2025-03-23,26,DPD3-14,13,13,0
2025-03-23,26,DPD30-59,1,1,0
2025-03-23,26,DPD60-89,0,0,0
2025-03-23,26,DPD90+,0,0,0
2025-03-23,32,Current,0,0,0
2025-03-23,32,DPD15-29,85,85,0
2025-03-23,32,DPD3-14,38,38,0
2025-03-23,32,DPD30-59,24,24,0
2025-03-23,32,DPD60-89,0,0,0
2025-03-23,32,DPD90+,0,0,0
2025-03-23,34,Current,0,0,0
2025-03-23,34,DPD15-29,37,37,0
2025-03-23,34,DPD3-14,23,23,0
2025-03-23,34,DPD30-59,20,20,0
2025-03-23,34,DPD60-89,0,0,0
2025-03-23,34,DPD90+,0,0,0
2025-03-23,36,Current,0,0,0
2025-03-23,36,DPD15-29,8,8,0
2025-03-23,36,DPD3-14,11,11,0
2025-03-23,36,DPD30-59,6,6,0
2025-03-23,36,DPD60-89,0,0,0
2025-03-23,36,DPD90+,0,0,0
2025-03-23,38,Current,7,7,0
2025-03-23,38,DPD15-29,28,28,0
2025-03-23,38,DPD3-14,17,17,0
2025-03-23,38,DPD30-59,8,8,0
2025-03-23,38,DPD60-89,0,0,0
2025-03-23,38,DPD90+,0,0,0
2025-03-23,40,Current,1,1,0
2025-03-23,40,DPD15-29,15,14,1
2025-03-23,40,DPD3-14,9,9,0
2025-03-23,40,DPD30-59,8,8,0
2025-03-23,40,DPD60-89,0,0,0
2025-03-23,40,DPD90+,0,0,0
2025-03-23,42,Current,0,0,0
2025-03-23,42,DPD15-29,5,5,0
2025-03-23,42,DPD3-14,3,3,0
2025-03-23,42,DPD30-59,3,3,0
2025-03-23,42,DPD60-89,0,0,0
2025-03-23,42,DPD90+,0,0,0
2025-03-23,44,Current,0,0,0
2025-03-23,44,DPD15-29,17,17,0
2025-03-23,44,DPD3-14,14,14,0
2025-03-23,44,DPD30-59,13,13,0
2025-03-23,44,DPD60-89,0,0,0
2025-03-23,44,DPD90+,0,0,0
2025-03-23,46,Current,0,0,0
2025-03-23,46,DPD15-29,2,2,0
2025-03-23,48,Current,24,24,0
2025-03-23,48,DPD15-29,26,26,0
2025-03-23,48,DPD3-14,27,27,0
2025-03-23,48,DPD30-59,19,19,0
2025-03-23,48,DPD60-89,0,0,0
2025-03-23,48,DPD90+,0,0,0
2025-03-23,6,Current,0,0,0
2025-03-22,100,Current,0,0,0
2025-03-22,100,DPD30-59,1,1,0
2025-03-22,102,Current,0,0,0
2025-03-22,104,Current,0,0,0
2025-03-22,20,Current,4,4,0
2025-03-22,20,DPD15-29,158,157,1
2025-03-22,20,DPD3-14,118,118,0
2025-03-22,20,DPD30-59,110,110,0
2025-03-22,20,DPD60-89,0,0,0
2025-03-22,20,DPD90+,0,0,0
2025-03-22,22,Current,0,0,0
2025-03-22,22,DPD15-29,0,0,0
2025-03-22,24,Current,41,41,0
2025-03-22,24,DPD15-29,86,86,0
2025-03-22,24,DPD3-14,93,93,0
2025-03-22,24,DPD30-59,80,80,0
2025-03-22,24,DPD60-89,0,0,0
2025-03-22,24,DPD90+,0,0,0
2025-03-22,26,Current,0,0,0
2025-03-22,26,DPD15-29,11,11,0
2025-03-22,26,DPD3-14,8,8,0
2025-03-22,26,DPD30-59,6,6,0
2025-03-22,26,DPD60-89,0,0,0
2025-03-22,26,DPD90+,0,0,0
2025-03-22,32,Current,0,0,0
2025-03-22,32,DPD15-29,92,92,0
2025-03-22,32,DPD3-14,52,52,0
2025-03-22,32,DPD30-59,57,57,0
2025-03-22,32,DPD60-89,1,1,0
2025-03-22,32,DPD90+,0,0,0
2025-03-22,34,Current,0,0,0
2025-03-22,34,DPD15-29,34,34,0
2025-03-22,34,DPD3-14,24,24,0
2025-03-22,34,DPD30-59,20,20,0
2025-03-22,34,DPD60-89,0,0,0
2025-03-22,34,DPD90+,0,0,0
2025-03-22,36,Current,0,0,0
2025-03-22,36,DPD15-29,18,18,0
2025-03-22,36,DPD3-14,15,15,0
2025-03-22,36,DPD30-59,22,22,0
2025-03-22,36,DPD60-89,0,0,0
2025-03-22,36,DPD90+,0,0,0
2025-03-22,38,Current,10,10,0
2025-03-22,38,DPD15-29,31,31,0
2025-03-22,38,DPD3-14,18,18,0
2025-03-22,38,DPD30-59,16,16,0
2025-03-22,38,DPD60-89,0,0,0
2025-03-22,38,DPD90+,0,0,0
2025-03-22,40,Current,0,0,0
2025-03-22,40,DPD15-29,16,16,0
2025-03-22,40,DPD3-14,10,10,0
2025-03-22,40,DPD30-59,9,9,0
2025-03-22,40,DPD60-89,0,0,0
2025-03-22,40,DPD90+,0,0,0
2025-03-22,42,Current,0,0,0
2025-03-22,42,DPD15-29,6,6,0
2025-03-22,42,DPD3-14,3,3,0
2025-03-22,42,DPD30-59,6,6,0
2025-03-22,42,DPD60-89,0,0,0
2025-03-22,42,DPD90+,0,0,0
2025-03-22,44,Current,0,0,0
2025-03-22,44,DPD15-29,17,17,0
2025-03-22,44,DPD3-14,18,18,0
2025-03-22,44,DPD30-59,11,11,0
2025-03-22,44,DPD60-89,0,0,0
2025-03-22,44,DPD90+,0,0,0
2025-03-22,46,Current,0,0,0
2025-03-22,46,DPD15-29,0,0,0
2025-03-22,48,Current,39,39,0
2025-03-22,48,DPD15-29,24,24,0
2025-03-22,48,DPD3-14,30,29,1
2025-03-22,48,DPD30-59,14,14,0
2025-03-22,48,DPD60-89,0,0,0
2025-03-22,48,DPD90+,0,0,0
2025-03-22,6,Current,0,0,0
2025-03-21,100,Current,0,0,0
2025-03-21,100,DPD30-59,0,0,0
2025-03-21,102,Current,0,0,0
2025-03-21,104,Current,0,0,0
2025-03-21,20,Current,1,1,0
2025-03-21,20,DPD15-29,174,174,0
2025-03-21,20,DPD3-14,215,215,0
2025-03-21,20,DPD30-59,65,65,0
2025-03-21,20,DPD60-89,0,0,0
2025-03-21,20,DPD90+,0,0,0
2025-03-21,22,Current,0,0,0
2025-03-21,22,DPD15-29,1,1,0
2025-03-21,24,Current,80,80,0
2025-03-21,24,DPD15-29,94,94,0
2025-03-21,24,DPD3-14,113,113,0
2025-03-21,24,DPD30-59,23,23,0
2025-03-21,24,DPD60-89,0,0,0
2025-03-21,24,DPD90+,0,0,0
2025-03-21,26,Current,0,0,0
2025-03-21,26,DPD15-29,15,15,0
2025-03-21,26,DPD3-14,20,20,0
2025-03-21,26,DPD30-59,2,2,0
2025-03-21,26,DPD60-89,0,0,0
2025-03-21,26,DPD90+,0,0,0
2025-03-21,32,Current,0,0,0
2025-03-21,32,DPD15-29,89,89,0
2025-03-21,32,DPD3-14,67,67,0
2025-03-21,32,DPD30-59,24,24,0
2025-03-21,32,DPD60-89,0,0,0
2025-03-21,32,DPD90+,0,0,0
2025-03-21,34,Current,0,0,0
2025-03-21,34,DPD15-29,49,49,0
2025-03-21,34,DPD3-14,30,30,0
2025-03-21,34,DPD30-59,32,32,0
2025-03-21,34,DPD60-89,0,0,0
2025-03-21,34,DPD90+,0,0,0
2025-03-21,36,Current,1,1,0
2025-03-21,36,DPD15-29,11,11,0
2025-03-21,36,DPD3-14,16,16,0
2025-03-21,36,DPD30-59,7,7,0
2025-03-21,36,DPD60-89,0,0,0
2025-03-21,36,DPD90+,0,0,0
2025-03-21,38,Current,15,15,0
2025-03-21,38,DPD15-29,29,29,0
2025-03-21,38,DPD3-14,21,21,0
2025-03-21,38,DPD30-59,9,9,0
2025-03-21,38,DPD60-89,0,0,0
2025-03-21,38,DPD90+,0,0,0
2025-03-21,40,Current,0,0,0
2025-03-21,40,DPD15-29,13,12,1
2025-03-21,40,DPD3-14,27,27,0
2025-03-21,40,DPD30-59,4,4,0
2025-03-21,40,DPD60-89,0,0,0
2025-03-21,40,DPD90+,0,0,0
2025-03-21,42,Current,0,0,0
2025-03-21,42,DPD15-29,4,4,0
2025-03-21,42,DPD3-14,13,13,0
2025-03-21,42,DPD30-59,4,4,0
2025-03-21,42,DPD60-89,0,0,0
2025-03-21,42,DPD90+,0,0,0
2025-03-21,44,Current,0,0,0
2025-03-21,44,DPD15-29,17,17,0
2025-03-21,44,DPD3-14,28,28,0
2025-03-21,44,DPD30-59,13,13,0
2025-03-21,44,DPD60-89,0,0,0
2025-03-21,44,DPD90+,0,0,0
2025-03-21,46,Current,0,0,0
2025-03-21,46,DPD3-14,0,0,0
2025-03-21,48,Current,52,52,0
2025-03-21,48,DPD15-29,28,28,0
2025-03-21,48,DPD3-14,31,31,0
2025-03-21,48,DPD30-59,15,15,0
2025-03-21,48,DPD60-89,0,0,0
2025-03-21,48,DPD90+,0,0,0
2025-03-21,6,Current,0,0,0
2025-03-20,100,Current,0,0,0
2025-03-20,100,DPD15-29,0,0,0
2025-03-20,100,DPD30-59,1,1,0
2025-03-20,102,Current,0,0,0
2025-03-20,102,DPD3-14,0,0,0
2025-03-20,104,Current,0,0,0
2025-03-20,20,Current,1,1,0
2025-03-20,20,DPD15-29,188,187,1
2025-03-20,20,DPD3-14,107,107,0
2025-03-20,20,DPD30-59,132,132,0
2025-03-20,20,DPD60-89,0,0,0
2025-03-20,20,DPD90+,0,0,0
2025-03-20,22,Current,0,0,0
2025-03-20,22,DPD15-29,0,0,0
2025-03-20,24,Current,62,62,0
2025-03-20,24,DPD15-29,107,107,0
2025-03-20,24,DPD3-14,91,91,0
2025-03-20,24,DPD30-59,91,91,0
2025-03-20,24,DPD60-89,0,0,0
2025-03-20,24,DPD90+,0,0,0
2025-03-20,26,Current,0,0,0
2025-03-20,26,DPD15-29,11,11,0
2025-03-20,26,DPD3-14,11,11,0
2025-03-20,26,DPD30-59,7,7,0
2025-03-20,26,DPD60-89,0,0,0
2025-03-20,26,DPD90+,1,1,0
2025-03-20,32,Current,0,0,0
2025-03-20,32,DPD15-29,111,111,0
2025-03-20,32,DPD3-14,67,67,0
2025-03-20,32,DPD30-59,62,62,0
2025-03-20,32,DPD60-89,0,0,0
2025-03-20,32,DPD90+,1,1,0
2025-03-20,34,Current,0,0,0
2025-03-20,34,DPD15-29,41,41,0
2025-03-20,34,DPD3-14,21,21,0
2025-03-20,34,DPD30-59,27,27,0
2025-03-20,34,DPD60-89,0,0,0
2025-03-20,34,DPD90+,0,0,0
2025-03-20,36,Current,0,0,0
2025-03-20,36,DPD15-29,28,28,0
2025-03-20,36,DPD3-14,14,14,0
2025-03-20,36,DPD30-59,22,22,0
2025-03-20,36,DPD60-89,0,0,0
2025-03-20,36,DPD90+,0,0,0
2025-03-20,38,Current,16,16,0
2025-03-20,38,DPD15-29,33,33,0
2025-03-20,38,DPD3-14,27,27,0
2025-03-20,38,DPD30-59,15,15,0
2025-03-20,38,DPD60-89,0,0,0
2025-03-20,38,DPD90+,0,0,0
2025-03-20,40,Current,0,0,0
2025-03-20,40,DPD15-29,19,19,0
2025-03-20,40,DPD3-14,13,13,0
2025-03-20,40,DPD30-59,8,8,0
2025-03-20,40,DPD60-89,0,0,0
2025-03-20,40,DPD90+,0,0,0
2025-03-20,42,Current,0,0,0
2025-03-20,42,DPD15-29,10,10,0
2025-03-20,42,DPD3-14,5,5,0
2025-03-20,42,DPD30-59,7,7,0
2025-03-20,42,DPD60-89,0,0,0
2025-03-20,42,DPD90+,0,0,0
2025-03-20,44,Current,0,0,0
2025-03-20,44,DPD15-29,19,19,0
2025-03-20,44,DPD3-14,14,14,0
2025-03-20,44,DPD30-59,16,16,0
2025-03-20,44,DPD60-89,0,0,0
2025-03-20,44,DPD90+,0,0,0
2025-03-20,46,Current,0,0,0
2025-03-20,46,DPD3-14,0,0,0
2025-03-20,48,Current,51,51,0
2025-03-20,48,DPD15-29,24,24,0
2025-03-20,48,DPD3-14,24,24,0
2025-03-20,48,DPD30-59,16,16,0
2025-03-20,48,DPD60-89,0,0,0
2025-03-20,48,DPD90+,0,0,0
2025-03-20,6,Current,0,0,0
2025-03-19,100,Current,0,0,0
2025-03-19,100,DPD15-29,0,0,0
2025-03-19,100,DPD30-59,0,0,0
2025-03-19,102,Current,0,0,0
2025-03-19,102,DPD3-14,0,0,0
2025-03-19,104,Current,0,0,0
2025-03-19,20,Current,1,1,0
2025-03-19,20,DPD15-29,183,183,0
2025-03-19,20,DPD3-14,185,185,0
2025-03-19,20,DPD30-59,66,66,0
2025-03-19,20,DPD60-89,0,0,0
2025-03-19,20,DPD90+,0,0,0
2025-03-19,22,Current,0,0,0
2025-03-19,22,DPD15-29,1,1,0
2025-03-19,24,Current,51,51,0
2025-03-19,24,DPD15-29,104,104,0
2025-03-19,24,DPD3-14,101,101,0
2025-03-19,24,DPD30-59,21,21,0
2025-03-19,24,DPD60-89,0,0,0
2025-03-19,24,DPD90+,0,0,0
2025-03-19,26,Current,0,0,0
2025-03-19,26,DPD15-29,12,12,0
2025-03-19,26,DPD3-14,14,14,0
2025-03-19,26,DPD30-59,2,2,0
2025-03-19,26,DPD60-89,0,0,0
2025-03-19,26,DPD90+,0,0,0
2025-03-19,32,Current,1,1,0
2025-03-19,32,DPD15-29,106,106,0
2025-03-19,32,DPD3-14,70,70,0
2025-03-19,32,DPD30-59,19,19,0
2025-03-19,32,DPD60-89,0,0,0
2025-03-19,32,DPD90+,0,0,0
2025-03-19,34,Current,0,0,0
2025-03-19,34,DPD15-29,30,30,0
2025-03-19,34,DPD3-14,29,29,0
2025-03-19,34,DPD30-59,11,11,0
2025-03-19,34,DPD60-89,0,0,0
2025-03-19,34,DPD90+,0,0,0
2025-03-19,36,Current,0,0,0
2025-03-19,36,DPD15-29,17,17,0
2025-03-19,36,DPD3-14,20,20,0
2025-03-19,36,DPD30-59,7,7,0
2025-03-19,36,DPD60-89,0,0,0
2025-03-19,36,DPD90+,0,0,0
2025-03-19,38,Current,10,10,0
2025-03-19,38,DPD15-29,28,28,0
2025-03-19,38,DPD3-14,31,31,0
2025-03-19,38,DPD30-59,6,6,0
2025-03-19,38,DPD60-89,0,0,0
2025-03-19,38,DPD90+,0,0,0
2025-03-19,40,Current,0,0,0
2025-03-19,40,DPD15-29,15,14,1
2025-03-19,40,DPD3-14,20,20,0
2025-03-19,40,DPD30-59,3,3,0
2025-03-19,40,DPD60-89,0,0,0
2025-03-19,40,DPD90+,0,0,0
2025-03-19,42,Current,0,0,0
2025-03-19,42,DPD15-29,5,5,0
2025-03-19,42,DPD3-14,14,14,0
2025-03-19,42,DPD30-59,4,4,0
2025-03-19,42,DPD60-89,0,0,0
2025-03-19,42,DPD90+,0,0,0
2025-03-19,44,Current,0,0,0
2025-03-19,44,DPD15-29,23,23,0
2025-03-19,44,DPD3-14,36,36,0
2025-03-19,44,DPD30-59,12,12,0
2025-03-19,44,DPD60-89,0,0,0
2025-03-19,44,DPD90+,0,0,0
2025-03-19,46,Current,0,0,0
2025-03-19,46,DPD3-14,0,0,0
2025-03-19,48,Current,41,41,0
2025-03-19,48,DPD15-29,27,27,0
2025-03-19,48,DPD3-14,37,37,0
2025-03-19,48,DPD30-59,11,11,0
2025-03-19,48,DPD60-89,0,0,0
2025-03-19,48,DPD90+,0,0,0
2025-03-19,6,Current,0,0,0
2025-03-18,100,Current,0,0,0
2025-03-18,100,DPD15-29,0,0,0
2025-03-18,100,DPD30-59,1,1,0
2025-03-18,102,Current,0,0,0
2025-03-18,102,DPD3-14,0,0,0
2025-03-18,104,Current,0,0,0
2025-03-18,20,Current,0,0,0
2025-03-18,20,DPD15-29,211,210,1
2025-03-18,20,DPD3-14,80,80,0
2025-03-18,20,DPD30-59,139,139,0
2025-03-18,20,DPD60-89,0,0,0
2025-03-18,20,DPD90+,0,0,0
2025-03-18,22,Current,0,0,0
2025-03-18,22,DPD15-29,0,0,0
2025-03-18,24,Current,83,82,1
2025-03-18,24,DPD15-29,113,113,0
2025-03-18,24,DPD3-14,61,61,0
2025-03-18,24,DPD30-59,103,103,0
2025-03-18,24,DPD60-89,0,0,0
2025-03-18,24,DPD90+,0,0,0
2025-03-18,26,Current,0,0,0
2025-03-18,26,DPD15-29,12,12,0
2025-03-18,26,DPD3-14,11,11,0
2025-03-18,26,DPD30-59,6,6,0
2025-03-18,26,DPD60-89,0,0,0
2025-03-18,26,DPD90+,0,0,0
2025-03-18,32,Current,0,0,0
2025-03-18,32,DPD15-29,125,125,0
2025-03-18,32,DPD3-14,42,42,0
2025-03-18,32,DPD30-59,68,68,0
2025-03-18,32,DPD60-89,0,0,0
2025-03-18,32,DPD90+,0,0,0
2025-03-18,34,Current,0,0,0
2025-03-18,34,DPD15-29,43,43,0
2025-03-18,34,DPD3-14,19,19,0
2025-03-18,34,DPD30-59,30,30,0
2025-03-18,34,DPD60-89,0,0,0
2025-03-18,34,DPD90+,0,0,0
2025-03-18,36,Current,0,0,0
2025-03-18,36,DPD15-29,32,32,0
2025-03-18,36,DPD3-14,5,5,0
2025-03-18,36,DPD30-59,22,22,0
2025-03-18,36,DPD60-89,0,0,0
2025-03-18,36,DPD90+,0,0,0
2025-03-18,38,Current,12,11,1
2025-03-18,38,DPD15-29,35,35,0
2025-03-18,38,DPD3-14,19,19,0
2025-03-18,38,DPD30-59,18,18,0
2025-03-18,38,DPD60-89,0,0,0
2025-03-18,38,DPD90+,0,0,0
2025-03-18,40,Current,0,0,0
2025-03-18,40,DPD15-29,19,19,0
2025-03-18,40,DPD3-14,12,12,0
2025-03-18,40,DPD30-59,8,8,0
2025-03-18,40,DPD60-89,0,0,0
2025-03-18,40,DPD90+,0,0,0
2025-03-18,42,Current,0,0,0
2025-03-18,42,DPD15-29,12,12,0
2025-03-18,42,DPD3-14,0,0,0
2025-03-18,42,DPD30-59,8,8,0
2025-03-18,42,DPD60-89,0,0,0
2025-03-18,42,DPD90+,0,0,0
2025-03-18,44,Current,1,1,0
2025-03-18,44,DPD15-29,25,25,0
2025-03-18,44,DPD3-14,12,12,0
2025-03-18,44,DPD30-59,20,20,0
2025-03-18,44,DPD60-89,0,0,0
2025-03-18,44,DPD90+,0,0,0
2025-03-18,46,Current,0,0,0
2025-03-18,46,DPD3-14,2,2,0
2025-03-18,48,Current,51,51,0
2025-03-18,48,DPD15-29,29,29,0
2025-03-18,48,DPD3-14,21,21,0
2025-03-18,48,DPD30-59,14,14,0
2025-03-18,48,DPD60-89,0,0,0
2025-03-18,48,DPD90+,0,0,0
2025-03-18,6,Current,0,0,0
2025-03-17,100,Current,0,0,0
2025-03-17,100,DPD3-14,0,0,0
2025-03-17,100,DPD30-59,0,0,0
2025-03-17,102,Current,0,0,0
2025-03-17,102,DPD3-14,0,0,0
2025-03-17,104,Current,0,0,0
2025-03-17,20,Current,0,0,0
2025-03-17,20,DPD15-29,312,312,0
2025-03-17,20,DPD3-14,101,101,0
2025-03-17,20,DPD30-59,139,139,0
2025-03-17,20,DPD60-89,0,0,0
2025-03-17,20,DPD90+,0,0,0
2025-03-17,22,Current,0,0,0
2025-03-17,22,DPD15-29,1,1,0
2025-03-17,24,Current,83,83,0
2025-03-17,24,DPD15-29,205,205,0
2025-03-17,24,DPD3-14,70,70,0
2025-03-17,24,DPD30-59,58,58,0
2025-03-17,24,DPD60-89,0,0,0
2025-03-17,24,DPD90+,0,0,0
2025-03-17,26,Current,0,0,0
2025-03-17,26,DPD15-29,23,23,0
2025-03-17,26,DPD3-14,10,10,0
2025-03-17,26,DPD30-59,6,6,0
2025-03-17,26,DPD60-89,0,0,0
2025-03-17,26,DPD90+,0,0,0
2025-03-17,32,Current,0,0,0
2025-03-17,32,DPD15-29,171,170,1
2025-03-17,32,DPD3-14,35,35,0
2025-03-17,32,DPD30-59,49,49,0
2025-03-17,32,DPD60-89,0,0,0
2025-03-17,32,DPD90+,0,0,0
2025-03-17,34,Current,0,0,0
2025-03-17,34,DPD15-29,46,46,0
2025-03-17,34,DPD3-14,23,23,0
2025-03-17,34,DPD30-59,21,21,0
2025-03-17,34,DPD60-89,0,0,0
2025-03-17,34,DPD90+,0,0,0
2025-03-17,36,Current,0,0,0
2025-03-17,36,DPD15-29,42,42,0
2025-03-17,36,DPD3-14,10,10,0
2025-03-17,36,DPD30-59,13,13,0
2025-03-17,36,DPD60-89,0,0,0
2025-03-17,36,DPD90+,0,0,0
2025-03-17,38,Current,17,17,0
2025-03-17,38,DPD15-29,53,53,0
2025-03-17,38,DPD3-14,13,13,0
2025-03-17,38,DPD30-59,20,19,1
2025-03-17,38,DPD60-89,0,0,0
2025-03-17,38,DPD90+,0,0,0
2025-03-17,40,Current,0,0,0
2025-03-17,40,DPD15-29,30,29,1
2025-03-17,40,DPD3-14,9,9,0
2025-03-17,40,DPD30-59,3,3,0
2025-03-17,40,DPD60-89,0,0,0
2025-03-17,40,DPD90+,0,0,0
2025-03-17,42,Current,0,0,0
2025-03-17,42,DPD15-29,16,16,0
2025-03-17,42,DPD3-14,4,4,0
2025-03-17,42,DPD30-59,5,5,0
2025-03-17,42,DPD60-89,0,0,0
2025-03-17,42,DPD90+,0,0,0
2025-03-17,44,Current,10,10,0
2025-03-17,44,DPD15-29,46,46,0
2025-03-17,44,DPD3-14,15,15,0
2025-03-17,44,DPD30-59,17,17,0
2025-03-17,44,DPD60-89,0,0,0
2025-03-17,44,DPD90+,0,0,0
2025-03-17,46,Current,0,0,0
2025-03-17,46,DPD3-14,0,0,0
2025-03-17,48,Current,60,60,0
2025-03-17,48,DPD15-29,61,61,0
2025-03-17,48,DPD3-14,35,35,0
2025-03-17,48,DPD30-59,17,17,0
2025-03-17,48,DPD60-89,0,0,0
2025-03-17,48,DPD90+,0,0,0
2025-03-17,6,Current,0,0,0
2025-03-16,100,Current,0,0,0
2025-03-16,100,DPD30-59,0,0,0
2025-03-16,100,DPD90+,0,0,0
2025-03-16,102,Current,0,0,0
2025-03-16,102,DPD15-29,0,0,0
2025-03-16,102,DPD90+,0,0,0
2025-03-16,104,Current,0,0,0
2025-03-16,20,Current,0,0,0
2025-03-16,20,DPD15-29,233,232,1
2025-03-16,20,DPD3-14,106,106,0
2025-03-16,20,DPD30-59,138,138,0
2025-03-16,20,DPD60-89,0,0,0
2025-03-16,20,DPD90+,0,0,0
2025-03-16,22,Current,0,0,0
2025-03-16,22,DPD15-29,0,0,0
2025-03-16,24,Current,39,39,0
2025-03-16,24,DPD15-29,118,118,0
2025-03-16,24,DPD3-14,100,100,0
2025-03-16,24,DPD30-59,99,99,0
2025-03-16,24,DPD60-89,0,0,0
2025-03-16,24,DPD90+,0,0,0
2025-03-16,26,Current,0,0,0
2025-03-16,26,DPD15-29,10,10,0
2025-03-16,26,DPD3-14,15,15,0
2025-03-16,26,DPD30-59,11,11,0
2025-03-16,26,DPD60-89,0,0,0
2025-03-16,26,DPD90+,0,0,0
2025-03-16,32,Current,0,0,0
2025-03-16,32,DPD15-29,124,124,0
2025-03-16,32,DPD3-14,40,40,0
2025-03-16,32,DPD30-59,74,74,0
2025-03-16,32,DPD60-89,0,0,0
2025-03-16,32,DPD90+,0,0,0
2025-03-16,34,Current,0,0,0
2025-03-16,34,DPD15-29,40,40,0
2025-03-16,34,DPD3-14,15,15,0
2025-03-16,34,DPD30-59,32,32,0
2025-03-16,34,DPD60-89,0,0,0
2025-03-16,34,DPD90+,0,0,0
2025-03-16,36,Current,0,0,0
2025-03-16,36,DPD15-29,29,29,0
2025-03-16,36,DPD3-14,10,10,0
2025-03-16,36,DPD30-59,18,18,0
2025-03-16,36,DPD60-89,0,0,0
2025-03-16,36,DPD90+,0,0,0
2025-03-16,38,Current,13,13,0
2025-03-16,38,DPD15-29,31,31,0
2025-03-16,38,DPD3-14,17,17,0
2025-03-16,38,DPD30-59,21,21,0
2025-03-16,38,DPD60-89,0,0,0
2025-03-16,38,DPD90+,0,0,0
2025-03-16,40,Current,0,0,0
2025-03-16,40,DPD15-29,21,21,0
2025-03-16,40,DPD3-14,13,13,0
2025-03-16,40,DPD30-59,10,10,0
2025-03-16,40,DPD60-89,0,0,0
2025-03-16,40,DPD90+,0,0,0
2025-03-16,42,Current,0,0,0
2025-03-16,42,DPD15-29,9,9,0
2025-03-16,42,DPD3-14,3,3,0
2025-03-16,42,DPD30-59,5,5,0
2025-03-16,42,DPD60-89,0,0,0
2025-03-16,42,DPD90+,0,0,0
2025-03-16,44,Current,5,5,0
2025-03-16,44,DPD15-29,27,27,0
2025-03-16,44,DPD3-14,9,9,0
2025-03-16,44,DPD30-59,18,18,0
2025-03-16,44,DPD60-89,0,0,0
2025-03-16,44,DPD90+,0,0,0
2025-03-16,46,Current,0,0,0
2025-03-16,46,DPD15-29,0,0,0
2025-03-16,46,DPD3-14,0,0,0
2025-03-16,48,Current,35,35,0
2025-03-16,48,DPD15-29,40,40,0
2025-03-16,48,DPD3-14,39,39,0
2025-03-16,48,DPD30-59,14,14,0
2025-03-16,48,DPD60-89,0,0,0
2025-03-16,48,DPD90+,0,0,0
2025-03-16,6,Current,0,0,0
2025-03-15,100,Current,0,0,0
2025-03-15,100,DPD30-59,0,0,0
2025-03-15,100,DPD90+,0,0,0
2025-03-15,102,Current,0,0,0
2025-03-15,102,DPD15-29,1,1,0
2025-03-15,102,DPD90+,0,0,0
2025-03-15,104,Current,0,0,0
2025-03-15,20,Current,1,1,0
2025-03-15,20,DPD15-29,319,319,0
2025-03-15,20,DPD3-14,282,282,0
2025-03-15,20,DPD30-59,160,160,0
2025-03-15,20,DPD60-89,0,0,0
2025-03-15,20,DPD90+,0,0,0
2025-03-15,22,Current,0,0,0
2025-03-15,22,DPD15-29,1,1,0
2025-03-15,24,Current,54,54,0
2025-03-15,24,DPD15-29,220,220,0
2025-03-15,24,DPD3-14,238,238,0
2025-03-15,24,DPD30-59,73,73,0
2025-03-15,24,DPD60-89,0,0,0
2025-03-15,24,DPD90+,0,0,0
2025-03-15,26,Current,0,0,0
2025-03-15,26,DPD15-29,29,29,0
2025-03-15,26,DPD3-14,19,19,0
2025-03-15,26,DPD30-59,9,9,0
2025-03-15,26,DPD60-89,0,0,0
2025-03-15,26,DPD90+,0,0,0
2025-03-15,32,Current,0,0,0
2025-03-15,32,DPD15-29,166,165,1
2025-03-15,32,DPD3-14,82,82,0
2025-03-15,32,DPD30-59,67,67,0
2025-03-15,32,DPD60-89,0,0,0
2025-03-15,32,DPD90+,0,0,0
2025-03-15,34,Current,0,0,0
2025-03-15,34,DPD15-29,42,42,0
2025-03-15,34,DPD3-14,32,32,0
2025-03-15,34,DPD30-59,29,29,0
2025-03-15,34,DPD60-89,0,0,0
2025-03-15,34,DPD90+,0,0,0
2025-03-15,36,Current,0,0,0
2025-03-15,36,DPD15-29,41,41,0
2025-03-15,36,DPD3-14,33,33,0
2025-03-15,36,DPD30-59,19,19,0
2025-03-15,36,DPD60-89,0,0,0
2025-03-15,36,DPD90+,0,0,0
2025-03-15,38,Current,9,9,0
2025-03-15,38,DPD15-29,56,56,0
2025-03-15,38,DPD3-14,30,30,0
2025-03-15,38,DPD30-59,22,21,1
2025-03-15,38,DPD60-89,0,0,0
2025-03-15,38,DPD90+,0,0,0
2025-03-15,40,Current,0,0,0
2025-03-15,40,DPD15-29,29,28,1
2025-03-15,40,DPD3-14,34,34,0
2025-03-15,40,DPD30-59,7,7,0
2025-03-15,40,DPD60-89,0,0,0
2025-03-15,40,DPD90+,0,0,0
2025-03-15,42,Current,0,0,0
2025-03-15,42,DPD15-29,16,16,0
2025-03-15,42,DPD3-14,9,9,0
2025-03-15,42,DPD30-59,10,10,0
2025-03-15,42,DPD60-89,0,0,0
2025-03-15,42,DPD90+,0,0,0
2025-03-15,44,Current,7,7,0
2025-03-15,44,DPD15-29,52,52,0
2025-03-15,44,DPD3-14,50,50,0
2025-03-15,44,DPD30-59,23,23,0
2025-03-15,44,DPD60-89,0,0,0
2025-03-15,44,DPD90+,0,0,0
2025-03-15,46,Current,0,0,0
2025-03-15,46,DPD3-14,0,0,0
2025-03-15,48,Current,19,19,0
2025-03-15,48,DPD15-29,70,70,0
2025-03-15,48,DPD3-14,95,95,0
2025-03-15,48,DPD30-59,25,25,0
2025-03-15,48,DPD60-89,0,0,0
2025-03-15,48,DPD90+,0,0,0
2025-03-15,6,Current,0,0,0
2025-03-14,100,Current,0,0,0
2025-03-14,100,DPD30-59,0,0,0
2025-03-14,100,DPD90+,0,0,0
2025-03-14,102,Current,0,0,0
2025-03-14,102,DPD15-29,1,1,0
2025-03-14,102,DPD90+,0,0,0
2025-03-14,104,Current,0,0,0
2025-03-14,20,Current,1,1,0
2025-03-14,20,DPD15-29,175,174,1
2025-03-14,20,DPD3-14,102,102,0
2025-03-14,20,DPD30-59,147,147,0
2025-03-14,20,DPD60-89,0,0,0
2025-03-14,20,DPD90+,0,0,0
2025-03-14,22,Current,0,0,0
2025-03-14,22,DPD15-29,0,0,0
2025-03-14,24,Current,78,78,0
2025-03-14,24,DPD15-29,98,98,0
2025-03-14,24,DPD3-14,77,77,0
2025-03-14,24,DPD30-59,92,92,0
2025-03-14,24,DPD60-89,0,0,0
2025-03-14,24,DPD90+,0,0,0
2025-03-14,26,Current,0,0,0
2025-03-14,26,DPD15-29,9,9,0
2025-03-14,26,DPD3-14,9,9,0
2025-03-14,26,DPD30-59,4,4,0
2025-03-14,26,DPD60-89,0,0,0
2025-03-14,26,DPD90+,0,0,0
2025-03-14,32,Current,0,0,0
2025-03-14,32,DPD15-29,103,103,0
2025-03-14,32,DPD3-14,35,35,0
2025-03-14,32,DPD30-59,71,71,0
2025-03-14,32,DPD60-89,0,0,0
2025-03-14,32,DPD90+,0,0,0
2025-03-14,34,Current,0,0,0
2025-03-14,34,DPD15-29,35,35,0
2025-03-14,34,DPD3-14,15,15,0
2025-03-14,34,DPD30-59,33,33,0
2025-03-14,34,DPD60-89,0,0,0
2025-03-14,34,DPD90+,0,0,0
2025-03-14,36,Current,1,1,0
2025-03-14,36,DPD15-29,24,24,0
2025-03-14,36,DPD3-14,9,9,0
2025-03-14,36,DPD30-59,16,16,0
2025-03-14,36,DPD60-89,0,0,0
2025-03-14,36,DPD90+,0,0,0
2025-03-14,38,Current,14,14,0
2025-03-14,38,DPD15-29,23,23,0
2025-03-14,38,DPD3-14,19,19,0
2025-03-14,38,DPD30-59,22,22,0
2025-03-14,38,DPD60-89,0,0,0
2025-03-14,38,DPD90+,0,0,0
2025-03-14,40,Current,0,0,0
2025-03-14,40,DPD15-29,19,19,0
2025-03-14,40,DPD3-14,10,10,0
2025-03-14,40,DPD30-59,12,12,0
2025-03-14,40,DPD60-89,0,0,0
2025-03-14,40,DPD90+,0,0,0
2025-03-14,42,Current,0,0,0
2025-03-14,42,DPD15-29,8,8,0
2025-03-14,42,DPD3-14,4,4,0
2025-03-14,42,DPD30-59,8,8,0
2025-03-14,42,DPD60-89,0,0,0
2025-03-14,42,DPD90+,0,0,0
2025-03-14,44,Current,0,0,0
2025-03-14,44,DPD15-29,23,23,0
2025-03-14,44,DPD3-14,20,20,0
2025-03-14,44,DPD30-59,18,18,0
2025-03-14,44,DPD60-89,0,0,0
2025-03-14,44,DPD90+,0,0,0
2025-03-14,46,Current,0,0,0
2025-03-14,46,DPD3-14,0,0,0
2025-03-14,48,Current,26,26,0
2025-03-14,48,DPD15-29,27,27,0
2025-03-14,48,DPD3-14,19,19,0
2025-03-14,48,DPD30-59,15,15,0
2025-03-14,48,DPD60-89,0,0,0
2025-03-14,48,DPD90+,0,0,0
2025-03-14,6,Current,0,0,0
2025-03-13,100,Current,0,0,0
2025-03-13,100,DPD3-14,0,0,0
2025-03-13,100,DPD30-59,0,0,0
2025-03-13,102,Current,0,0,0
2025-03-13,102,DPD15-29,0,0,0
2025-03-13,102,DPD3-14,0,0,0
2025-03-13,104,Current,0,0,0
2025-03-13,20,Current,2,2,0
2025-03-13,20,DPD15-29,185,185,0
2025-03-13,20,DPD3-14,81,81,0
2025-03-13,20,DPD30-59,93,93,0
2025-03-13,20,DPD60-89,0,0,0
2025-03-13,20,DPD90+,0,0,0
2025-03-13,22,Current,0,0,0
2025-03-13,22,DPD3-14,0,0,0
2025-03-13,24,Current,96,96,0
2025-03-13,24,DPD15-29,124,124,0
2025-03-13,24,DPD3-14,65,65,0
2025-03-13,24,DPD30-59,49,49,0
2025-03-13,24,DPD60-89,0,0,0
2025-03-13,24,DPD90+,0,0,0
2025-03-13,26,Current,0,0,0
2025-03-13,26,DPD15-29,12,12,0
2025-03-13,26,DPD3-14,5,5,0
2025-03-13,26,DPD30-59,4,4,0
2025-03-13,26,DPD60-89,0,0,0
2025-03-13,26,DPD90+,0,0,0
2025-03-13,32,Current,0,0,0
2025-03-13,32,DPD15-29,97,97,0
2025-03-13,32,DPD3-14,34,34,0
2025-03-13,32,DPD30-59,38,38,0
2025-03-13,32,DPD60-89,1,1,0
2025-03-13,32,DPD90+,0,0,0
2025-03-13,34,Current,239,239,0
2025-03-13,34,DPD15-29,49,49,0
2025-03-13,34,DPD3-14,16,16,0
2025-03-13,34,DPD30-59,35,35,0
2025-03-13,34,DPD60-89,4,4,0
2025-03-13,34,DPD90+,1,1,0
2025-03-13,36,Current,0,0,0
2025-03-13,36,DPD15-29,25,25,0
2025-03-13,36,DPD3-14,11,11,0
2025-03-13,36,DPD30-59,16,16,0
2025-03-13,36,DPD60-89,0,0,0
2025-03-13,36,DPD90+,0,0,0
2025-03-13,38,Current,8,8,0
2025-03-13,38,DPD15-29,28,28,0
2025-03-13,38,DPD3-14,13,13,0
2025-03-13,38,DPD30-59,12,12,0
2025-03-13,38,DPD60-89,0,0,0
2025-03-13,38,DPD90+,0,0,0
2025-03-13,40,Current,0,0,0
2025-03-13,40,DPD15-29,15,14,1
2025-03-13,40,DPD3-14,13,13,0
2025-03-13,40,DPD30-59,4,4,0
2025-03-13,40,DPD60-89,0,0,0
2025-03-13,40,DPD90+,0,0,0
2025-03-13,42,Current,0,0,0
2025-03-13,42,DPD15-29,7,7,0
2025-03-13,42,DPD3-14,3,3,0
2025-03-13,42,DPD30-59,7,7,0
2025-03-13,42,DPD60-89,0,0,0
2025-03-13,42,DPD90+,0,0,0
2025-03-13,44,Current,0,0,0
2025-03-13,44,DPD15-29,20,20,0
2025-03-13,44,DPD3-14,12,12,0
2025-03-13,44,DPD30-59,14,14,0
2025-03-13,44,DPD60-89,0,0,0
2025-03-13,44,DPD90+,0,0,0
2025-03-13,46,Current,0,0,0
2025-03-13,46,DPD3-14,2,2,0
2025-03-13,48,Current,28,28,0
2025-03-13,48,DPD15-29,30,30,0
2025-03-13,48,DPD3-14,19,19,0
2025-03-13,48,DPD30-59,24,24,0
2025-03-13,48,DPD60-89,0,0,0
2025-03-13,48,DPD90+,0,0,0
2025-03-13,6,Current,0,0,0
2025-03-12,100,Current,0,0,0
2025-03-12,100,DPD3-14,0,0,0
2025-03-12,100,DPD30-59,0,0,0
2025-03-12,102,Current,0,0,0
2025-03-12,102,DPD15-29,1,1,0
2025-03-12,102,DPD3-14,0,0,0
2025-03-12,104,Current,0,0,0
2025-03-12,20,Current,2,2,0
2025-03-12,20,DPD15-29,176,176,0
2025-03-12,20,DPD3-14,134,134,0
2025-03-12,20,DPD30-59,145,145,0
2025-03-12,20,DPD60-89,0,0,0
2025-03-12,20,DPD90+,1,1,0
2025-03-12,22,Current,0,0,0
2025-03-12,22,DPD15-29,0,0,0
2025-03-12,22,DPD3-14,0,0,0
2025-03-12,24,Current,74,74,0
2025-03-12,24,DPD15-29,105,105,0
2025-03-12,24,DPD3-14,65,65,0
2025-03-12,24,DPD30-59,81,81,0
2025-03-12,24,DPD60-89,0,0,0
2025-03-12,24,DPD90+,0,0,0
2025-03-12,26,Current,0,0,0
2025-03-12,26,DPD15-29,7,7,0
2025-03-12,26,DPD3-14,6,6,0
2025-03-12,26,DPD30-59,3,3,0
2025-03-12,26,DPD60-89,0,0,0
2025-03-12,26,DPD90+,0,0,0
2025-03-12,32,Current,0,0,0
2025-03-12,32,DPD15-29,102,102,0
2025-03-12,32,DPD3-14,56,56,0
2025-03-12,32,DPD30-59,64,64,0
2025-03-12,32,DPD60-89,0,0,0
2025-03-12,32,DPD90+,0,0,0
2025-03-12,34,Current,1,1,0
2025-03-12,34,DPD15-29,31,31,0
2025-03-12,34,DPD3-14,25,25,0
2025-03-12,34,DPD30-59,25,25,0
2025-03-12,34,DPD60-89,0,0,0
2025-03-12,34,DPD90+,0,0,0
2025-03-12,36,Current,1,1,0
2025-03-12,36,DPD15-29,21,21,0
2025-03-12,36,DPD3-14,11,11,0
2025-03-12,36,DPD30-59,15,15,0
2025-03-12,36,DPD60-89,0,0,0
2025-03-12,36,DPD90+,0,0,0
2025-03-12,38,Current,12,12,0
2025-03-12,38,DPD15-29,22,22,0
2025-03-12,38,DPD3-14,23,23,0
2025-03-12,38,DPD30-59,24,24,0
2025-03-12,38,DPD60-89,0,0,0
2025-03-12,38,DPD90+,0,0,0
2025-03-12,40,Current,0,0,0
2025-03-12,40,DPD15-29,16,16,0
2025-03-12,40,DPD3-14,15,15,0
2025-03-12,40,DPD30-59,10,10,0
2025-03-12,40,DPD60-89,0,0,0
2025-03-12,40,DPD90+,0,0,0
2025-03-12,42,Current,0,0,0
2025-03-12,42,DPD15-29,8,8,0
2025-03-12,42,DPD3-14,4,4,0
2025-03-12,42,DPD30-59,5,5,0
2025-03-12,42,DPD60-89,0,0,0
2025-03-12,42,DPD90+,0,0,0
2025-03-12,44,Current,0,0,0
2025-03-12,44,DPD15-29,25,25,0
2025-03-12,44,DPD3-14,30,30,0
2025-03-12,44,DPD30-59,19,19,0
2025-03-12,44,DPD60-89,0,0,0
2025-03-12,44,DPD90+,0,0,0
2025-03-12,46,Current,0,0,0
2025-03-12,46,DPD3-14,1,1,0
2025-03-12,48,Current,34,34,0
2025-03-12,48,DPD15-29,26,26,0
2025-03-12,48,DPD3-14,22,22,0
2025-03-12,48,DPD30-59,18,18,0
2025-03-12,48,DPD60-89,0,0,0
2025-03-12,48,DPD90+,0,0,0
2025-03-12,6,Current,0,0,0
2025-03-11,100,Current,0,0,0
2025-03-11,100,DPD3-14,0,0,0
2025-03-11,100,DPD30-59,0,0,0
2025-03-11,102,Current,0,0,0
2025-03-11,102,DPD15-29,0,0,0
2025-03-11,102,DPD3-14,0,0,0
2025-03-11,104,Current,0,0,0
2025-03-11,20,Current,0,0,0
2025-03-11,20,DPD15-29,174,174,0
2025-03-11,20,DPD3-14,179,179,0
2025-03-11,20,DPD30-59,108,108,0
2025-03-11,20,DPD60-89,0,0,0
2025-03-11,20,DPD90+,0,0,0
2025-03-11,22,Current,0,0,0
2025-03-11,22,DPD15-29,0,0,0
2025-03-11,22,DPD3-14,0,0,0
2025-03-11,24,Current,70,70,0
2025-03-11,24,DPD15-29,124,124,0
2025-03-11,24,DPD3-14,98,98,0
2025-03-11,24,DPD30-59,57,57,0
2025-03-11,24,DPD60-89,0,0,0
2025-03-11,24,DPD90+,0,0,0
2025-03-11,26,Current,0,0,0
2025-03-11,26,DPD15-29,16,16,0
2025-03-11,26,DPD3-14,20,20,0
2025-03-11,26,DPD30-59,3,3,0
2025-03-11,26,DPD60-89,0,0,0
2025-03-11,26,DPD90+,0,0,0
2025-03-11,32,Current,2,2,0
2025-03-11,32,DPD15-29,89,89,0
2025-03-11,32,DPD3-14,82,82,0
2025-03-11,32,DPD30-59,44,44,0
2025-03-11,32,DPD60-89,0,0,0
2025-03-11,32,DPD90+,0,0,0
2025-03-11,34,Current,0,0,0
2025-03-11,34,DPD15-29,29,29,0
2025-03-11,34,DPD3-14,29,29,0
2025-03-11,34,DPD30-59,27,27,0
2025-03-11,34,DPD60-89,0,0,0
2025-03-11,34,DPD90+,0,0,0
2025-03-11,36,Current,0,0,0
2025-03-11,36,DPD15-29,22,22,0
2025-03-11,36,DPD3-14,17,17,0
2025-03-11,36,DPD30-59,16,16,0
2025-03-11,36,DPD60-89,0,0,0
2025-03-11,36,DPD90+,0,0,0
2025-03-11,38,Current,17,17,0
2025-03-11,38,DPD15-29,33,33,0
2025-03-11,38,DPD3-14,33,33,0
2025-03-11,38,DPD30-59,14,14,0
2025-03-11,38,DPD60-89,0,0,0
2025-03-11,38,DPD90+,0,0,0
2025-03-11,40,Current,0,0,0
2025-03-11,40,DPD15-29,12,11,1
2025-03-11,40,DPD3-14,12,12,0
2025-03-11,40,DPD30-59,6,6,0
2025-03-11,40,DPD60-89,0,0,0
2025-03-11,40,DPD90+,0,0,0
2025-03-11,42,Current,0,0,0
2025-03-11,42,DPD15-29,8,8,0
2025-03-11,42,DPD3-14,6,6,0
2025-03-11,42,DPD30-59,7,7,0
2025-03-11,42,DPD60-89,0,0,0
2025-03-11,42,DPD90+,0,0,0
2025-03-11,44,Current,12,12,0
2025-03-11,44,DPD15-29,19,19,0
2025-03-11,44,DPD3-14,22,22,0
2025-03-11,44,DPD30-59,14,14,0
2025-03-11,44,DPD60-89,0,0,0
2025-03-11,44,DPD90+,0,0,0
2025-03-11,46,Current,0,0,0
2025-03-11,46,DPD3-14,1,1,0
2025-03-11,48,Current,51,51,0
2025-03-11,48,DPD15-29,32,32,0
2025-03-11,48,DPD3-14,37,37,0
2025-03-11,48,DPD30-59,24,24,0
2025-03-11,48,DPD60-89,0,0,0
2025-03-11,48,DPD90+,0,0,0
2025-03-11,6,Current,0,0,0
2025-03-10,100,Current,0,0,0
2025-03-10,100,DPD3-14,0,0,0
2025-03-10,100,DPD30-59,0,0,0
2025-03-10,102,Current,0,0,0
2025-03-10,102,DPD3-14,0,0,0
2025-03-10,104,Current,0,0,0
2025-03-10,20,Current,0,0,0
2025-03-10,20,DPD15-29,181,181,0
2025-03-10,20,DPD3-14,86,86,0
2025-03-10,20,DPD30-59,142,142,0
2025-03-10,20,DPD60-89,0,0,0
2025-03-10,20,DPD90+,0,0,0
2025-03-10,22,Current,0,0,0
2025-03-10,22,DPD15-29,0,0,0
2025-03-10,22,DPD3-14,1,1,0
2025-03-10,24,Current,114,113,1
2025-03-10,24,DPD15-29,112,112,0
2025-03-10,24,DPD3-14,66,66,0
2025-03-10,24,DPD30-59,89,89,0
2025-03-10,24,DPD60-89,0,0,0
2025-03-10,24,DPD90+,0,0,0
2025-03-10,26,Current,0,0,0
2025-03-10,26,DPD15-29,5,5,0
2025-03-10,26,DPD3-14,10,10,0
2025-03-10,26,DPD30-59,3,3,0
2025-03-10,26,DPD60-89,0,0,0
2025-03-10,26,DPD90+,0,0,0
2025-03-10,32,Current,1,1,0
2025-03-10,32,DPD15-29,93,93,0
2025-03-10,32,DPD3-14,48,48,0
2025-03-10,32,DPD30-59,69,69,0
2025-03-10,32,DPD60-89,0,0,0
2025-03-10,32,DPD90+,0,0,0
2025-03-10,34,Current,0,0,0
2025-03-10,34,DPD15-29,29,29,0
2025-03-10,34,DPD3-14,22,22,0
2025-03-10,34,DPD30-59,27,27,0
2025-03-10,34,DPD60-89,0,0,0
2025-03-10,34,DPD90+,0,0,0
2025-03-10,36,Current,0,0,0
2025-03-10,36,DPD15-29,21,21,0
2025-03-10,36,DPD3-14,11,11,0
2025-03-10,36,DPD30-59,15,15,0
2025-03-10,36,DPD60-89,0,0,0
2025-03-10,36,DPD90+,0,0,0
2025-03-10,38,Current,20,19,1
2025-03-10,38,DPD15-29,17,17,0
2025-03-10,38,DPD3-14,22,22,0
2025-03-10,38,DPD30-59,26,26,0
2025-03-10,38,DPD60-89,0,0,0
2025-03-10,38,DPD90+,0,0,0
2025-03-10,40,Current,0,0,0
2025-03-10,40,DPD15-29,18,18,0
2025-03-10,40,DPD3-14,10,10,0
2025-03-10,40,DPD30-59,10,10,0
2025-03-10,40,DPD60-89,0,0,0
2025-03-10,40,DPD90+,0,0,0
2025-03-10,42,Current,0,0,0
2025-03-10,42,DPD15-29,6,6,0
2025-03-10,42,DPD3-14,1,1,0
2025-03-10,42,DPD30-59,5,5,0
2025-03-10,42,DPD60-89,0,0,0
2025-03-10,42,DPD90+,0,0,0
2025-03-10,44,Current,11,11,0
2025-03-10,44,DPD15-29,25,25,0
2025-03-10,44,DPD3-14,13,13,0
2025-03-10,44,DPD30-59,18,18,0
2025-03-10,44,DPD60-89,0,0,0
2025-03-10,44,DPD90+,0,0,0
2025-03-10,46,Current,0,0,0
2025-03-10,46,DPD3-14,0,0,0
2025-03-10,48,Current,72,72,0
2025-03-10,48,DPD15-29,29,29,0
2025-03-10,48,DPD3-14,27,27,0
2025-03-10,48,DPD30-59,20,20,0
2025-03-10,48,DPD60-89,0,0,0
2025-03-10,48,DPD90+,0,0,0
2025-03-10,6,Current,0,0,0
2025-03-09,100,Current,0,0,0
2025-03-09,100,DPD3-14,0,0,0
2025-03-09,100,DPD30-59,0,0,0
2025-03-09,102,Current,0,0,0
2025-03-09,102,DPD3-14,0,0,0
2025-03-09,104,Current,0,0,0
2025-03-09,20,Current,1,1,0
2025-03-09,20,DPD15-29,157,157,0
2025-03-09,20,DPD3-14,94,93,1
2025-03-09,20,DPD30-59,116,116,0
2025-03-09,20,DPD60-89,0,0,0
2025-03-09,20,DPD90+,0,0,0
2025-03-09,22,Current,0,0,0
2025-03-09,22,DPD15-29,0,0,0
2025-03-09,22,DPD3-14,0,0,0
2025-03-09,24,Current,41,41,0
2025-03-09,24,DPD15-29,108,108,0
2025-03-09,24,DPD3-14,66,66,0
2025-03-09,24,DPD30-59,64,64,0
2025-03-09,24,DPD60-89,0,0,0
2025-03-09,24,DPD90+,0,0,0
2025-03-09,26,Current,0,0,0
2025-03-09,26,DPD15-29,13,13,0
2025-03-09,26,DPD3-14,14,13,1
2025-03-09,26,DPD30-59,5,5,0
2025-03-09,26,DPD60-89,0,0,0
2025-03-09,26,DPD90+,0,0,0
2025-03-09,32,Current,0,0,0
2025-03-09,32,DPD15-29,81,81,0
2025-03-09,32,DPD3-14,38,38,0
2025-03-09,32,DPD30-59,48,48,0
2025-03-09,32,DPD60-89,0,0,0
2025-03-09,32,DPD90+,0,0,0
2025-03-09,34,Current,1,1,0
2025-03-09,34,DPD15-29,28,28,0
2025-03-09,34,DPD3-14,10,10,0
2025-03-09,34,DPD30-59,28,28,0
2025-03-09,34,DPD60-89,0,0,0
2025-03-09,34,DPD90+,0,0,0
2025-03-09,36,Current,0,0,0
2025-03-09,36,DPD15-29,22,22,0
2025-03-09,36,DPD3-14,9,9,0
2025-03-09,36,DPD30-59,16,16,0
2025-03-09,36,DPD60-89,0,0,0
2025-03-09,36,DPD90+,0,0,0
2025-03-09,38,Current,11,11,0
2025-03-09,38,DPD15-29,31,31,0
2025-03-09,38,DPD3-14,13,13,0
2025-03-09,38,DPD30-59,15,15,0
2025-03-09,38,DPD60-89,0,0,0
2025-03-09,38,DPD90+,0,0,0
2025-03-09,40,Current,0,0,0
2025-03-09,40,DPD15-29,10,10,0
2025-03-09,40,DPD3-14,6,6,0
2025-03-09,40,DPD30-59,10,10,0
2025-03-09,40,DPD60-89,0,0,0
2025-03-09,40,DPD90+,0,0,0
2025-03-09,42,Current,0,0,0
2025-03-09,42,DPD15-29,8,8,0
2025-03-09,42,DPD3-14,6,6,0
2025-03-09,42,DPD30-59,7,7,0
2025-03-09,42,DPD60-89,0,0,0
2025-03-09,42,DPD90+,0,0,0
2025-03-09,44,Current,8,8,0
2025-03-09,44,DPD15-29,17,17,0
2025-03-09,44,DPD3-14,11,11,0
2025-03-09,44,DPD30-59,16,16,0
2025-03-09,44,DPD60-89,0,0,0
2025-03-09,44,DPD90+,0,0,0
2025-03-09,46,Current,0,0,0
2025-03-09,46,DPD3-14,0,0,0
2025-03-09,48,Current,26,26,0
2025-03-09,48,DPD15-29,33,33,0
2025-03-09,48,DPD3-14,29,29,0
2025-03-09,48,DPD30-59,28,28,0
2025-03-09,48,DPD60-89,0,0,0
2025-03-09,48,DPD90+,0,0,0
2025-03-09,6,Current,0,0,0
2025-03-08,100,Current,0,0,0
2025-03-08,100,DPD3-14,0,0,0
2025-03-08,100,DPD30-59,0,0,0
2025-03-08,102,Current,0,0,0
2025-03-08,102,DPD3-14,0,0,0
2025-03-08,104,Current,0,0,0
2025-03-08,20,Current,0,0,0
2025-03-08,20,DPD15-29,166,166,0
2025-03-08,20,DPD3-14,85,85,0
2025-03-08,20,DPD30-59,103,103,0
2025-03-08,20,DPD60-89,0,0,0
2025-03-08,20,DPD90+,0,0,0
2025-03-08,22,Current,0,0,0
2025-03-08,22,DPD15-29,0,0,0
2025-03-08,22,DPD3-14,0,0,0
2025-03-08,24,Current,37,37,0
2025-03-08,24,DPD15-29,109,109,0
2025-03-08,24,DPD3-14,72,72,0
2025-03-08,24,DPD30-59,71,71,0
2025-03-08,24,DPD60-89,0,0,0
2025-03-08,24,DPD90+,0,0,0
2025-03-08,26,Current,0,0,0
2025-03-08,26,DPD15-29,4,4,0
2025-03-08,26,DPD3-14,4,4,0
2025-03-08,26,DPD30-59,1,1,0
2025-03-08,26,DPD60-89,0,0,0
2025-03-08,26,DPD90+,0,0,0
2025-03-08,32,Current,0,0,0
2025-03-08,32,DPD15-29,84,84,0
2025-03-08,32,DPD3-14,42,42,0
2025-03-08,32,DPD30-59,58,58,0
2025-03-08,32,DPD60-89,0,0,0
2025-03-08,32,DPD90+,0,0,0
2025-03-08,34,Current,0,0,0
2025-03-08,34,DPD15-29,31,31,0
2025-03-08,34,DPD3-14,16,16,0
2025-03-08,34,DPD30-59,22,22,0
2025-03-08,34,DPD60-89,0,0,0
2025-03-08,34,DPD90+,0,0,0
2025-03-08,36,Current,0,0,0
2025-03-08,36,DPD15-29,17,17,0
2025-03-08,36,DPD3-14,14,14,0
2025-03-08,36,DPD30-59,10,10,0
2025-03-08,36,DPD60-89,0,0,0
2025-03-08,36,DPD90+,0,0,0
2025-03-08,38,Current,7,7,0
2025-03-08,38,DPD15-29,13,13,0
2025-03-08,38,DPD3-14,19,19,0
2025-03-08,38,DPD30-59,19,19,0
2025-03-08,38,DPD60-89,0,0,0
2025-03-08,38,DPD90+,0,0,0
2025-03-08,40,Current,0,0,0
2025-03-08,40,DPD15-29,17,17,0
2025-03-08,40,DPD3-14,10,10,0
2025-03-08,40,DPD30-59,6,6,0
2025-03-08,40,DPD60-89,0,0,0
2025-03-08,40,DPD90+,0,0,0
2025-03-08,42,Current,0,0,0
2025-03-08,42,DPD15-29,5,5,0
2025-03-08,42,DPD3-14,1,1,0
2025-03-08,42,DPD30-59,4,4,0
2025-03-08,42,DPD60-89,0,0,0
2025-03-08,42,DPD90+,0,0,0
2025-03-08,44,Current,2,2,0
2025-03-08,44,DPD15-29,25,25,0
2025-03-08,44,DPD3-14,11,11,0
2025-03-08,44,DPD30-59,14,14,0
2025-03-08,44,DPD60-89,0,0,0
2025-03-08,44,DPD90+,0,0,0
2025-03-08,46,Current,0,0,0
2025-03-08,46,DPD3-14,0,0,0
2025-03-08,48,Current,31,31,0
2025-03-08,48,DPD15-29,33,33,0
2025-03-08,48,DPD3-14,16,16,0
2025-03-08,48,DPD30-59,15,15,0
2025-03-08,48,DPD60-89,0,0,0
2025-03-08,48,DPD90+,0,0,0
2025-03-08,6,Current,0,0,0
2025-03-07,100,Current,0,0,0
2025-03-07,100,DPD3-14,0,0,0
2025-03-07,100,DPD30-59,0,0,0
2025-03-07,102,Current,0,0,0
2025-03-07,102,DPD3-14,1,1,0
2025-03-07,104,Current,0,0,0
2025-03-07,20,Current,1,1,0
2025-03-07,20,DPD15-29,152,152,0
2025-03-07,20,DPD3-14,158,158,0
2025-03-07,20,DPD30-59,117,117,0
2025-03-07,20,DPD60-89,0,0,0
2025-03-07,20,DPD90+,0,0,0
2025-03-07,22,Current,0,0,0
2025-03-07,22,DPD15-29,0,0,0
2025-03-07,22,DPD3-14,0,0,0
2025-03-07,24,Current,79,79,0
2025-03-07,24,DPD15-29,103,103,0
2025-03-07,24,DPD3-14,80,80,0
2025-03-07,24,DPD30-59,64,64,0
2025-03-07,24,DPD60-89,0,0,0
2025-03-07,24,DPD90+,0,0,0
2025-03-07,26,Current,0,0,0
2025-03-07,26,DPD15-29,14,14,0
2025-03-07,26,DPD3-14,14,13,1
2025-03-07,26,DPD30-59,5,5,0
2025-03-07,26,DPD60-89,0,0,0
2025-03-07,26,DPD90+,0,0,0
2025-03-07,32,Current,0,0,0
2025-03-07,32,DPD15-29,69,69,0
2025-03-07,32,DPD3-14,75,75,0
2025-03-07,32,DPD30-59,49,49,0
2025-03-07,32,DPD60-89,0,0,0
2025-03-07,32,DPD90+,0,0,0
2025-03-07,34,Current,0,0,0
2025-03-07,34,DPD15-29,29,29,0
2025-03-07,34,DPD3-14,22,22,0
2025-03-07,34,DPD30-59,25,25,0
2025-03-07,34,DPD60-89,0,0,0
2025-03-07,34,DPD90+,0,0,0
2025-03-07,36,Current,0,0,0
2025-03-07,36,DPD15-29,15,15,0
2025-03-07,36,DPD3-14,15,15,0
2025-03-07,36,DPD30-59,18,18,0
2025-03-07,36,DPD60-89,0,0,0
2025-03-07,36,DPD90+,0,0,0
2025-03-07,38,Current,16,16,0
2025-03-07,38,DPD15-29,25,25,0
2025-03-07,38,DPD3-14,22,22,0
2025-03-07,38,DPD30-59,20,20,0
2025-03-07,38,DPD60-89,0,0,0
2025-03-07,38,DPD90+,0,0,0
2025-03-07,40,Current,0,0,0
2025-03-07,40,DPD15-29,12,12,0
2025-03-07,40,DPD3-14,14,14,0
2025-03-07,40,DPD30-59,11,11,0
2025-03-07,40,DPD60-89,0,0,0
2025-03-07,40,DPD90+,0,0,0
2025-03-07,42,Current,0,0,0
2025-03-07,42,DPD15-29,9,9,0
2025-03-07,42,DPD3-14,5,5,0
2025-03-07,42,DPD30-59,7,7,0
2025-03-07,42,DPD60-89,0,0,0
2025-03-07,42,DPD90+,0,0,0
2025-03-07,44,Current,14,14,0
2025-03-07,44,DPD15-29,22,22,0
2025-03-07,44,DPD3-14,27,27,0
2025-03-07,44,DPD30-59,18,18,0
2025-03-07,44,DPD60-89,0,0,0
2025-03-07,44,DPD90+,0,0,0
2025-03-07,46,Current,0,0,0
2025-03-07,46,DPD3-14,1,1,0
2025-03-07,48,Current,37,37,0
2025-03-07,48,DPD15-29,35,34,1
2025-03-07,48,DPD3-14,11,11,0
2025-03-07,48,DPD30-59,25,25,0
2025-03-07,48,DPD60-89,0,0,0
2025-03-07,48,DPD90+,0,0,0
2025-03-07,6,Current,0,0,0
2025-03-06,100,Current,0,0,0
2025-03-06,100,DPD15-29,0,0,0
2025-03-06,100,DPD3-14,0,0,0
2025-03-06,102,Current,0,0,0
2025-03-06,102,DPD3-14,0,0,0
2025-03-06,104,Current,0,0,0
2025-03-06,20,Current,3,3,0
2025-03-06,20,DPD15-29,142,142,0
2025-03-06,20,DPD3-14,195,195,0
2025-03-06,20,DPD30-59,101,101,0
2025-03-06,20,DPD60-89,0,0,0
2025-03-06,20,DPD90+,0,0,0
2025-03-06,22,Current,0,0,0
2025-03-06,22,DPD15-29,0,0,0
2025-03-06,22,DPD3-14,0,0,0
2025-03-06,24,Current,65,65,0
2025-03-06,24,DPD15-29,94,94,0
2025-03-06,24,DPD3-14,133,133,0
2025-03-06,24,DPD30-59,71,71,0
2025-03-06,24,DPD60-89,0,0,0
2025-03-06,24,DPD90+,0,0,0
2025-03-06,26,Current,0,0,0
2025-03-06,26,DPD15-29,8,8,0
2025-03-06,26,DPD3-14,15,15,0
2025-03-06,26,DPD30-59,1,1,0
2025-03-06,26,DPD60-89,0,0,0
2025-03-06,26,DPD90+,0,0,0
2025-03-06,32,Current,1,1,0
2025-03-06,32,DPD15-29,66,66,0
2025-03-06,32,DPD3-14,96,96,0
2025-03-06,32,DPD30-59,59,59,0
2025-03-06,32,DPD60-89,1,1,0
2025-03-06,32,DPD90+,0,0,0
2025-03-06,34,Current,0,0,0
2025-03-06,34,DPD15-29,24,24,0
2025-03-06,34,DPD3-14,32,32,0
2025-03-06,34,DPD30-59,19,19,0
2025-03-06,34,DPD60-89,0,0,0
2025-03-06,34,DPD90+,0,0,0
2025-03-06,36,Current,0,0,0
2025-03-06,36,DPD15-29,10,10,0
2025-03-06,36,DPD3-14,23,23,0
2025-03-06,36,DPD30-59,12,12,0
2025-03-06,36,DPD60-89,0,0,0
2025-03-06,36,DPD90+,0,0,0
2025-03-06,38,Current,13,13,0
2025-03-06,38,DPD15-29,9,9,0
2025-03-06,38,DPD3-14,35,35,0
2025-03-06,38,DPD30-59,21,21,0
2025-03-06,38,DPD60-89,0,0,0
2025-03-06,38,DPD90+,0,0,0
2025-03-06,40,Current,0,0,0
2025-03-06,40,DPD15-29,16,16,0
2025-03-06,40,DPD3-14,15,14,1
2025-03-06,40,DPD30-59,9,9,0
2025-03-06,40,DPD60-89,0,0,0
2025-03-06,40,DPD90+,0,0,0
2025-03-06,42,Current,1,1,0
2025-03-06,42,DPD15-29,3,3,0
2025-03-06,42,DPD3-14,7,7,0
2025-03-06,42,DPD30-59,5,5,0
2025-03-06,42,DPD60-89,0,0,0
2025-03-06,42,DPD90+,0,0,0
2025-03-06,44,Current,14,14,0
2025-03-06,44,DPD15-29,22,22,0
2025-03-06,44,DPD3-14,19,19,0
2025-03-06,44,DPD30-59,12,12,0
2025-03-06,44,DPD60-89,0,0,0
2025-03-06,44,DPD90+,0,0,0
2025-03-06,46,Current,0,0,0
2025-03-06,46,DPD3-14,0,0,0
2025-03-06,48,Current,41,41,0
2025-03-06,48,DPD15-29,34,34,0
2025-03-06,48,DPD3-14,38,38,0
2025-03-06,48,DPD30-59,15,15,0
2025-03-06,48,DPD60-89,0,0,0
2025-03-06,48,DPD90+,0,0,0
2025-03-06,6,Current,0,0,0
2025-03-05,100,Current,0,0,0
2025-03-05,100,DPD15-29,1,1,0
2025-03-05,102,Current,0,0,0
2025-03-05,102,DPD3-14,0,0,0
2025-03-05,104,Current,0,0,0
2025-03-05,20,Current,1,1,0
2025-03-05,20,DPD15-29,166,166,0
2025-03-05,20,DPD3-14,179,179,0
2025-03-05,20,DPD30-59,130,130,0
2025-03-05,20,DPD60-89,0,0,0
2025-03-05,20,DPD90+,0,0,0
2025-03-05,22,Current,0,0,0
2025-03-05,22,DPD3-14,1,1,0
2025-03-05,24,Current,86,85,1
2025-03-05,24,DPD15-29,106,106,0
2025-03-05,24,DPD3-14,96,96,0
2025-03-05,24,DPD30-59,89,89,0
2025-03-05,24,DPD60-89,0,0,0
2025-03-05,24,DPD90+,0,0,0
2025-03-05,26,Current,0,0,0
2025-03-05,26,DPD15-29,15,15,0
2025-03-05,26,DPD3-14,14,14,0
2025-03-05,26,DPD30-59,5,5,0
2025-03-05,26,DPD60-89,0,0,0
2025-03-05,26,DPD90+,0,0,0
2025-03-05,32,Current,0,0,0
2025-03-05,32,DPD15-29,76,76,0
2025-03-05,32,DPD3-14,83,83,0
2025-03-05,32,DPD30-59,57,57,0
2025-03-05,32,DPD60-89,0,0,0
2025-03-05,32,DPD90+,0,0,0
2025-03-05,34,Current,0,0,0
2025-03-05,34,DPD15-29,29,29,0
2025-03-05,34,DPD3-14,22,22,0
2025-03-05,34,DPD30-59,29,29,0
2025-03-05,34,DPD60-89,0,0,0
2025-03-05,34,DPD90+,0,0,0
2025-03-05,36,Current,0,0,0
2025-03-05,36,DPD15-29,15,15,0
2025-03-05,36,DPD3-14,24,24,0
2025-03-05,36,DPD30-59,21,21,0
2025-03-05,36,DPD60-89,0,0,0
2025-03-05,36,DPD90+,0,0,0
2025-03-05,38,Current,12,11,1
2025-03-05,38,DPD15-29,24,24,0
2025-03-05,38,DPD3-14,26,26,0
2025-03-05,38,DPD30-59,24,24,0
2025-03-05,38,DPD60-89,0,0,0
2025-03-05,38,DPD90+,0,0,0
2025-03-05,40,Current,0,0,0
2025-03-05,40,DPD15-29,15,15,0
2025-03-05,40,DPD3-14,16,16,0
2025-03-05,40,DPD30-59,11,11,0
2025-03-05,40,DPD60-89,0,0,0
2025-03-05,40,DPD90+,0,0,0
2025-03-05,42,Current,0,0,0
2025-03-05,42,DPD15-29,9,9,0
2025-03-05,42,DPD3-14,6,6,0
2025-03-05,42,DPD30-59,9,9,0
2025-03-05,42,DPD60-89,0,0,0
2025-03-05,42,DPD90+,0,0,0
2025-03-05,44,Current,7,7,0
2025-03-05,44,DPD15-29,21,21,0
2025-03-05,44,DPD3-14,28,28,0
2025-03-05,44,DPD30-59,17,17,0
2025-03-05,44,DPD60-89,0,0,0
2025-03-05,44,DPD90+,0,0,0
2025-03-05,46,Current,0,0,0
2025-03-05,46,DPD3-14,1,1,0
2025-03-05,48,Current,22,22,0
2025-03-05,48,DPD15-29,42,41,1
2025-03-05,48,DPD3-14,26,26,0
2025-03-05,48,DPD30-59,28,28,0
2025-03-05,48,DPD60-89,0,0,0
2025-03-05,48,DPD90+,0,0,0
2025-03-05,6,Current,0,0,0
2025-03-04,100,Current,0,0,0
2025-03-04,100,DPD15-29,0,0,0
2025-03-04,102,Current,0,0,0
2025-03-04,102,DPD15-29,0,0,0
2025-03-04,102,DPD3-14,0,0,0
2025-03-04,104,Current,0,0,0
2025-03-04,20,Current,0,0,0
2025-03-04,20,DPD15-29,110,110,0
2025-03-04,20,DPD3-14,217,216,1
2025-03-04,20,DPD30-59,67,67,0
2025-03-04,20,DPD60-89,0,0,0
2025-03-04,20,DPD90+,0,0,0
2025-03-04,22,Current,0,0,0
2025-03-04,22,DPD3-14,0,0,0
2025-03-04,24,Current,87,87,0
2025-03-04,24,DPD15-29,73,73,0
2025-03-04,24,DPD3-14,129,129,0
2025-03-04,24,DPD30-59,42,42,0
2025-03-04,24,DPD60-89,0,0,0
2025-03-04,24,DPD90+,0,0,0
2025-03-04,26,Current,0,0,0
2025-03-04,26,DPD15-29,6,6,0
2025-03-04,26,DPD3-14,19,19,0
2025-03-04,26,DPD30-59,0,0,0
2025-03-04,26,DPD60-89,0,0,0
2025-03-04,26,DPD90+,0,0,0
2025-03-04,32,Current,0,0,0
2025-03-04,32,DPD15-29,53,53,0
2025-03-04,32,DPD3-14,98,98,0
2025-03-04,32,DPD30-59,37,37,0
2025-03-04,32,DPD60-89,0,0,0
2025-03-04,32,DPD90+,0,0,0
2025-03-04,34,Current,0,0,0
2025-03-04,34,DPD15-29,20,20,0
2025-03-04,34,DPD3-14,35,35,0
2025-03-04,34,DPD30-59,9,9,0
2025-03-04,34,DPD60-89,0,0,0
2025-03-04,34,DPD90+,0,0,0
2025-03-04,36,Current,0,0,0
2025-03-04,36,DPD15-29,9,9,0
2025-03-04,36,DPD3-14,35,35,0
2025-03-04,36,DPD30-59,10,10,0
2025-03-04,36,DPD60-89,0,0,0
2025-03-04,36,DPD90+,0,0,0
2025-03-04,38,Current,8,8,0
2025-03-04,38,DPD15-29,11,11,0
2025-03-04,38,DPD3-14,29,29,0
2025-03-04,38,DPD30-59,14,14,0
2025-03-04,38,DPD60-89,0,0,0
2025-03-04,38,DPD90+,0,0,0
2025-03-04,40,Current,0,0,0
2025-03-04,40,DPD15-29,14,14,0
2025-03-04,40,DPD3-14,14,14,0
2025-03-04,40,DPD30-59,11,11,0
2025-03-04,40,DPD60-89,0,0,0
2025-03-04,40,DPD90+,0,0,0
2025-03-04,42,Current,0,0,0
2025-03-04,42,DPD15-29,2,2,0
2025-03-04,42,DPD3-14,9,9,0
2025-03-04,42,DPD30-59,1,1,0
2025-03-04,42,DPD60-89,0,0,0
2025-03-04,42,DPD90+,0,0,0
2025-03-04,44,Current,14,14,0
2025-03-04,44,DPD15-29,19,19,0
2025-03-04,44,DPD3-14,22,22,0
2025-03-04,44,DPD30-59,8,8,0
2025-03-04,44,DPD60-89,0,0,0
2025-03-04,44,DPD90+,0,0,0
2025-03-04,46,Current,0,0,0
2025-03-04,46,DPD3-14,0,0,0
2025-03-04,48,Current,26,26,0
2025-03-04,48,DPD15-29,29,29,0
2025-03-04,48,DPD3-14,38,38,0
2025-03-04,48,DPD30-59,14,14,0
2025-03-04,48,DPD60-89,0,0,0
2025-03-04,48,DPD90+,0,0,0
2025-03-04,6,Current,0,0,0
2025-03-03,100,Current,0,0,0
2025-03-03,100,DPD15-29,1,1,0
2025-03-03,102,Current,0,0,0
2025-03-03,102,DPD15-29,0,0,0
2025-03-03,102,DPD3-14,0,0,0
2025-03-03,104,Current,0,0,0
2025-03-03,20,Current,0,0,0
2025-03-03,20,DPD15-29,178,178,0
2025-03-03,20,DPD3-14,176,176,0
2025-03-03,20,DPD30-59,149,149,0
2025-03-03,20,DPD60-89,0,0,0
2025-03-03,20,DPD90+,0,0,0
2025-03-03,22,DPD3-14,1,1,0
2025-03-03,24,Current,115,115,0
2025-03-03,24,DPD15-29,109,109,0
2025-03-03,24,DPD3-14,107,107,0
2025-03-03,24,DPD30-59,88,88,0
2025-03-03,24,DPD60-89,0,0,0
2025-03-03,24,DPD90+,0,0,0
2025-03-03,26,Current,0,0,0
2025-03-03,26,DPD15-29,16,16,0
2025-03-03,26,DPD3-14,11,11,0
2025-03-03,26,DPD30-59,3,3,0
2025-03-03,26,DPD60-89,0,0,0
2025-03-03,26,DPD90+,0,0,0
2025-03-03,32,Current,1,1,0
2025-03-03,32,DPD15-29,90,90,0
2025-03-03,32,DPD3-14,88,88,0
2025-03-03,32,DPD30-59,59,59,0
2025-03-03,32,DPD60-89,0,0,0
2025-03-03,32,DPD90+,0,0,0
2025-03-03,34,Current,0,0,0
2025-03-03,34,DPD15-29,33,33,0
2025-03-03,34,DPD3-14,28,28,0
2025-03-03,34,DPD30-59,26,26,0
2025-03-03,34,DPD60-89,0,0,0
2025-03-03,34,DPD90+,0,0,0
2025-03-03,36,Current,0,0,0
2025-03-03,36,DPD15-29,22,22,0
2025-03-03,36,DPD3-14,24,24,0
2025-03-03,36,DPD30-59,23,23,0
2025-03-03,36,DPD60-89,0,0,0
2025-03-03,36,DPD90+,0,0,0
2025-03-03,38,Current,15,15,0
2025-03-03,38,DPD15-29,31,31,0
2025-03-03,38,DPD3-14,32,32,0
2025-03-03,38,DPD30-59,21,21,0
2025-03-03,38,DPD60-89,0,0,0
2025-03-03,38,DPD90+,0,0,0
2025-03-03,40,Current,0,0,0
2025-03-03,40,DPD15-29,16,16,0
2025-03-03,40,DPD3-14,20,20,0
2025-03-03,40,DPD30-59,12,12,0
2025-03-03,40,DPD60-89,0,0,0
2025-03-03,40,DPD90+,0,0,0
2025-03-03,42,Current,0,0,0
2025-03-03,42,DPD15-29,13,13,0
2025-03-03,42,DPD3-14,8,8,0
2025-03-03,42,DPD30-59,8,8,0
2025-03-03,42,DPD60-89,0,0,0
2025-03-03,42,DPD90+,0,0,0
2025-03-03,44,Current,21,21,0
2025-03-03,44,DPD15-29,26,26,0
2025-03-03,44,DPD3-14,24,24,0
2025-03-03,44,DPD30-59,18,18,0
2025-03-03,44,DPD60-89,0,0,0
2025-03-03,44,DPD90+,0,0,0
2025-03-03,46,Current,0,0,0
2025-03-03,48,Current,30,30,0
2025-03-03,48,DPD15-29,36,35,1
2025-03-03,48,DPD3-14,32,32,0
2025-03-03,48,DPD30-59,29,29,0
2025-03-03,48,DPD60-89,0,0,0
2025-03-03,48,DPD90+,0,0,0
2025-03-03,6,Current,0,0,0
2025-03-02,100,Current,0,0,0
2025-03-02,100,DPD15-29,0,0,0
2025-03-02,102,Current,0,0,0
2025-03-02,102,DPD15-29,0,0,0
2025-03-02,102,DPD3-14,1,1,0
2025-03-02,104,Current,0,0,0
2025-03-02,20,Current,0,0,0
2025-03-02,20,DPD15-29,80,79,1
2025-03-02,20,DPD3-14,100,99,1
2025-03-02,20,DPD30-59,71,71,0
2025-03-02,20,DPD60-89,0,0,0
2025-03-02,20,DPD90+,0,0,0
2025-03-02,22,DPD3-14,0,0,0
2025-03-02,24,Current,25,25,0
2025-03-02,24,DPD15-29,54,54,0
2025-03-02,24,DPD3-14,56,56,0
2025-03-02,24,DPD30-59,40,40,0
2025-03-02,24,DPD60-89,0,0,0
2025-03-02,24,DPD90+,0,0,0
2025-03-02,26,Current,0,0,0
2025-03-02,26,DPD15-29,5,5,0
2025-03-02,26,DPD3-14,12,12,0
2025-03-02,26,DPD30-59,1,1,0
2025-03-02,26,DPD60-89,0,0,0
2025-03-02,26,DPD90+,0,0,0
2025-03-02,32,Current,0,0,0
2025-03-02,32,DPD15-29,41,41,0
2025-03-02,32,DPD3-14,46,46,0
2025-03-02,32,DPD30-59,35,35,0
2025-03-02,32,DPD60-89,0,0,0
2025-03-02,32,DPD90+,0,0,0
2025-03-02,34,Current,0,0,0
2025-03-02,34,DPD15-29,12,12,0
2025-03-02,34,DPD3-14,21,21,0
2025-03-02,34,DPD30-59,12,12,0
2025-03-02,34,DPD60-89,0,0,0
2025-03-02,34,DPD90+,0,0,0
2025-03-02,36,Current,0,0,0
2025-03-02,36,DPD15-29,6,6,0
2025-03-02,36,DPD3-14,17,17,0
2025-03-02,36,DPD30-59,8,8,0
2025-03-02,36,DPD60-89,0,0,0
2025-03-02,36,DPD90+,0,0,0
2025-03-02,38,Current,8,8,0
2025-03-02,38,DPD15-29,10,10,0
2025-03-02,38,DPD3-14,15,15,0
2025-03-02,38,DPD30-59,14,14,0
2025-03-02,38,DPD60-89,0,0,0
2025-03-02,38,DPD90+,0,0,0
2025-03-02,40,Current,0,0,0
2025-03-02,40,DPD15-29,11,11,0
2025-03-02,40,DPD3-14,7,7,0
2025-03-02,40,DPD30-59,10,10,0
2025-03-02,40,DPD60-89,0,0,0
2025-03-02,40,DPD90+,0,0,0
2025-03-02,42,Current,0,0,0
2025-03-02,42,DPD15-29,2,2,0
2025-03-02,42,DPD3-14,10,10,0
2025-03-02,42,DPD30-59,1,1,0
2025-03-02,42,DPD60-89,0,0,0
2025-03-02,42,DPD90+,0,0,0
2025-03-02,44,Current,10,10,0
2025-03-02,44,DPD15-29,14,14,0
2025-03-02,44,DPD3-14,17,17,0
2025-03-02,44,DPD30-59,8,8,0
2025-03-02,44,DPD60-89,0,0,0
2025-03-02,44,DPD90+,0,0,0
2025-03-02,46,Current,0,0,0
2025-03-02,48,Current,15,15,0
2025-03-02,48,DPD15-29,24,24,0
2025-03-02,48,DPD3-14,21,21,0
2025-03-02,48,DPD30-59,9,9,0
2025-03-02,48,DPD60-89,0,0,0
2025-03-02,48,DPD90+,0,0,0
2025-03-02,6,Current,0,0,0
2025-03-01,100,Current,0,0,0
2025-03-01,100,DPD15-29,1,1,0
2025-03-01,102,Current,0,0,0
2025-03-01,102,DPD15-29,0,0,0
2025-03-01,102,DPD3-14,0,0,0
2025-03-01,104,Current,0,0,0
2025-03-01,20,Current,3322,3322,0
2025-03-01,20,DPD15-29,165,165,0
2025-03-01,20,DPD3-14,222,222,0
2025-03-01,20,DPD30-59,223,223,0
2025-03-01,20,DPD60-89,47,47,0
2025-03-01,20,DPD90+,36,36,0
2025-03-01,22,Current,0,0,0
2025-03-01,22,DPD3-14,0,0,0
2025-03-01,24,Current,4567,4567,0
2025-03-01,24,DPD15-29,98,98,0
2025-03-01,24,DPD3-14,164,164,0
2025-03-01,24,DPD30-59,140,140,0
2025-03-01,24,DPD60-89,27,27,0
2025-03-01,24,DPD90+,18,18,0
2025-03-01,26,Current,0,0,0
2025-03-01,26,DPD15-29,12,12,0
2025-03-01,26,DPD3-14,6,6,0
2025-03-01,26,DPD30-59,4,4,0
2025-03-01,26,DPD60-89,0,0,0
2025-03-01,26,DPD90+,0,0,0
2025-03-01,32,Current,167,167,0
2025-03-01,32,DPD15-29,64,64,0
2025-03-01,32,DPD3-14,70,69,1
2025-03-01,32,DPD30-59,71,71,0
2025-03-01,32,DPD60-89,2,2,0
2025-03-01,32,DPD90+,0,0,0
2025-03-01,34,Current,0,0,0
2025-03-01,34,DPD15-29,25,25,0
2025-03-01,34,DPD3-14,21,21,0
2025-03-01,34,DPD30-59,29,29,0
2025-03-01,34,DPD60-89,0,0,0
2025-03-01,34,DPD90+,0,0,0
2025-03-01,36,Current,155,155,0
2025-03-01,36,DPD15-29,16,16,0
2025-03-01,36,DPD3-14,16,16,0
2025-03-01,36,DPD30-59,26,26,0
2025-03-01,36,DPD60-89,2,2,0
2025-03-01,36,DPD90+,0,0,0
2025-03-01,38,Current,309,309,0
2025-03-01,38,DPD15-29,21,21,0
2025-03-01,38,DPD3-14,25,25,0
2025-03-01,38,DPD30-59,21,21,0
2025-03-01,38,DPD60-89,2,2,0
2025-03-01,38,DPD90+,0,0,0
2025-03-01,40,Current,183,183,0
2025-03-01,40,DPD15-29,11,11,0
2025-03-01,40,DPD3-14,22,21,1
2025-03-01,40,DPD30-59,15,15,0
2025-03-01,40,DPD60-89,0,0,0
2025-03-01,40,DPD90+,1,1,0
2025-03-01,42,Current,0,0,0
2025-03-01,42,DPD15-29,10,10,0
2025-03-01,42,DPD3-14,5,5,0
2025-03-01,42,DPD30-59,6,6,0
2025-03-01,42,DPD60-89,0,0,0
2025-03-01,42,DPD90+,0,0,0
2025-03-01,44,Current,148,148,0
2025-03-01,44,DPD15-29,16,16,0
2025-03-01,44,DPD3-14,16,16,0
2025-03-01,44,DPD30-59,20,20,0
2025-03-01,44,DPD60-89,0,0,0
2025-03-01,44,DPD90+,1,1,0
2025-03-01,46,Current,4,4,0
2025-03-01,48,Current,4228,4228,0
2025-03-01,48,DPD15-29,52,51,1
2025-03-01,48,DPD3-14,94,94,0
2025-03-01,48,DPD30-59,70,70,0
2025-03-01,48,DPD60-89,31,31,0
2025-03-01,48,DPD90+,23,23,0
2025-03-01,6,Current,0,0,0
2025-02-28,100,Current,0,0,0
2025-02-28,100,DPD15-29,0,0,0
2025-02-28,102,Current,0,0,0
2025-02-28,102,DPD15-29,0,0,0
2025-02-28,102,DPD3-14,1,1,0
2025-02-28,104,Current,0,0,0
2025-02-28,20,Current,291,291,0
2025-02-28,20,DPD15-29,82,81,1
2025-02-28,20,DPD3-14,131,130,1
2025-02-28,20,DPD30-59,55,55,0
2025-02-28,20,DPD60-89,6,6,0
2025-02-28,20,DPD90+,1,1,0
2025-02-28,22,Current,0,0,0
2025-02-28,22,DPD3-14,1,1,0
2025-02-28,24,Current,390,390,0
2025-02-28,24,DPD15-29,47,47,0
2025-02-28,24,DPD3-14,85,85,0
2025-02-28,24,DPD30-59,32,32,0
2025-02-28,24,DPD60-89,1,1,0
2025-02-28,24,DPD90+,0,0,0
2025-02-28,26,Current,1,1,0
2025-02-28,26,DPD15-29,4,4,0
2025-02-28,26,DPD3-14,11,11,0
2025-02-28,26,DPD30-59,0,0,0
2025-02-28,26,DPD60-89,1,1,0
2025-02-28,26,DPD90+,0,0,0
2025-02-28,32,Current,41,41,0
2025-02-28,32,DPD15-29,34,34,0
2025-02-28,32,DPD3-14,56,56,0
2025-02-28,32,DPD30-59,28,28,0
2025-02-28,32,DPD60-89,0,0,0
2025-02-28,32,DPD90+,0,0,0
2025-02-28,34,Current,0,0,0
2025-02-28,34,DPD15-29,11,11,0
2025-02-28,34,DPD3-14,20,20,0
2025-02-28,34,DPD30-59,9,9,0
2025-02-28,34,DPD60-89,0,0,0
2025-02-28,34,DPD90+,0,0,0
2025-02-28,36,Current,37,37,0
2025-02-28,36,DPD15-29,7,7,0
2025-02-28,36,DPD3-14,9,9,0
2025-02-28,36,DPD30-59,6,6,0
2025-02-28,36,DPD60-89,0,0,0
2025-02-28,36,DPD90+,0,0,0
2025-02-28,38,Current,21,21,0
2025-02-28,38,DPD15-29,12,12,0
2025-02-28,38,DPD3-14,17,17,0
2025-02-28,38,DPD30-59,12,12,0
2025-02-28,38,DPD60-89,0,0,0
2025-02-28,38,DPD90+,0,0,0
2025-02-28,40,Current,39,39,0
2025-02-28,40,DPD15-29,10,10,0
2025-02-28,40,DPD3-14,5,5,0
2025-02-28,40,DPD30-59,8,8,0
2025-02-28,40,DPD60-89,0,0,0
2025-02-28,40,DPD90+,1,1,0
2025-02-28,42,Current,3,3,0
2025-02-28,42,DPD15-29,3,3,0
2025-02-28,42,DPD3-14,6,6,0
2025-02-28,42,DPD30-59,0,0,0
2025-02-28,42,DPD60-89,0,0,0
2025-02-28,42,DPD90+,0,0,0
2025-02-28,44,Current,29,29,0
2025-02-28,44,DPD15-29,16,16,0
2025-02-28,44,DPD3-14,8,8,0
2025-02-28,44,DPD30-59,4,4,0
2025-02-28,44,DPD60-89,0,0,0
2025-02-28,44,DPD90+,0,0,0
2025-02-28,46,Current,1,1,0
2025-02-28,48,Current,178,178,0
2025-02-28,48,DPD15-29,22,22,0
2025-02-28,48,DPD3-14,25,25,0
2025-02-28,48,DPD30-59,8,8,0
2025-02-28,48,DPD60-89,1,1,0
2025-02-28,48,DPD90+,0,0,0
2025-02-28,6,Current,0,0,0
2025-02-27,100,Current,0,0,0
2025-02-27,100,DPD15-29,1,1,0
2025-02-27,102,Current,0,0,0
2025-02-27,102,DPD15-29,0,0,0
2025-02-27,102,DPD3-14,0,0,0
2025-02-27,104,Current,0,0,0
2025-02-27,20,Current,2,2,0
2025-02-27,20,DPD15-29,219,219,0
2025-02-27,20,DPD3-14,152,152,0
2025-02-27,20,DPD30-59,175,175,0
2025-02-27,20,DPD60-89,0,0,0
2025-02-27,20,DPD90+,0,0,0
2025-02-27,22,Current,0,0,0
2025-02-27,22,DPD3-14,0,0,0
2025-02-27,24,Current,58,58,0
2025-02-27,24,DPD15-29,115,115,0
2025-02-27,24,DPD3-14,106,106,0
2025-02-27,24,DPD30-59,93,93,0
2025-02-27,24,DPD60-89,0,0,0
2025-02-27,24,DPD90+,0,0,0
2025-02-27,26,Current,0,0,0
2025-02-27,26,DPD15-29,18,18,0
2025-02-27,26,DPD3-14,11,11,0
2025-02-27,26,DPD30-59,5,5,0
2025-02-27,26,DPD60-89,0,0,0
2025-02-27,26,DPD90+,0,0,0
2025-02-27,32,Current,1,1,0
2025-02-27,32,DPD15-29,98,98,0
2025-02-27,32,DPD3-14,84,83,1
2025-02-27,32,DPD30-59,64,64,0
2025-02-27,32,DPD60-89,0,0,0
2025-02-27,32,DPD90+,0,0,0
2025-02-27,34,Current,0,0,0
2025-02-27,34,DPD15-29,40,40,0
2025-02-27,34,DPD3-14,27,27,0
2025-02-27,34,DPD30-59,26,26,0
2025-02-27,34,DPD60-89,0,0,0
2025-02-27,34,DPD90+,0,0,0
2025-02-27,36,Current,0,0,0
2025-02-27,36,DPD15-29,23,23,0
2025-02-27,36,DPD3-14,18,18,0
2025-02-27,36,DPD30-59,25,25,0
2025-02-27,36,DPD60-89,0,0,0
2025-02-27,36,DPD90+,0,0,0
2025-02-27,38,Current,12,12,0
2025-02-27,38,DPD15-29,37,36,1
2025-02-27,38,DPD3-14,31,30,1
2025-02-27,38,DPD30-59,20,20,0
2025-02-27,38,DPD60-89,0,0,0
2025-02-27,38,DPD90+,0,0,0
2025-02-27,40,Current,1,1,0
2025-02-27,40,DPD15-29,11,11,0
2025-02-27,40,DPD3-14,16,15,1
2025-02-27,40,DPD30-59,17,17,0
2025-02-27,40,DPD60-89,0,0,0
2025-02-27,40,DPD90+,0,0,0
2025-02-27,42,Current,0,0,0
2025-02-27,42,DPD15-29,9,9,0
2025-02-27,42,DPD3-14,6,6,0
2025-02-27,42,DPD30-59,6,6,0
2025-02-27,42,DPD60-89,0,0,0
2025-02-27,42,DPD90+,0,0,0
2025-02-27,44,Current,0,0,0
2025-02-27,44,DPD15-29,21,21,0
2025-02-27,44,DPD3-14,23,23,0
2025-02-27,44,DPD30-59,18,18,0
2025-02-27,44,DPD60-89,0,0,0
2025-02-27,44,DPD90+,0,0,0
2025-02-27,46,Current,0,0,0
2025-02-27,48,Current,41,41,0
2025-02-27,48,DPD15-29,25,24,1
2025-02-27,48,DPD3-14,30,30,0
2025-02-27,48,DPD30-59,31,31,0
2025-02-27,48,DPD60-89,0,0,0
2025-02-27,48,DPD90+,0,0,0
2025-02-27,6,Current,0,0,0
2025-02-26,100,Current,0,0,0
2025-02-26,100,DPD15-29,0,0,0
2025-02-26,102,Current,0,0,0
2025-02-26,102,DPD15-29,1,1,0
2025-02-26,104,Current,0,0,0
2025-02-26,20,Current,1,1,0
2025-02-26,20,DPD15-29,64,63,1
2025-02-26,20,DPD3-14,231,231,0
2025-02-26,20,DPD30-59,41,41,0
2025-02-26,20,DPD60-89,0,0,0
2025-02-26,20,DPD90+,0,0,0
2025-02-26,22,DPD3-14,1,1,0
2025-02-26,22,DPD30-59,0,0,0
2025-02-26,24,Current,547,547,0
2025-02-26,24,DPD15-29,42,42,0
2025-02-26,24,DPD3-14,153,153,0
2025-02-26,24,DPD30-59,22,22,0
2025-02-26,24,DPD60-89,1,1,0
2025-02-26,24,DPD90+,0,0,0
2025-02-26,26,Current,0,0,0
2025-02-26,26,DPD15-29,7,7,0
2025-02-26,26,DPD3-14,14,14,0
2025-02-26,26,DPD30-59,2,2,0
2025-02-26,26,DPD60-89,0,0,0
2025-02-26,26,DPD90+,0,0,0
2025-02-26,32,Current,1,1,0
2025-02-26,32,DPD15-29,28,28,0
2025-02-26,32,DPD3-14,108,108,0
2025-02-26,32,DPD30-59,26,26,0
2025-02-26,32,DPD60-89,0,0,0
2025-02-26,32,DPD90+,0,0,0
2025-02-26,34,Current,0,0,0
2025-02-26,34,DPD15-29,12,12,0
2025-02-26,34,DPD3-14,32,32,0
2025-02-26,34,DPD30-59,4,4,0
2025-02-26,34,DPD60-89,0,0,0
2025-02-26,34,DPD90+,0,0,0
2025-02-26,36,Current,0,0,0
2025-02-26,36,DPD15-29,5,5,0
2025-02-26,36,DPD3-14,26,26,0
2025-02-26,36,DPD30-59,3,3,0
2025-02-26,36,DPD60-89,0,0,0
2025-02-26,36,DPD90+,0,0,0
2025-02-26,38,Current,124,124,0
2025-02-26,38,DPD15-29,12,12,0
2025-02-26,38,DPD3-14,41,40,1
2025-02-26,38,DPD30-59,8,8,0
2025-02-26,38,DPD60-89,1,1,0
2025-02-26,38,DPD90+,0,0,0
2025-02-26,40,Current,0,0,0
2025-02-26,40,DPD15-29,6,6,0
2025-02-26,40,DPD3-14,20,20,0
2025-02-26,40,DPD30-59,5,5,0
2025-02-26,40,DPD60-89,0,0,0
2025-02-26,40,DPD90+,0,0,0
2025-02-26,42,Current,0,0,0
2025-02-26,42,DPD15-29,3,3,0
2025-02-26,42,DPD3-14,13,13,0
2025-02-26,42,DPD30-59,2,2,0
2025-02-26,42,DPD60-89,0,0,0
2025-02-26,42,DPD90+,0,0,0
2025-02-26,44,Current,0,0,0
2025-02-26,44,DPD15-29,14,14,0
2025-02-26,44,DPD3-14,26,26,0
2025-02-26,44,DPD30-59,3,3,0
2025-02-26,44,DPD60-89,0,0,0
2025-02-26,44,DPD90+,0,0,0
2025-02-26,46,Current,0,0,0
2025-02-26,48,Current,338,338,0
2025-02-26,48,DPD15-29,20,20,0
2025-02-26,48,DPD3-14,47,47,0
2025-02-26,48,DPD30-59,6,6,0
2025-02-26,48,DPD60-89,0,0,0
2025-02-26,48,DPD90+,0,0,0
2025-02-26,6,Current,0,0,0
2025-02-25,100,Current,0,0,0
2025-02-25,100,DPD15-29,1,1,0
2025-02-25,102,Current,0,0,0
2025-02-25,102,DPD15-29,0,0,0
2025-02-25,104,Current,0,0,0
2025-02-25,20,Current,1,1,0
2025-02-25,20,DPD15-29,253,253,0
2025-02-25,20,DPD3-14,119,119,0
2025-02-25,20,DPD30-59,227,227,0
2025-02-25,20,DPD60-89,0,0,0
2025-02-25,20,DPD90+,0,0,0
2025-02-25,22,DPD15-29,1,1,0
2025-02-25,22,DPD3-14,1,1,0
2025-02-25,24,Current,83,83,0
2025-02-25,24,DPD15-29,138,138,0
2025-02-25,24,DPD3-14,83,83,0
2025-02-25,24,DPD30-59,128,128,0
2025-02-25,24,DPD60-89,0,0,0
2025-02-25,24,DPD90+,0,0,0
2025-02-25,26,Current,0,0,0
2025-02-25,26,DPD15-29,22,22,0
2025-02-25,26,DPD3-14,12,12,0
2025-02-25,26,DPD30-59,9,9,0
2025-02-25,26,DPD60-89,0,0,0
2025-02-25,26,DPD90+,0,0,0
2025-02-25,32,Current,0,0,0
2025-02-25,32,DPD15-29,130,130,0
2025-02-25,32,DPD3-14,58,58,0
2025-02-25,32,DPD30-59,103,103,0
2025-02-25,32,DPD60-89,0,0,0
2025-02-25,32,DPD90+,0,0,0
2025-02-25,34,Current,0,0,0
2025-02-25,34,DPD15-29,48,48,0
2025-02-25,34,DPD3-14,17,17,0
2025-02-25,34,DPD30-59,37,37,0
2025-02-25,34,DPD60-89,0,0,0
2025-02-25,34,DPD90+,0,0,0
2025-02-25,36,Current,1,1,0
2025-02-25,36,DPD15-29,38,38,0
2025-02-25,36,DPD3-14,15,14,1
2025-02-25,36,DPD30-59,35,35,0
2025-02-25,36,DPD60-89,0,0,0
2025-02-25,36,DPD90+,0,0,0
2025-02-25,38,Current,18,18,0
2025-02-25,38,DPD15-29,52,51,1
2025-02-25,38,DPD3-14,27,27,0
2025-02-25,38,DPD30-59,29,29,0
2025-02-25,38,DPD60-89,0,0,0
2025-02-25,38,DPD90+,0,0,0
2025-02-25,40,Current,0,0,0
2025-02-25,40,DPD15-29,14,14,0
2025-02-25,40,DPD3-14,11,11,0
2025-02-25,40,DPD30-59,19,19,0
2025-02-25,40,DPD60-89,0,0,0
2025-02-25,40,DPD90+,0,0,0
2025-02-25,42,Current,2,2,0
2025-02-25,42,DPD15-29,14,14,0
2025-02-25,42,DPD3-14,2,2,0
2025-02-25,42,DPD30-59,12,12,0
2025-02-25,42,DPD60-89,0,0,0
2025-02-25,42,DPD90+,0,0,0
2025-02-25,44,Current,0,0,0
2025-02-25,44,DPD15-29,33,33,0
2025-02-25,44,DPD3-14,20,20,0
2025-02-25,44,DPD30-59,19,19,0
2025-02-25,44,DPD60-89,0,0,0
2025-02-25,44,DPD90+,0,0,0
2025-02-25,46,Current,0,0,0
2025-02-25,48,Current,60,60,0
2025-02-25,48,DPD15-29,36,36,0
2025-02-25,48,DPD3-14,21,21,0
2025-02-25,48,DPD30-59,39,39,0
2025-02-25,48,DPD60-89,0,0,0
2025-02-25,48,DPD90+,0,0,0
2025-02-25,6,Current,0,0,0
2025-02-24,100,Current,0,0,0
2025-02-24,100,DPD15-29,0,0,0
2025-02-24,102,Current,0,0,0
2025-02-24,102,DPD15-29,1,1,0
2025-02-24,104,Current,0,0,0
2025-02-24,20,Current,292,292,0
2025-02-24,20,DPD15-29,52,51,1
2025-02-24,20,DPD3-14,184,184,0
2025-02-24,20,DPD30-59,31,31,0
2025-02-24,20,DPD60-89,3,3,0
2025-02-24,20,DPD90+,4,4,0
2025-02-24,22,Current,0,0,0
2025-02-24,22,DPD15-29,0,0,0
2025-02-24,22,DPD3-14,0,0,0
2025-02-24,24,Current,355,355,0
2025-02-24,24,DPD15-29,26,26,0
2025-02-24,24,DPD3-14,130,130,0
2025-02-24,24,DPD30-59,16,16,0
2025-02-24,24,DPD60-89,1,1,0
2025-02-24,24,DPD90+,0,0,0
2025-02-24,26,Current,1,1,0
2025-02-24,26,DPD15-29,4,4,0
2025-02-24,26,DPD3-14,10,10,0
2025-02-24,26,DPD30-59,2,2,0
2025-02-24,26,DPD60-89,1,1,0
2025-02-24,26,DPD90+,0,0,0
2025-02-24,32,Current,40,40,0
2025-02-24,32,DPD15-29,22,22,0
2025-02-24,32,DPD3-14,74,74,0
2025-02-24,32,DPD30-59,19,19,0
2025-02-24,32,DPD60-89,0,0,0
2025-02-24,32,DPD90+,0,0,0
2025-02-24,34,Current,0,0,0
2025-02-24,34,DPD15-29,11,11,0
2025-02-24,34,DPD3-14,22,22,0
2025-02-24,34,DPD30-59,3,3,0
2025-02-24,34,DPD60-89,0,0,0
2025-02-24,34,DPD90+,0,0,0
2025-02-24,36,Current,36,36,0
2025-02-24,36,DPD15-29,4,4,0
2025-02-24,36,DPD3-14,27,27,0
2025-02-24,36,DPD30-59,2,2,0
2025-02-24,36,DPD60-89,0,0,0
2025-02-24,36,DPD90+,0,0,0
2025-02-24,38,Current,17,17,0
2025-02-24,38,DPD15-29,9,9,0
2025-02-24,38,DPD3-14,14,13,1
2025-02-24,38,DPD30-59,6,6,0
2025-02-24,38,DPD60-89,0,0,0
2025-02-24,38,DPD90+,0,0,0
2025-02-24,40,Current,37,37,0
2025-02-24,40,DPD15-29,6,6,0
2025-02-24,40,DPD3-14,21,21,0
2025-02-24,40,DPD30-59,3,3,0
2025-02-24,40,DPD60-89,0,0,0
2025-02-24,40,DPD90+,1,1,0
2025-02-24,42,Current,3,3,0
2025-02-24,42,DPD15-29,2,2,0
2025-02-24,42,DPD3-14,6,6,0
2025-02-24,42,DPD30-59,1,1,0
2025-02-24,42,DPD60-89,0,0,0
2025-02-24,42,DPD90+,0,0,0
2025-02-24,44,Current,29,29,0
2025-02-24,44,DPD15-29,14,14,0
2025-02-24,44,DPD3-14,22,22,0
2025-02-24,44,DPD30-59,1,1,0
2025-02-24,44,DPD60-89,0,0,0
2025-02-24,44,DPD90+,0,0,0
2025-02-24,46,Current,1,1,0
2025-02-24,48,Current,158,158,0
2025-02-24,48,DPD15-29,13,13,0
2025-02-24,48,DPD3-14,41,41,0
2025-02-24,48,DPD30-59,5,5,0
2025-02-24,48,DPD60-89,1,1,0
2025-02-24,48,DPD90+,1,1,0
2025-02-24,6,Current,0,0,0
2025-02-23,100,Current,0,0,0
2025-02-23,100,DPD15-29,1,1,0
2025-02-23,102,Current,0,0,0
2025-02-23,102,DPD15-29,0,0,0
2025-02-23,104,Current,0,0,0
2025-02-23,20,Current,1,1,0
2025-02-23,20,DPD15-29,289,289,0
2025-02-23,20,DPD3-14,115,115,0
2025-02-23,20,DPD30-59,242,242,0
2025-02-23,20,DPD60-89,0,0,0
2025-02-23,20,DPD90+,0,0,0
2025-02-23,22,Current,0,0,0
2025-02-23,22,DPD15-29,1,1,0
2025-02-23,22,DPD3-14,1,1,0
2025-02-23,24,Current,44,44,0
2025-02-23,24,DPD15-29,158,158,0
2025-02-23,24,DPD3-14,84,84,0
2025-02-23,24,DPD30-59,125,125,0
2025-02-23,24,DPD60-89,0,0,0
2025-02-23,24,DPD90+,0,0,0
2025-02-23,26,Current,0,0,0
2025-02-23,26,DPD15-29,27,27,0
2025-02-23,26,DPD3-14,12,12,0
2025-02-23,26,DPD30-59,12,11,1
2025-02-23,26,DPD60-89,0,0,0
2025-02-23,26,DPD90+,0,0,0
2025-02-23,32,Current,0,0,0
2025-02-23,32,DPD15-29,150,150,0
2025-02-23,32,DPD3-14,35,35,0
2025-02-23,32,DPD30-59,106,106,0
2025-02-23,32,DPD60-89,0,0,0
2025-02-23,32,DPD90+,0,0,0
2025-02-23,34,Current,0,0,0
2025-02-23,34,DPD15-29,56,56,0
2025-02-23,34,DPD3-14,23,23,0
2025-02-23,34,DPD30-59,32,32,0
2025-02-23,34,DPD60-89,0,0,0
2025-02-23,34,DPD90+,0,0,0
2025-02-23,36,Current,1,1,0
2025-02-23,36,DPD15-29,39,39,0
2025-02-23,36,DPD3-14,13,12,1
2025-02-23,36,DPD30-59,30,30,0
2025-02-23,36,DPD60-89,0,0,0
2025-02-23,36,DPD90+,0,0,0
2025-02-23,38,Current,11,11,0
2025-02-23,38,DPD15-29,59,58,1
2025-02-23,38,DPD3-14,23,23,0
2025-02-23,38,DPD30-59,36,36,0
2025-02-23,38,DPD60-89,0,0,0
2025-02-23,38,DPD90+,0,0,0
2025-02-23,40,Current,0,0,0
2025-02-23,40,DPD15-29,23,22,1
2025-02-23,40,DPD3-14,10,10,0
2025-02-23,40,DPD30-59,25,25,0
2025-02-23,40,DPD60-89,0,0,0
2025-02-23,40,DPD90+,0,0,0
2025-02-23,42,Current,0,0,0
2025-02-23,42,DPD15-29,15,15,0
2025-02-23,42,DPD3-14,4,4,0
2025-02-23,42,DPD30-59,13,13,0
2025-02-23,42,DPD60-89,0,0,0
2025-02-23,42,DPD90+,0,0,0
2025-02-23,44,Current,0,0,0
2025-02-23,44,DPD15-29,36,36,0
2025-02-23,44,DPD3-14,15,15,0
2025-02-23,44,DPD30-59,23,23,0
2025-02-23,44,DPD60-89,0,0,0
2025-02-23,44,DPD90+,0,0,0
2025-02-23,46,Current,0,0,0
2025-02-23,48,Current,37,37,0
2025-02-23,48,DPD15-29,45,45,0
2025-02-23,48,DPD3-14,30,30,0
2025-02-23,48,DPD30-59,34,34,0
2025-02-23,48,DPD60-89,0,0,0
2025-02-23,48,DPD90+,0,0,0
2025-02-23,6,Current,0,0,0
2025-02-22,100,Current,0,0,0
2025-02-22,100,DPD15-29,0,0,0
2025-02-22,102,Current,0,0,0
2025-02-22,102,DPD15-29,1,1,0
2025-02-22,104,Current,0,0,0
2025-02-22,20,Current,2,2,0
2025-02-22,20,DPD15-29,24,24,0
2025-02-22,20,DPD3-14,137,137,0
2025-02-22,20,DPD30-59,18,18,0
2025-02-22,20,DPD60-89,0,0,0
2025-02-22,20,DPD90+,0,0,0
2025-02-22,22,Current,0,0,0
2025-02-22,22,DPD15-29,0,0,0
2025-02-22,22,DPD3-14,0,0,0
2025-02-22,24,Current,35,35,0
2025-02-22,24,DPD15-29,9,9,0
2025-02-22,24,DPD3-14,110,110,0
2025-02-22,24,DPD30-59,9,9,0
2025-02-22,24,DPD60-89,0,0,0
2025-02-22,24,DPD90+,0,0,0
2025-02-22,26,Current,0,0,0
2025-02-22,26,DPD15-29,2,2,0
2025-02-22,26,DPD3-14,13,13,0
2025-02-22,26,DPD30-59,1,1,0
2025-02-22,26,DPD60-89,0,0,0
2025-02-22,26,DPD90+,0,0,0
2025-02-22,32,Current,2,2,0
2025-02-22,32,DPD15-29,11,11,0
2025-02-22,32,DPD3-14,65,64,1
2025-02-22,32,DPD30-59,7,7,0
2025-02-22,32,DPD60-89,0,0,0
2025-02-22,32,DPD90+,0,0,0
2025-02-22,34,Current,0,0,0
2025-02-22,34,DPD15-29,3,3,0
2025-02-22,34,DPD3-14,23,23,0
2025-02-22,34,DPD30-59,1,1,0
2025-02-22,34,DPD60-89,0,0,0
2025-02-22,34,DPD90+,0,0,0
2025-02-22,36,Current,0,0,0
2025-02-22,36,DPD15-29,3,3,0
2025-02-22,36,DPD3-14,14,14,0
2025-02-22,36,DPD30-59,1,1,0
2025-02-22,36,DPD60-89,0,0,0
2025-02-22,36,DPD90+,0,0,0
2025-02-22,38,Current,6,6,0
2025-02-22,38,DPD15-29,4,4,0
2025-02-22,38,DPD3-14,21,21,0
2025-02-22,38,DPD30-59,6,6,0
2025-02-22,38,DPD60-89,0,0,0
2025-02-22,38,DPD90+,0,0,0
2025-02-22,40,Current,0,0,0
2025-02-22,40,DPD15-29,1,1,0
2025-02-22,40,DPD3-14,13,13,0
2025-02-22,40,DPD30-59,0,0,0
2025-02-22,40,DPD60-89,0,0,0
2025-02-22,40,DPD90+,0,0,0
2025-02-22,42,Current,0,0,0
2025-02-22,42,DPD15-29,1,1,0
2025-02-22,42,DPD3-14,4,4,0
2025-02-22,42,DPD30-59,0,0,0
2025-02-22,42,DPD60-89,0,0,0
2025-02-22,42,DPD90+,0,0,0
2025-02-22,44,Current,0,0,0
2025-02-22,44,DPD15-29,4,4,0
2025-02-22,44,DPD3-14,21,21,0
2025-02-22,44,DPD30-59,2,2,0
2025-02-22,44,DPD60-89,0,0,0
2025-02-22,44,DPD90+,0,0,0
2025-02-22,46,Current,0,0,0
2025-02-22,48,Current,25,25,0
2025-02-22,48,DPD15-29,6,6,0
2025-02-22,48,DPD3-14,28,27,1
2025-02-22,48,DPD30-59,3,3,0
2025-02-22,48,DPD60-89,0,0,0
2025-02-22,48,DPD90+,0,0,0
2025-02-22,6,Current,0,0,0
2025-02-21,100,Current,0,0,0
2025-02-21,100,DPD15-29,2,2,0
2025-02-21,102,Current,0,0,0
2025-02-21,102,DPD15-29,0,0,0
2025-02-21,104,Current,0,0,0
2025-02-21,20,Current,0,0,0
2025-02-21,20,DPD15-29,337,335,2
2025-02-21,20,DPD3-14,213,213,0
2025-02-21,20,DPD30-59,266,266,0
2025-02-21,20,DPD60-89,0,0,0
2025-02-21,20,DPD90+,0,0,0
2025-02-21,22,Current,0,0,0
2025-02-21,22,DPD15-29,1,1,0
2025-02-21,24,Current,85,85,0
2025-02-21,24,DPD15-29,199,198,1
2025-02-21,24,DPD3-14,160,160,0
2025-02-21,24,DPD30-59,149,149,0
2025-02-21,24,DPD60-89,0,0,0
2025-02-21,24,DPD90+,0,0,0
2025-02-21,26,Current,0,0,0
2025-02-21,26,DPD15-29,29,29,0
2025-02-21,26,DPD3-14,22,22,0
2025-02-21,26,DPD30-59,14,14,0
2025-02-21,26,DPD60-89,0,0,0
2025-02-21,26,DPD90+,0,0,0
2025-02-21,32,Current,1,1,0
2025-02-21,32,DPD15-29,176,176,0
2025-02-21,32,DPD3-14,88,88,0
2025-02-21,32,DPD30-59,121,121,0
2025-02-21,32,DPD60-89,0,0,0
2025-02-21,32,DPD90+,0,0,0
2025-02-21,34,Current,0,0,0
2025-02-21,34,DPD15-29,61,61,0
2025-02-21,34,DPD3-14,30,30,0
2025-02-21,34,DPD30-59,32,32,0
2025-02-21,34,DPD60-89,0,0,0
2025-02-21,34,DPD90+,0,0,0
2025-02-21,36,Current,0,0,0
2025-02-21,36,DPD15-29,46,46,0
2025-02-21,36,DPD3-14,12,12,0
2025-02-21,36,DPD30-59,33,33,0
2025-02-21,36,DPD60-89,0,0,0
2025-02-21,36,DPD90+,0,0,0
2025-02-21,38,Current,15,15,0
2025-02-21,38,DPD15-29,73,72,1
2025-02-21,38,DPD3-14,34,34,0
2025-02-21,38,DPD30-59,40,40,0
2025-02-21,38,DPD60-89,0,0,0
2025-02-21,38,DPD90+,0,0,0
2025-02-21,40,Current,0,0,0
2025-02-21,40,DPD15-29,21,20,1
2025-02-21,40,DPD3-14,25,25,0
2025-02-21,40,DPD30-59,26,26,0
2025-02-21,40,DPD60-89,0,0,0
2025-02-21,40,DPD90+,0,0,0
2025-02-21,42,Current,0,0,0
2025-02-21,42,DPD15-29,21,21,0
2025-02-21,42,DPD3-14,13,13,0
2025-02-21,42,DPD30-59,15,15,0
2025-02-21,42,DPD60-89,0,0,0
2025-02-21,42,DPD90+,0,0,0
2025-02-21,44,Current,0,0,0
2025-02-21,44,DPD15-29,39,39,0
2025-02-21,44,DPD3-14,24,24,0
2025-02-21,44,DPD30-59,23,23,0
2025-02-21,44,DPD60-89,0,0,0
2025-02-21,44,DPD90+,0,0,0
2025-02-21,46,Current,0,0,0
2025-02-21,48,Current,51,51,0
2025-02-21,48,DPD15-29,53,53,0
2025-02-21,48,DPD3-14,44,44,0
2025-02-21,48,DPD30-59,33,33,0
2025-02-21,48,DPD60-89,0,0,0
2025-02-21,48,DPD90+,0,0,0
2025-02-21,6,Current,0,0,0
2025-02-20,100,Current,0,0,0
2025-02-20,100,DPD15-29,0,0,0
2025-02-20,102,Current,0,0,0
2025-02-20,102,DPD3-14,0,0,0
2025-02-20,104,Current,0,0,0
2025-02-20,20,Current,2,2,0
2025-02-20,20,DPD15-29,6,6,0
2025-02-20,20,DPD3-14,2,2,0
2025-02-20,20,DPD30-59,2,2,0
2025-02-20,20,DPD60-89,0,0,0
2025-02-20,20,DPD90+,0,0,0
2025-02-20,22,Current,0,0,0
2025-02-20,22,DPD15-29,0,0,0
2025-02-20,24,Current,11,11,0
2025-02-20,24,DPD15-29,2,2,0
2025-02-20,24,DPD3-14,0,0,0
2025-02-20,24,DPD30-59,1,1,0
2025-02-20,24,DPD60-89,0,0,0
2025-02-20,24,DPD90+,0,0,0
2025-02-20,26,Current,0,0,0
2025-02-20,26,DPD15-29,0,0,0
2025-02-20,26,DPD3-14,0,0,0
2025-02-20,26,DPD30-59,0,0,0
2025-02-20,26,DPD60-89,0,0,0
2025-02-20,26,DPD90+,0,0,0
2025-02-20,32,Current,0,0,0
2025-02-20,32,DPD15-29,1,1,0
2025-02-20,32,DPD3-14,0,0,0
2025-02-20,32,DPD30-59,1,1,0
2025-02-20,32,DPD60-89,0,0,0
2025-02-20,32,DPD90+,0,0,0
2025-02-20,34,Current,0,0,0
2025-02-20,34,DPD15-29,0,0,0
2025-02-20,34,DPD3-14,1,1,0
2025-02-20,34,DPD30-59,0,0,0
2025-02-20,34,DPD60-89,0,0,0
2025-02-20,34,DPD90+,0,0,0
2025-02-20,36,Current,0,0,0
2025-02-20,36,DPD15-29,2,2,0
2025-02-20,36,DPD3-14,0,0,0
2025-02-20,36,DPD30-59,0,0,0
2025-02-20,36,DPD60-89,0,0,0
2025-02-20,36,DPD90+,0,0,0
2025-02-20,38,Current,1,1,0
2025-02-20,38,DPD15-29,2,2,0
2025-02-20,38,DPD3-14,0,0,0
2025-02-20,38,DPD30-59,1,1,0
2025-02-20,38,DPD60-89,0,0,0
2025-02-20,38,DPD90+,0,0,0
2025-02-20,40,Current,1,1,0
2025-02-20,40,DPD15-29,0,0,0
2025-02-20,40,DPD3-14,0,0,0
2025-02-20,40,DPD30-59,1,1,0
2025-02-20,40,DPD60-89,0,0,0
2025-02-20,40,DPD90+,0,0,0
2025-02-20,42,Current,3,3,0
2025-02-20,42,DPD15-29,0,0,0
2025-02-20,42,DPD3-14,0,0,0
2025-02-20,42,DPD30-59,0,0,0
2025-02-20,42,DPD60-89,0,0,0
2025-02-20,42,DPD90+,0,0,0
2025-02-20,44,Current,1,1,0
2025-02-20,44,DPD15-29,0,0,0
2025-02-20,44,DPD3-14,0,0,0
2025-02-20,44,DPD30-59,0,0,0
2025-02-20,44,DPD60-89,0,0,0
2025-02-20,44,DPD90+,0,0,0
2025-02-20,46,Current,0,0,0
2025-02-20,46,DPD60-89,0,0,0
2025-02-20,48,Current,13,13,0
2025-02-20,48,DPD15-29,1,1,0
2025-02-20,48,DPD3-14,1,1,0
2025-02-20,48,DPD30-59,1,1,0
2025-02-20,48,DPD60-89,0,0,0
2025-02-20,48,DPD90+,0,0,0
2025-02-20,6,Current,0,0,0
2025-02-19,100,Current,0,0,0
2025-02-19,100,DPD15-29,0,0,0
2025-02-19,100,DPD3-14,0,0,0
2025-02-19,102,Current,0,0,0
2025-02-19,102,DPD3-14,0,0,0
2025-02-19,104,Current,0,0,0
2025-02-19,20,Current,6,6,0
2025-02-19,20,DPD15-29,0,0,0
2025-02-19,20,DPD3-14,0,0,0
2025-02-19,20,DPD30-59,1,1,0
2025-02-19,20,DPD60-89,1,1,0
2025-02-19,20,DPD90+,0,0,0
2025-02-19,22,Current,0,0,0
2025-02-19,22,DPD15-29,0,0,0
2025-02-19,24,Current,44,44,0
2025-02-19,24,DPD15-29,1,1,0
2025-02-19,24,DPD3-14,0,0,0
2025-02-19,24,DPD30-59,0,0,0
2025-02-19,24,DPD60-89,0,0,0
2025-02-19,24,DPD90+,0,0,0
2025-02-19,26,Current,0,0,0
2025-02-19,26,DPD15-29,0,0,0
2025-02-19,26,DPD3-14,0,0,0
2025-02-19,26,DPD30-59,0,0,0
2025-02-19,26,DPD60-89,0,0,0
2025-02-19,26,DPD90+,0,0,0
2025-02-19,32,Current,1,1,0
2025-02-19,32,DPD15-29,0,0,0
2025-02-19,32,DPD3-14,0,0,0
2025-02-19,32,DPD30-59,0,0,0
2025-02-19,32,DPD60-89,0,0,0
2025-02-19,32,DPD90+,0,0,0
2025-02-19,34,Current,0,0,0
2025-02-19,34,DPD15-29,0,0,0
2025-02-19,34,DPD3-14,0,0,0
2025-02-19,34,DPD30-59,0,0,0
2025-02-19,34,DPD60-89,0,0,0
2025-02-19,34,DPD90+,0,0,0
2025-02-19,36,Current,0,0,0
2025-02-19,36,DPD15-29,1,1,0
2025-02-19,36,DPD3-14,0,0,0
2025-02-19,36,DPD30-59,0,0,0
2025-02-19,36,DPD60-89,0,0,0
2025-02-19,36,DPD90+,0,0,0
2025-02-19,38,Current,7,7,0
2025-02-19,38,DPD15-29,0,0,0
2025-02-19,38,DPD3-14,0,0,0
2025-02-19,38,DPD30-59,0,0,0
2025-02-19,38,DPD60-89,0,0,0
2025-02-19,38,DPD90+,0,0,0
2025-02-19,40,Current,0,0,0
2025-02-19,40,DPD15-29,0,0,0
2025-02-19,40,DPD3-14,0,0,0
2025-02-19,40,DPD30-59,0,0,0
2025-02-19,40,DPD60-89,0,0,0
2025-02-19,40,DPD90+,0,0,0
2025-02-19,42,Current,1,1,0
2025-02-19,42,DPD15-29,0,0,0
2025-02-19,42,DPD3-14,0,0,0
2025-02-19,42,DPD30-59,0,0,0
2025-02-19,42,DPD60-89,0,0,0
2025-02-19,42,DPD90+,0,0,0
2025-02-19,44,Current,2,2,0
2025-02-19,44,DPD15-29,0,0,0
2025-02-19,44,DPD3-14,2,2,0
2025-02-19,44,DPD30-59,0,0,0
2025-02-19,44,DPD60-89,0,0,0
2025-02-19,44,DPD90+,1,1,0
2025-02-19,46,Current,0,0,0
2025-02-19,46,DPD60-89,0,0,0
2025-02-19,48,Current,38,38,0
2025-02-19,48,DPD15-29,0,0,0
2025-02-19,48,DPD3-14,0,0,0
2025-02-19,48,DPD30-59,0,0,0
2025-02-19,48,DPD60-89,0,0,0
2025-02-19,48,DPD90+,0,0,0
2025-02-19,6,Current,0,0,0
2025-02-18,100,Current,0,0,0
2025-02-18,100,DPD15-29,0,0,0
2025-02-18,100,DPD3-14,0,0,0
2025-02-18,102,Current,0,0,0
2025-02-18,102,DPD3-14,0,0,0
2025-02-18,104,Current,0,0,0
2025-02-18,104,DPD3-14,1,1,0
2025-02-18,20,Current,1,1,0
2025-02-18,20,DPD15-29,185,185,0
2025-02-18,20,DPD3-14,93,93,0
2025-02-18,20,DPD30-59,172,172,0
2025-02-18,20,DPD60-89,0,0,0
2025-02-18,20,DPD90+,0,0,0
2025-02-18,22,Current,0,0,0
2025-02-18,22,DPD15-29,1,1,0
2025-02-18,24,Current,63,63,0
2025-02-18,24,DPD15-29,107,107,0
2025-02-18,24,DPD3-14,56,56,0
2025-02-18,24,DPD30-59,101,101,0
2025-02-18,24,DPD60-89,0,0,0
2025-02-18,24,DPD90+,0,0,0
2025-02-18,26,Current,0,0,0
2025-02-18,26,DPD15-29,13,13,0
2025-02-18,26,DPD3-14,9,9,0
2025-02-18,26,DPD30-59,7,7,0
2025-02-18,26,DPD60-89,0,0,0
2025-02-18,26,DPD90+,0,0,0
2025-02-18,32,Current,0,0,0
2025-02-18,32,DPD15-29,91,91,0
2025-02-18,32,DPD3-14,33,33,0
2025-02-18,32,DPD30-59,88,88,0
2025-02-18,32,DPD60-89,0,0,0
2025-02-18,32,DPD90+,0,0,0
2025-02-18,34,Current,0,0,0
2025-02-18,34,DPD15-29,49,49,0
2025-02-18,34,DPD3-14,21,21,0
2025-02-18,34,DPD30-59,27,27,0
2025-02-18,34,DPD60-89,0,0,0
2025-02-18,34,DPD90+,0,0,0
2025-02-18,36,Current,0,0,0
2025-02-18,36,DPD15-29,24,24,0
2025-02-18,36,DPD3-14,11,11,0
2025-02-18,36,DPD30-59,21,21,0
2025-02-18,36,DPD60-89,0,0,0
2025-02-18,36,DPD90+,0,0,0
2025-02-18,38,Current,12,12,0
2025-02-18,38,DPD15-29,35,35,0
2025-02-18,38,DPD3-14,24,24,0
2025-02-18,38,DPD30-59,42,42,0
2025-02-18,38,DPD60-89,0,0,0
2025-02-18,38,DPD90+,0,0,0
2025-02-18,40,Current,0,0,0
2025-02-18,40,DPD15-29,12,12,0
2025-02-18,40,DPD3-14,12,12,0
2025-02-18,40,DPD30-59,16,16,0
2025-02-18,40,DPD60-89,0,0,0
2025-02-18,40,DPD90+,0,0,0
2025-02-18,42,Current,0,0,0
2025-02-18,42,DPD15-29,11,11,0
2025-02-18,42,DPD3-14,2,2,0
2025-02-18,42,DPD30-59,9,9,0
2025-02-18,42,DPD60-89,0,0,0
2025-02-18,42,DPD90+,0,0,0
2025-02-18,44,Current,0,0,0
2025-02-18,44,DPD15-29,26,26,0
2025-02-18,44,DPD3-14,15,15,0
2025-02-18,44,DPD30-59,20,20,0
2025-02-18,44,DPD60-89,0,0,0
2025-02-18,44,DPD90+,0,0,0
2025-02-18,46,Current,0,0,0
2025-02-18,46,DPD60-89,0,0,0
2025-02-18,48,Current,28,28,0
2025-02-18,48,DPD15-29,32,32,0
2025-02-18,48,DPD3-14,26,26,0
2025-02-18,48,DPD30-59,30,30,0
2025-02-18,48,DPD60-89,0,0,0
2025-02-18,48,DPD90+,0,0,0
2025-02-18,6,Current,0,0,0
2025-02-17,100,Current,0,0,0
2025-02-17,100,DPD3-14,0,0,0
2025-02-17,102,Current,0,0,0
2025-02-17,102,DPD3-14,0,0,0
2025-02-17,104,Current,0,0,0
2025-02-17,104,DPD3-14,0,0,0
2025-02-17,20,Current,2,2,0
2025-02-17,20,DPD15-29,202,202,0
2025-02-17,20,DPD3-14,86,86,0
2025-02-17,20,DPD30-59,111,111,0
2025-02-17,20,DPD60-89,0,0,0
2025-02-17,20,DPD90+,0,0,0
2025-02-17,22,Current,0,0,0
2025-02-17,22,DPD15-29,0,0,0
2025-02-17,24,Current,57,57,0
2025-02-17,24,DPD15-29,113,113,0
2025-02-17,24,DPD3-14,52,52,0
2025-02-17,24,DPD30-59,50,50,0
2025-02-17,24,DPD60-89,0,0,0
2025-02-17,24,DPD90+,0,0,0
2025-02-17,26,Current,0,0,0
2025-02-17,26,DPD15-29,17,17,0
2025-02-17,26,DPD3-14,5,5,0
2025-02-17,26,DPD30-59,7,7,0
2025-02-17,26,DPD60-89,0,0,0
2025-02-17,26,DPD90+,0,0,0
2025-02-17,32,Current,0,0,0
2025-02-17,32,DPD15-29,118,118,0
2025-02-17,32,DPD3-14,40,40,0
2025-02-17,32,DPD30-59,44,44,0
2025-02-17,32,DPD60-89,0,0,0
2025-02-17,32,DPD90+,0,0,0
2025-02-17,34,Current,0,0,0
2025-02-17,34,DPD15-29,39,39,0
2025-02-17,34,DPD3-14,16,16,0
2025-02-17,34,DPD30-59,16,16,0
2025-02-17,34,DPD60-89,0,0,0
2025-02-17,34,DPD90+,0,0,0
2025-02-17,36,Current,0,0,0
2025-02-17,36,DPD15-29,20,20,0
2025-02-17,36,DPD3-14,10,10,0
2025-02-17,36,DPD30-59,19,19,0
2025-02-17,36,DPD60-89,0,0,0
2025-02-17,36,DPD90+,0,0,0
2025-02-17,38,Current,13,13,0
2025-02-17,38,DPD15-29,36,36,0
2025-02-17,38,DPD3-14,14,14,0
2025-02-17,38,DPD30-59,11,11,0
2025-02-17,38,DPD60-89,0,0,0
2025-02-17,38,DPD90+,0,0,0
2025-02-17,40,Current,0,0,0
2025-02-17,40,DPD15-29,13,13,0
2025-02-17,40,DPD3-14,7,7,0
2025-02-17,40,DPD30-59,8,8,0
2025-02-17,40,DPD60-89,0,0,0
2025-02-17,40,DPD90+,0,0,0
2025-02-17,42,Current,0,0,0
2025-02-17,42,DPD15-29,16,16,0
2025-02-17,42,DPD3-14,2,2,0
2025-02-17,42,DPD30-59,6,6,0
2025-02-17,42,DPD60-89,0,0,0
2025-02-17,42,DPD90+,0,0,0
2025-02-17,44,Current,0,0,0
2025-02-17,44,DPD15-29,24,24,0
2025-02-17,44,DPD3-14,15,15,0
2025-02-17,44,DPD30-59,11,11,0
2025-02-17,44,DPD60-89,0,0,0
2025-02-17,44,DPD90+,0,0,0
2025-02-17,46,Current,0,0,0
2025-02-17,46,DPD60-89,0,0,0
2025-02-17,48,Current,31,31,0
2025-02-17,48,DPD15-29,26,26,0
2025-02-17,48,DPD3-14,30,30,0
2025-02-17,48,DPD30-59,15,15,0
2025-02-17,48,DPD60-89,0,0,0
2025-02-17,48,DPD90+,0,0,0
2025-02-17,6,Current,0,0,0
2025-02-16,100,Current,0,0,0
2025-02-16,100,DPD3-14,1,1,0
2025-02-16,102,Current,0,0,0
2025-02-16,102,DPD3-14,0,0,0
2025-02-16,104,Current,0,0,0
2025-02-16,20,Current,2,2,0
2025-02-16,20,DPD15-29,205,205,0
2025-02-16,20,DPD3-14,106,106,0
2025-02-16,20,DPD30-59,191,191,0
2025-02-16,20,DPD60-89,0,0,0
2025-02-16,20,DPD90+,0,0,0
2025-02-16,22,Current,0,0,0
2025-02-16,22,DPD15-29,1,1,0
2025-02-16,24,Current,12,12,0
2025-02-16,24,DPD15-29,128,128,0
2025-02-16,24,DPD3-14,87,87,0
2025-02-16,24,DPD30-59,115,115,0
2025-02-16,24,DPD60-89,0,0,0
2025-02-16,24,DPD90+,0,0,0
2025-02-16,26,Current,0,0,0
2025-02-16,26,DPD15-29,12,12,0
2025-02-16,26,DPD3-14,12,12,0
2025-02-16,26,DPD30-59,7,7,0
2025-02-16,26,DPD60-89,0,0,0
2025-02-16,26,DPD90+,0,0,0
2025-02-16,32,Current,0,0,0
2025-02-16,32,DPD15-29,103,103,0
2025-02-16,32,DPD3-14,21,21,0
2025-02-16,32,DPD30-59,105,105,0
2025-02-16,32,DPD60-89,1,1,0
2025-02-16,32,DPD90+,0,0,0
2025-02-16,34,Current,1,1,0
2025-02-16,34,DPD15-29,57,57,0
2025-02-16,34,DPD3-14,16,16,0
2025-02-16,34,DPD30-59,34,34,0
2025-02-16,34,DPD60-89,0,0,0
2025-02-16,34,DPD90+,0,0,0
2025-02-16,36,Current,0,0,0
2025-02-16,36,DPD15-29,24,24,0
2025-02-16,36,DPD3-14,12,12,0
2025-02-16,36,DPD30-59,25,25,0
2025-02-16,36,DPD60-89,0,0,0
2025-02-16,36,DPD90+,0,0,0
2025-02-16,38,Current,0,0,0
2025-02-16,38,DPD15-29,36,36,0
2025-02-16,38,DPD3-14,26,26,0
2025-02-16,38,DPD30-59,50,50,0
2025-02-16,38,DPD60-89,0,0,0
2025-02-16,38,DPD90+,0,0,0
2025-02-16,40,Current,1,1,0
2025-02-16,40,DPD15-29,17,17,0
2025-02-16,40,DPD3-14,8,8,0
2025-02-16,40,DPD30-59,18,18,0
2025-02-16,40,DPD60-89,0,0,0
2025-02-16,40,DPD90+,0,0,0
2025-02-16,42,Current,0,0,0
2025-02-16,42,DPD15-29,11,11,0
2025-02-16,42,DPD3-14,1,1,0
2025-02-16,42,DPD30-59,11,11,0
2025-02-16,42,DPD60-89,0,0,0
2025-02-16,42,DPD90+,0,0,0
2025-02-16,44,Current,0,0,0
2025-02-16,44,DPD15-29,30,30,0
2025-02-16,44,DPD3-14,7,7,0
2025-02-16,44,DPD30-59,27,27,0
2025-02-16,44,DPD60-89,0,0,0
2025-02-16,44,DPD90+,0,0,0
2025-02-16,46,Current,0,0,0
2025-02-16,46,DPD60-89,0,0,0
2025-02-16,48,Current,11,11,0
2025-02-16,48,DPD15-29,33,33,0
2025-02-16,48,DPD3-14,32,32,0
2025-02-16,48,DPD30-59,31,31,0
2025-02-16,48,DPD60-89,0,0,0
2025-02-16,48,DPD90+,0,0,0
2025-02-16,6,Current,0,0,0
2025-02-15,100,Current,0,0,0
2025-02-15,100,DPD3-14,0,0,0
2025-02-15,102,Current,0,0,0
2025-02-15,102,DPD3-14,0,0,0
2025-02-15,104,Current,0,0,0
2025-02-15,20,Current,3405,3405,0
2025-02-15,20,DPD15-29,184,184,0
2025-02-15,20,DPD3-14,136,136,0
2025-02-15,20,DPD30-59,164,164,0
2025-02-15,20,DPD60-89,53,53,0
2025-02-15,20,DPD90+,46,46,0
2025-02-15,22,Current,0,0,0
2025-02-15,22,DPD15-29,0,0,0
2025-02-15,24,Current,4594,4594,0
2025-02-15,24,DPD15-29,129,129,0
2025-02-15,24,DPD3-14,104,104,0
2025-02-15,24,DPD30-59,108,108,0
2025-02-15,24,DPD60-89,29,29,0
2025-02-15,24,DPD90+,17,17,0
2025-02-15,26,Current,0,0,0
2025-02-15,26,DPD15-29,17,17,0
2025-02-15,26,DPD3-14,3,3,0
2025-02-15,26,DPD30-59,7,7,0
2025-02-15,26,DPD60-89,0,0,0
2025-02-15,26,DPD90+,0,0,0
2025-02-15,32,Current,167,167,0
2025-02-15,32,DPD15-29,85,85,0
2025-02-15,32,DPD3-14,33,33,0
2025-02-15,32,DPD30-59,46,46,0
2025-02-15,32,DPD60-89,3,3,0
2025-02-15,32,DPD90+,3,3,0
2025-02-15,34,Current,0,0,0
2025-02-15,34,DPD15-29,31,31,0
2025-02-15,34,DPD3-14,19,19,0
2025-02-15,34,DPD30-59,15,15,0
2025-02-15,34,DPD60-89,0,0,0
2025-02-15,34,DPD90+,0,0,0
2025-02-15,36,Current,167,167,0
2025-02-15,36,DPD15-29,17,17,0
2025-02-15,36,DPD3-14,9,9,0
2025-02-15,36,DPD30-59,19,19,0
2025-02-15,36,DPD60-89,3,3,0
2025-02-15,36,DPD90+,1,1,0
2025-02-15,38,Current,305,305,0
2025-02-15,38,DPD15-29,30,30,0
2025-02-15,38,DPD3-14,15,15,0
2025-02-15,38,DPD30-59,12,12,0
2025-02-15,38,DPD60-89,0,0,0
2025-02-15,38,DPD90+,0,0,0
2025-02-15,40,Current,189,189,0
2025-02-15,40,DPD15-29,12,12,0
2025-02-15,40,DPD3-14,8,8,0
2025-02-15,40,DPD30-59,10,10,0
2025-02-15,40,DPD60-89,0,0,0
2025-02-15,40,DPD90+,1,1,0
2025-02-15,42,Current,0,0,0
2025-02-15,42,DPD15-29,11,11,0
2025-02-15,42,DPD3-14,2,2,0
2025-02-15,42,DPD30-59,7,7,0
2025-02-15,42,DPD60-89,0,0,0
2025-02-15,42,DPD90+,0,0,0
2025-02-15,44,Current,131,131,0
2025-02-15,44,DPD15-29,15,15,0
2025-02-15,44,DPD3-14,15,15,0
2025-02-15,44,DPD30-59,12,12,0
2025-02-15,44,DPD60-89,0,0,0
2025-02-15,44,DPD90+,1,1,0
2025-02-15,46,Current,4,4,0
2025-02-15,46,DPD60-89,0,0,0
2025-02-15,48,Current,4278,4278,0
2025-02-15,48,DPD15-29,65,65,0
2025-02-15,48,DPD3-14,72,72,0
2025-02-15,48,DPD30-59,57,57,0
2025-02-15,48,DPD60-89,30,30,0
2025-02-15,48,DPD90+,21,21,0
2025-02-15,6,Current,0,0,0
2025-02-14,100,Current,0,0,0
2025-02-14,100,DPD3-14,0,0,0
2025-02-14,102,Current,0,0,0
2025-02-14,102,DPD3-14,0,0,0
2025-02-14,104,Current,0,0,0
2025-02-14,20,Current,0,0,0
2025-02-14,20,DPD15-29,306,306,0
2025-02-14,20,DPD3-14,108,108,0
2025-02-14,20,DPD30-59,235,235,0
2025-02-14,20,DPD60-89,0,0,0
2025-02-14,20,DPD90+,0,0,0
2025-02-14,22,Current,0,0,0
2025-02-14,22,DPD15-29,1,1,0
2025-02-14,24,Current,19,19,0
2025-02-14,24,DPD15-29,183,183,0
2025-02-14,24,DPD3-14,92,92,0
2025-02-14,24,DPD30-59,149,149,0
2025-02-14,24,DPD60-89,0,0,0
2025-02-14,24,DPD90+,0,0,0
2025-02-14,26,Current,0,0,0
2025-02-14,26,DPD15-29,19,19,0
2025-02-14,26,DPD3-14,10,10,0
2025-02-14,26,DPD30-59,8,8,0
2025-02-14,26,DPD60-89,0,0,0
2025-02-14,26,DPD90+,0,0,0
2025-02-14,32,Current,0,0,0
2025-02-14,32,DPD15-29,155,155,0
2025-02-14,32,DPD3-14,38,38,0
2025-02-14,32,DPD30-59,121,121,0
2025-02-14,32,DPD60-89,0,0,0
2025-02-14,32,DPD90+,0,0,0
2025-02-14,34,Current,1,1,0
2025-02-14,34,DPD15-29,77,77,0
2025-02-14,34,DPD3-14,18,18,0
2025-02-14,34,DPD30-59,38,38,0
2025-02-14,34,DPD60-89,0,0,0
2025-02-14,34,DPD90+,0,0,0
2025-02-14,36,Current,0,0,0
2025-02-14,36,DPD15-29,36,36,0
2025-02-14,36,DPD3-14,7,7,0
2025-02-14,36,DPD30-59,33,33,0
2025-02-14,36,DPD60-89,0,0,0
2025-02-14,36,DPD90+,0,0,0
2025-02-14,38,Current,9,9,0
2025-02-14,38,DPD15-29,49,49,0
2025-02-14,38,DPD3-14,21,21,0
2025-02-14,38,DPD30-59,53,53,0
2025-02-14,38,DPD60-89,0,0,0
2025-02-14,38,DPD90+,0,0,0
2025-02-14,40,Current,0,0,0
2025-02-14,40,DPD15-29,28,28,0
2025-02-14,40,DPD3-14,15,15,0
2025-02-14,40,DPD30-59,20,20,0
2025-02-14,40,DPD60-89,0,0,0
2025-02-14,40,DPD90+,0,0,0
2025-02-14,42,Current,0,0,0
2025-02-14,42,DPD15-29,11,11,0
2025-02-14,42,DPD3-14,4,4,0
2025-02-14,42,DPD30-59,13,13,0
2025-02-14,42,DPD60-89,0,0,0
2025-02-14,42,DPD90+,0,0,0
2025-02-14,44,Current,0,0,0
2025-02-14,44,DPD15-29,43,43,0
2025-02-14,44,DPD3-14,16,16,0
2025-02-14,44,DPD30-59,28,28,0
2025-02-14,44,DPD60-89,0,0,0
2025-02-14,44,DPD90+,0,0,0
2025-02-14,46,Current,0,0,0
2025-02-14,46,DPD60-89,0,0,0
2025-02-14,48,Current,10,10,0
2025-02-14,48,DPD15-29,53,53,0
2025-02-14,48,DPD3-14,24,24,0
2025-02-14,48,DPD30-59,36,36,0
2025-02-14,48,DPD60-89,0,0,0
2025-02-14,48,DPD90+,0,0,0
2025-02-14,6,Current,0,0,0
2025-02-13,100,Current,0,0,0
2025-02-13,100,DPD3-14,0,0,0
2025-02-13,102,Current,0,0,0
2025-02-13,102,DPD15-29,1,1,0
2025-02-13,102,DPD3-14,0,0,0
2025-02-13,104,Current,0,0,0
2025-02-13,20,Current,2,2,0
2025-02-13,20,DPD15-29,131,131,0
2025-02-13,20,DPD3-14,72,72,0
2025-02-13,20,DPD30-59,17,17,0
2025-02-13,20,DPD60-89,0,0,0
2025-02-13,20,DPD90+,1,1,0
2025-02-13,22,Current,0,0,0
2025-02-13,22,DPD15-29,0,0,0
2025-02-13,24,Current,19,19,0
2025-02-13,24,DPD15-29,73,73,0
2025-02-13,24,DPD3-14,62,62,0
2025-02-13,24,DPD30-59,6,6,0
2025-02-13,24,DPD60-89,0,0,0
2025-02-13,24,DPD90+,0,0,0
2025-02-13,26,Current,0,0,0
2025-02-13,26,DPD15-29,15,15,0
2025-02-13,26,DPD3-14,7,7,0
2025-02-13,26,DPD30-59,0,0,0
2025-02-13,26,DPD60-89,0,0,0
2025-02-13,26,DPD90+,0,0,0
2025-02-13,32,Current,1,1,0
2025-02-13,32,DPD15-29,63,63,0
2025-02-13,32,DPD3-14,37,37,0
2025-02-13,32,DPD30-59,6,6,0
2025-02-13,32,DPD60-89,0,0,0
2025-02-13,32,DPD90+,0,0,0
2025-02-13,34,Current,3,3,0
2025-02-13,34,DPD15-29,31,31,0
2025-02-13,34,DPD3-14,17,17,0
2025-02-13,34,DPD30-59,1,1,0
2025-02-13,34,DPD60-89,0,0,0
2025-02-13,34,DPD90+,0,0,0
2025-02-13,36,Current,0,0,0
2025-02-13,36,DPD15-29,19,19,0
2025-02-13,36,DPD3-14,16,16,0
2025-02-13,36,DPD30-59,3,3,0
2025-02-13,36,DPD60-89,0,0,0
2025-02-13,36,DPD90+,0,0,0
2025-02-13,38,Current,3,3,0
2025-02-13,38,DPD15-29,32,32,0
2025-02-13,38,DPD3-14,19,19,0
2025-02-13,38,DPD30-59,1,1,0
2025-02-13,38,DPD60-89,0,0,0
2025-02-13,38,DPD90+,0,0,0
2025-02-13,40,Current,0,0,0
2025-02-13,40,DPD15-29,11,11,0
2025-02-13,40,DPD3-14,9,9,0
2025-02-13,40,DPD30-59,0,0,0
2025-02-13,40,DPD60-89,0,0,0
2025-02-13,40,DPD90+,0,0,0
2025-02-13,42,Current,0,0,0
2025-02-13,42,DPD15-29,6,6,0
2025-02-13,42,DPD3-14,7,7,0
2025-02-13,42,DPD30-59,0,0,0
2025-02-13,42,DPD60-89,1,1,0
2025-02-13,42,DPD90+,0,0,0
2025-02-13,44,Current,0,0,0
2025-02-13,44,DPD15-29,17,17,0
2025-02-13,44,DPD3-14,19,19,0
2025-02-13,44,DPD30-59,1,1,0
2025-02-13,44,DPD60-89,0,0,0
2025-02-13,44,DPD90+,0,0,0
2025-02-13,46,Current,0,0,0
2025-02-13,46,DPD60-89,0,0,0
2025-02-13,48,Current,7,7,0
2025-02-13,48,DPD15-29,12,12,0
2025-02-13,48,DPD3-14,20,20,0
2025-02-13,48,DPD30-59,1,1,0
2025-02-13,48,DPD60-89,0,0,0
2025-02-13,48,DPD90+,0,0,0
2025-02-13,6,Current,0,0,0
2025-02-12,100,Current,0,0,0
2025-02-12,100,DPD3-14,0,0,0
2025-02-12,102,Current,0,0,0
2025-02-12,102,DPD15-29,0,0,0
2025-02-12,102,DPD3-14,0,0,0
2025-02-12,104,Current,0,0,0
2025-02-12,20,Current,3,3,0
2025-02-12,20,DPD15-29,125,125,0
2025-02-12,20,DPD3-14,147,147,0
2025-02-12,20,DPD30-59,25,25,0
2025-02-12,20,DPD60-89,0,0,0
2025-02-12,20,DPD90+,0,0,0
2025-02-12,22,Current,0,0,0
2025-02-12,22,DPD15-29,1,1,0
2025-02-12,24,Current,32,32,0
2025-02-12,24,DPD15-29,76,76,0
2025-02-12,24,DPD3-14,77,77,0
2025-02-12,24,DPD30-59,6,6,0
2025-02-12,24,DPD60-89,0,0,0
2025-02-12,24,DPD90+,0,0,0
2025-02-12,26,Current,0,0,0
2025-02-12,26,DPD15-29,9,9,0
2025-02-12,26,DPD3-14,6,6,0
2025-02-12,26,DPD30-59,0,0,0
2025-02-12,26,DPD60-89,0,0,0
2025-02-12,26,DPD90+,0,0,0
2025-02-12,32,Current,0,0,0
2025-02-12,32,DPD15-29,61,61,0
2025-02-12,32,DPD3-14,75,75,0
2025-02-12,32,DPD30-59,6,6,0
2025-02-12,32,DPD60-89,0,0,0
2025-02-12,32,DPD90+,0,0,0
2025-02-12,34,Current,1,1,0
2025-02-12,34,DPD15-29,29,29,0
2025-02-12,34,DPD3-14,24,24,0
2025-02-12,34,DPD30-59,7,7,0
2025-02-12,34,DPD60-89,0,0,0
2025-02-12,34,DPD90+,0,0,0
2025-02-12,36,Current,0,0,0
2025-02-12,36,DPD15-29,17,17,0
2025-02-12,36,DPD3-14,13,13,0
2025-02-12,36,DPD30-59,3,3,0
2025-02-12,36,DPD60-89,0,0,0
2025-02-12,36,DPD90+,0,0,0
2025-02-12,38,Current,7,7,0
2025-02-12,38,DPD15-29,19,19,0
2025-02-12,38,DPD3-14,29,29,0
2025-02-12,38,DPD30-59,2,2,0
2025-02-12,38,DPD60-89,0,0,0
2025-02-12,38,DPD90+,0,0,0
2025-02-12,40,Current,0,0,0
2025-02-12,40,DPD15-29,10,10,0
2025-02-12,40,DPD3-14,15,15,0
2025-02-12,40,DPD30-59,2,2,0
2025-02-12,40,DPD60-89,0,0,0
2025-02-12,40,DPD90+,0,0,0
2025-02-12,42,Current,0,0,0
2025-02-12,42,DPD15-29,3,3,0
2025-02-12,42,DPD3-14,8,8,0
2025-02-12,42,DPD30-59,0,0,0
2025-02-12,42,DPD60-89,0,0,0
2025-02-12,42,DPD90+,0,0,0
2025-02-12,44,Current,5,5,0
2025-02-12,44,DPD15-29,21,21,0
2025-02-12,44,DPD3-14,32,32,0
2025-02-12,44,DPD30-59,0,0,0
2025-02-12,44,DPD60-89,0,0,0
2025-02-12,44,DPD90+,0,0,0
2025-02-12,46,Current,0,0,0
2025-02-12,46,DPD60-89,0,0,0
2025-02-12,48,Current,23,23,0
2025-02-12,48,DPD15-29,22,22,0
2025-02-12,48,DPD3-14,26,26,0
2025-02-12,48,DPD30-59,2,2,0
2025-02-12,48,DPD60-89,0,0,0
2025-02-12,48,DPD90+,0,0,0
2025-02-12,6,Current,0,0,0
2025-02-11,100,Current,0,0,0
2025-02-11,100,DPD3-14,1,1,0
2025-02-11,102,Current,0,0,0
2025-02-11,102,DPD15-29,0,0,0
2025-02-11,102,DPD3-14,0,0,0
2025-02-11,104,Current,0,0,0
2025-02-11,20,Current,2,2,0
2025-02-11,20,DPD15-29,43,43,0
2025-02-11,20,DPD3-14,79,79,0
2025-02-11,20,DPD30-59,85,85,0
2025-02-11,20,DPD60-89,0,0,0
2025-02-11,20,DPD90+,0,0,0
2025-02-11,22,Current,0,0,0
2025-02-11,22,DPD15-29,0,0,0
2025-02-11,24,Current,38,38,0
2025-02-11,24,DPD15-29,39,39,0
2025-02-11,24,DPD3-14,60,60,0
2025-02-11,24,DPD30-59,35,35,0
2025-02-11,24,DPD60-89,0,0,0
2025-02-11,24,DPD90+,0,0,0
2025-02-11,26,Current,0,0,0
2025-02-11,26,DPD15-29,3,3,0
2025-02-11,26,DPD3-14,9,9,0
2025-02-11,26,DPD30-59,7,7,0
2025-02-11,26,DPD60-89,0,0,0
2025-02-11,26,DPD90+,0,0,0
2025-02-11,32,Current,0,0,0
2025-02-11,32,DPD15-29,33,33,0
2025-02-11,32,DPD3-14,25,25,0
2025-02-11,32,DPD30-59,42,42,0
2025-02-11,32,DPD60-89,0,0,0
2025-02-11,32,DPD90+,0,0,0
2025-02-11,34,Current,0,0,0
2025-02-11,34,DPD15-29,6,6,0
2025-02-11,34,DPD3-14,14,14,0
2025-02-11,34,DPD30-59,17,17,0
2025-02-11,34,DPD60-89,0,0,0
2025-02-11,34,DPD90+,0,0,0
2025-02-11,36,Current,0,0,0
2025-02-11,36,DPD15-29,4,4,0
2025-02-11,36,DPD3-14,9,9,0
2025-02-11,36,DPD30-59,14,14,0
2025-02-11,36,DPD60-89,0,0,0
2025-02-11,36,DPD90+,0,0,0
2025-02-11,38,Current,7,7,0
2025-02-11,38,DPD15-29,7,7,0
2025-02-11,38,DPD3-14,15,15,0
2025-02-11,38,DPD30-59,13,13,0
2025-02-11,38,DPD60-89,0,0,0
2025-02-11,38,DPD90+,0,0,0
2025-02-11,40,Current,1,1,0
2025-02-11,40,DPD15-29,0,0,0
2025-02-11,40,DPD3-14,5,5,0
2025-02-11,40,DPD30-59,8,8,0
2025-02-11,40,DPD60-89,0,0,0
2025-02-11,40,DPD90+,0,0,0
2025-02-11,42,Current,0,0,0
2025-02-11,42,DPD15-29,5,5,0
2025-02-11,42,DPD3-14,3,3,0
2025-02-11,42,DPD30-59,6,6,0
2025-02-11,42,DPD60-89,0,0,0
2025-02-11,42,DPD90+,0,0,0
2025-02-11,44,Current,0,0,0
2025-02-11,44,DPD15-29,5,5,0
2025-02-11,44,DPD3-14,13,13,0
2025-02-11,44,DPD30-59,8,8,0
2025-02-11,44,DPD60-89,0,0,0
2025-02-11,44,DPD90+,0,0,0
2025-02-11,46,Current,0,0,0
2025-02-11,46,DPD30-59,0,0,0
2025-02-11,46,DPD60-89,0,0,0
2025-02-11,48,Current,22,22,0
2025-02-11,48,DPD15-29,13,13,0
2025-02-11,48,DPD3-14,20,20,0
2025-02-11,48,DPD30-59,10,10,0
2025-02-11,48,DPD60-89,0,0,0
2025-02-11,48,DPD90+,0,0,0
2025-02-11,6,Current,0,0,0
2025-02-10,100,Current,0,0,0
2025-02-10,100,DPD3-14,0,0,0
2025-02-10,102,Current,0,0,0
2025-02-10,102,DPD15-29,0,0,0
2025-02-10,102,DPD3-14,0,0,0
2025-02-10,104,Current,0,0,0
2025-02-10,20,Current,2,2,0
2025-02-10,20,DPD15-29,343,343,0
2025-02-10,20,DPD3-14,58,58,0
2025-02-10,20,DPD30-59,317,317,0
2025-02-10,20,DPD60-89,0,0,0
2025-02-10,20,DPD90+,0,0,0
2025-02-10,22,Current,0,0,0
2025-02-10,22,DPD3-14,0,0,0
2025-02-10,24,Current,23,23,0
2025-02-10,24,DPD15-29,225,225,0
2025-02-10,24,DPD3-14,47,47,0
2025-02-10,24,DPD30-59,189,189,0
2025-02-10,24,DPD60-89,0,0,0
2025-02-10,24,DPD90+,0,0,0
2025-02-10,26,Current,0,0,0
2025-02-10,26,DPD15-29,23,23,0
2025-02-10,26,DPD3-14,4,4,0
2025-02-10,26,DPD30-59,20,20,0
2025-02-10,26,DPD60-89,0,0,0
2025-02-10,26,DPD90+,0,0,0
2025-02-10,32,Current,0,0,0
2025-02-10,32,DPD15-29,171,171,0
2025-02-10,32,DPD3-14,14,14,0
2025-02-10,32,DPD30-59,151,151,0
2025-02-10,32,DPD60-89,0,0,0
2025-02-10,32,DPD90+,0,0,0
2025-02-10,34,Current,0,0,0
2025-02-10,34,DPD15-29,78,78,0
2025-02-10,34,DPD3-14,12,12,0
2025-02-10,34,DPD30-59,48,48,0
2025-02-10,34,DPD60-89,0,0,0
2025-02-10,34,DPD90+,0,0,0
2025-02-10,36,Current,0,0,0
2025-02-10,36,DPD15-29,47,47,0
2025-02-10,36,DPD3-14,7,7,0
2025-02-10,36,DPD30-59,45,45,0
2025-02-10,36,DPD60-89,0,0,0
2025-02-10,36,DPD90+,0,0,0
2025-02-10,38,Current,9,9,0
2025-02-10,38,DPD15-29,50,50,0
2025-02-10,38,DPD3-14,12,12,0
2025-02-10,38,DPD30-59,64,64,0
2025-02-10,38,DPD60-89,0,0,0
2025-02-10,38,DPD90+,0,0,0
2025-02-10,40,Current,0,0,0
2025-02-10,40,DPD15-29,34,34,0
2025-02-10,40,DPD3-14,4,4,0
2025-02-10,40,DPD30-59,33,33,0
2025-02-10,40,DPD60-89,0,0,0
2025-02-10,40,DPD90+,0,0,0
2025-02-10,42,Current,0,0,0
2025-02-10,42,DPD15-29,14,14,0
2025-02-10,42,DPD3-14,2,2,0
2025-02-10,42,DPD30-59,17,17,0
2025-02-10,42,DPD60-89,0,0,0
2025-02-10,42,DPD90+,0,0,0
2025-02-10,44,Current,0,0,0
2025-02-10,44,DPD15-29,47,47,0
2025-02-10,44,DPD3-14,7,7,0
2025-02-10,44,DPD30-59,36,36,0
2025-02-10,44,DPD60-89,0,0,0
2025-02-10,44,DPD90+,0,0,0
2025-02-10,46,Current,0,0,0
2025-02-10,46,DPD30-59,0,0,0
2025-02-10,46,DPD60-89,0,0,0
2025-02-10,48,Current,32,32,0
2025-02-10,48,DPD15-29,66,66,0
2025-02-10,48,DPD3-14,15,15,0
2025-02-10,48,DPD30-59,52,52,0
2025-02-10,48,DPD60-89,0,0,0
2025-02-10,48,DPD90+,0,0,0
2025-02-10,6,Current,0,0,0
2025-02-09,100,Current,0,0,0
2025-02-09,100,DPD3-14,1,1,0
2025-02-09,102,Current,0,0,0
2025-02-09,102,DPD15-29,1,1,0
2025-02-09,102,DPD3-14,0,0,0
2025-02-09,104,Current,0,0,0
2025-02-09,20,Current,0,0,0
2025-02-09,20,DPD15-29,29,29,0
2025-02-09,20,DPD3-14,65,65,0
2025-02-09,20,DPD30-59,2,2,0
2025-02-09,20,DPD60-89,0,0,0
2025-02-09,20,DPD90+,0,0,0
2025-02-09,22,Current,0,0,0
2025-02-09,22,DPD3-14,0,0,0
2025-02-09,24,Current,12,12,0
2025-02-09,24,DPD15-29,10,10,0
2025-02-09,24,DPD3-14,77,77,0
2025-02-09,24,DPD30-59,1,1,0
2025-02-09,24,DPD60-89,0,0,0
2025-02-09,24,DPD90+,0,0,0
2025-02-09,26,Current,0,0,0
2025-02-09,26,DPD15-29,5,5,0
2025-02-09,26,DPD3-14,13,13,0
2025-02-09,26,DPD30-59,0,0,0
2025-02-09,26,DPD60-89,0,0,0
2025-02-09,26,DPD90+,0,0,0
2025-02-09,32,Current,0,0,0
2025-02-09,32,DPD15-29,16,16,0
2025-02-09,32,DPD3-14,28,28,0
2025-02-09,32,DPD30-59,0,0,0
2025-02-09,32,DPD60-89,0,0,0
2025-02-09,32,DPD90+,0,0,0
2025-02-09,34,Current,0,0,0
2025-02-09,34,DPD15-29,7,7,0
2025-02-09,34,DPD3-14,13,13,0
2025-02-09,34,DPD30-59,0,0,0
2025-02-09,34,DPD60-89,0,0,0
2025-02-09,34,DPD90+,0,0,0
2025-02-09,36,Current,0,0,0
2025-02-09,36,DPD15-29,4,4,0
2025-02-09,36,DPD3-14,8,8,0
2025-02-09,36,DPD30-59,0,0,0
2025-02-09,36,DPD60-89,0,0,0
2025-02-09,36,DPD90+,0,0,0
2025-02-09,38,Current,3,3,0
2025-02-09,38,DPD15-29,6,6,0
2025-02-09,38,DPD3-14,12,12,0
2025-02-09,38,DPD30-59,0,0,0
2025-02-09,38,DPD60-89,0,0,0
2025-02-09,38,DPD90+,0,0,0
2025-02-09,40,Current,1,1,0
2025-02-09,40,DPD15-29,5,5,0
2025-02-09,40,DPD3-14,2,2,0
2025-02-09,40,DPD30-59,0,0,0
2025-02-09,40,DPD60-89,0,0,0
2025-02-09,40,DPD90+,0,0,0
2025-02-09,42,Current,0,0,0
2025-02-09,42,DPD15-29,1,1,0
2025-02-09,42,DPD3-14,3,3,0
2025-02-09,42,DPD30-59,0,0,0
2025-02-09,42,DPD60-89,0,0,0
2025-02-09,42,DPD90+,0,0,0
2025-02-09,44,Current,0,0,0
2025-02-09,44,DPD15-29,3,3,0
2025-02-09,44,DPD3-14,4,4,0
2025-02-09,44,DPD30-59,1,1,0
2025-02-09,44,DPD60-89,0,0,0
2025-02-09,44,DPD90+,0,0,0
2025-02-09,46,Current,0,0,0
2025-02-09,46,DPD30-59,0,0,0
2025-02-09,46,DPD60-89,0,0,0
2025-02-09,48,Current,5,5,0
2025-02-09,48,DPD15-29,3,3,0
2025-02-09,48,DPD3-14,20,20,0
2025-02-09,48,DPD30-59,0,0,0
2025-02-09,48,DPD60-89,0,0,0
2025-02-09,48,DPD90+,0,0,0
2025-02-09,6,Current,0,0,0
2025-02-08,100,Current,0,0,0
2025-02-08,100,DPD3-14,0,0,0
2025-02-08,102,Current,0,0,0
2025-02-08,102,DPD15-29,0,0,0
2025-02-08,104,Current,0,0,0
2025-02-08,20,Current,0,0,0
2025-02-08,20,DPD15-29,40,40,0
2025-02-08,20,DPD3-14,175,175,0
2025-02-08,20,DPD30-59,5,5,0
2025-02-08,20,DPD60-89,0,0,0
2025-02-08,20,DPD90+,0,0,0
2025-02-08,22,Current,0,0,0
2025-02-08,22,DPD3-14,0,0,0
2025-02-08,24,Current,8,8,0
2025-02-08,24,DPD15-29,26,26,0
2025-02-08,24,DPD3-14,119,119,0
2025-02-08,24,DPD30-59,1,1,0
2025-02-08,24,DPD60-89,0,0,0
2025-02-08,24,DPD90+,0,0,0
2025-02-08,26,Current,0,0,0
2025-02-08,26,DPD15-29,4,4,0
2025-02-08,26,DPD3-14,19,19,0
2025-02-08,26,DPD30-59,0,0,0
2025-02-08,26,DPD60-89,0,0,0
2025-02-08,26,DPD90+,0,0,0
2025-02-08,32,Current,0,0,0
2025-02-08,32,DPD15-29,25,25,0
2025-02-08,32,DPD3-14,69,69,0
2025-02-08,32,DPD30-59,4,4,0
2025-02-08,32,DPD60-89,0,0,0
2025-02-08,32,DPD90+,0,0,0
2025-02-08,34,Current,0,0,0
2025-02-08,34,DPD15-29,11,11,0
2025-02-08,34,DPD3-14,31,31,0
2025-02-08,34,DPD30-59,2,2,0
2025-02-08,34,DPD60-89,0,0,0
2025-02-08,34,DPD90+,0,0,0
2025-02-08,36,Current,0,0,0
2025-02-08,36,DPD15-29,4,4,0
2025-02-08,36,DPD3-14,29,29,0
2025-02-08,36,DPD30-59,0,0,0
2025-02-08,36,DPD60-89,0,0,0
2025-02-08,36,DPD90+,0,0,0
2025-02-08,38,Current,1,1,0
2025-02-08,38,DPD15-29,7,7,0
2025-02-08,38,DPD3-14,44,44,0
2025-02-08,38,DPD30-59,1,1,0
2025-02-08,38,DPD60-89,0,0,0
2025-02-08,38,DPD90+,0,0,0
2025-02-08,40,Current,0,0,0
2025-02-08,40,DPD15-29,5,5,0
2025-02-08,40,DPD3-14,12,12,0
2025-02-08,40,DPD30-59,0,0,0
2025-02-08,40,DPD60-89,0,0,0
2025-02-08,40,DPD90+,0,0,0
2025-02-08,42,Current,0,0,0
2025-02-08,42,DPD15-29,2,2,0
2025-02-08,42,DPD3-14,11,11,0
2025-02-08,42,DPD30-59,0,0,0
2025-02-08,42,DPD60-89,0,0,0
2025-02-08,42,DPD90+,0,0,0
2025-02-08,44,Current,0,0,0
2025-02-08,44,DPD15-29,5,5,0
2025-02-08,44,DPD3-14,23,23,0
2025-02-08,44,DPD30-59,0,0,0
2025-02-08,44,DPD60-89,0,0,0
2025-02-08,44,DPD90+,0,0,0
2025-02-08,46,Current,0,0,0
2025-02-08,46,DPD30-59,0,0,0
2025-02-08,46,DPD60-89,0,0,0
2025-02-08,48,Current,6,6,0
2025-02-08,48,DPD15-29,5,5,0
2025-02-08,48,DPD3-14,21,21,0
2025-02-08,48,DPD30-59,1,1,0
2025-02-08,48,DPD60-89,0,0,0
2025-02-08,48,DPD90+,0,0,0
2025-02-08,6,Current,0,0,0
2025-02-07,100,Current,0,0,0
2025-02-07,100,DPD3-14,0,0,0
2025-02-07,102,Current,1,1,0
2025-02-07,102,DPD3-14,0,0,0
2025-02-07,104,Current,0,0,0
2025-02-07,20,Current,178,178,0
2025-02-07,20,DPD15-29,224,224,0
2025-02-07,20,DPD3-14,354,354,0
2025-02-07,20,DPD30-59,479,479,0
2025-02-07,20,DPD60-89,0,0,0
2025-02-07,20,DPD90+,0,0,0
2025-02-07,22,Current,0,0,0
2025-02-07,22,DPD3-14,1,1,0
2025-02-07,22,DPD60-89,0,0,0
2025-02-07,24,Current,150,150,0
2025-02-07,24,DPD15-29,141,141,0
2025-02-07,24,DPD3-14,206,206,0
2025-02-07,24,DPD30-59,261,261,0
2025-02-07,24,DPD60-89,0,0,0
2025-02-07,24,DPD90+,0,0,0
2025-02-07,26,Current,16,16,0
2025-02-07,26,DPD15-29,12,12,0
2025-02-07,26,DPD3-14,25,25,0
2025-02-07,26,DPD30-59,33,33,0
2025-02-07,26,DPD60-89,0,0,0
2025-02-07,26,DPD90+,0,0,0
2025-02-07,32,Current,64,64,0
2025-02-07,32,DPD15-29,93,93,0
2025-02-07,32,DPD3-14,185,185,0
2025-02-07,32,DPD30-59,240,240,0
2025-02-07,32,DPD60-89,0,0,0
2025-02-07,32,DPD90+,0,0,0
2025-02-07,34,Current,22,22,0
2025-02-07,34,DPD15-29,37,37,0
2025-02-07,34,DPD3-14,67,67,0
2025-02-07,34,DPD30-59,83,83,0
2025-02-07,34,DPD60-89,0,0,0
2025-02-07,34,DPD90+,0,0,0
2025-02-07,36,Current,9,9,0
2025-02-07,36,DPD15-29,23,23,0
2025-02-07,36,DPD3-14,43,43,0
2025-02-07,36,DPD30-59,75,75,0
2025-02-07,36,DPD60-89,0,0,0
2025-02-07,36,DPD90+,0,0,0
2025-02-07,38,Current,5,5,0
2025-02-07,38,DPD15-29,7,7,0
2025-02-07,38,DPD3-14,38,38,0
2025-02-07,38,DPD30-59,13,13,0
2025-02-07,38,DPD60-89,0,0,0
2025-02-07,38,DPD90+,0,0,0
2025-02-07,40,Current,4,4,0
2025-02-07,40,DPD15-29,0,0,0
2025-02-07,40,DPD3-14,9,9,0
2025-02-07,40,DPD30-59,4,4,0
2025-02-07,40,DPD60-89,0,0,0
2025-02-07,40,DPD90+,0,0,0
2025-02-07,42,Current,15,15,0
2025-02-07,42,DPD15-29,11,11,0
2025-02-07,42,DPD3-14,21,21,0
2025-02-07,42,DPD30-59,26,26,0
2025-02-07,42,DPD60-89,0,0,0
2025-02-07,42,DPD90+,0,0,0
2025-02-07,44,Current,35,35,0
2025-02-07,44,DPD15-29,19,19,0
2025-02-07,44,DPD3-14,44,44,0
2025-02-07,44,DPD30-59,57,57,0
2025-02-07,44,DPD60-89,0,0,0
2025-02-07,44,DPD90+,0,0,0
2025-02-07,46,Current,0,0,0
2025-02-07,46,DPD30-59,2,2,0
2025-02-07,46,DPD60-89,0,0,0
2025-02-07,48,Current,21,21,0
2025-02-07,48,DPD15-29,6,6,0
2025-02-07,48,DPD3-14,33,33,0
2025-02-07,48,DPD30-59,6,6,0
2025-02-07,48,DPD60-89,0,0,0
2025-02-07,48,DPD90+,0,0,0
2025-02-07,6,Current,0,0,0
2025-02-06,100,Current,0,0,0
2025-02-06,100,DPD3-14,0,0,0
2025-02-06,102,Current,0,0,0
2025-02-06,102,DPD3-14,0,0,0
2025-02-06,104,Current,0,0,0
2025-02-06,20,Current,0,0,0
2025-02-06,20,DPD15-29,457,457,0
2025-02-06,20,DPD3-14,54,54,0
2025-02-06,20,DPD30-59,399,399,0
2025-02-06,20,DPD60-89,1,1,0
2025-02-06,20,DPD90+,0,0,0
2025-02-06,22,Current,0,0,0
2025-02-06,22,DPD3-14,0,0,0
2025-02-06,24,Current,1,1,0
2025-02-06,24,DPD15-29,300,300,0
2025-02-06,24,DPD3-14,57,57,0
2025-02-06,24,DPD30-59,235,235,0
2025-02-06,24,DPD60-89,0,0,0
2025-02-06,24,DPD90+,0,0,0
2025-02-06,26,Current,0,0,0
2025-02-06,26,DPD15-29,35,35,0
2025-02-06,26,DPD3-14,5,5,0
2025-02-06,26,DPD30-59,21,21,0
2025-02-06,26,DPD60-89,0,0,0
2025-02-06,26,DPD90+,0,0,0
2025-02-06,32,Current,0,0,0
2025-02-06,32,DPD15-29,207,207,0
2025-02-06,32,DPD3-14,31,31,0
2025-02-06,32,DPD30-59,194,194,0
2025-02-06,32,DPD60-89,0,0,0
2025-02-06,32,DPD90+,0,0,0
2025-02-06,34,Current,1,1,0
2025-02-06,34,DPD15-29,82,82,0
2025-02-06,34,DPD3-14,8,8,0
2025-02-06,34,DPD30-59,60,60,0
2025-02-06,34,DPD60-89,0,0,0
2025-02-06,34,DPD90+,0,0,0
2025-02-06,36,Current,0,0,0
2025-02-06,36,DPD15-29,53,53,0
2025-02-06,36,DPD3-14,10,10,0
2025-02-06,36,DPD30-59,51,51,0
2025-02-06,36,DPD60-89,0,0,0
2025-02-06,36,DPD90+,0,0,0
2025-02-06,38,Current,4,4,0
2025-02-06,38,DPD15-29,60,60,0
2025-02-06,38,DPD3-14,11,11,0
2025-02-06,38,DPD30-59,75,75,0
2025-02-06,38,DPD60-89,0,0,0
2025-02-06,38,DPD90+,0,0,0
2025-02-06,40,Current,0,0,0
2025-02-06,40,DPD15-29,46,46,0
2025-02-06,40,DPD3-14,3,3,0
2025-02-06,40,DPD30-59,42,42,0
2025-02-06,40,DPD60-89,0,0,0
2025-02-06,40,DPD90+,0,0,0
2025-02-06,42,Current,0,0,0
2025-02-06,42,DPD15-29,19,19,0
2025-02-06,42,DPD3-14,6,6,0
2025-02-06,42,DPD30-59,25,25,0
2025-02-06,42,DPD60-89,0,0,0
2025-02-06,42,DPD90+,0,0,0
2025-02-06,44,Current,0,0,0
2025-02-06,44,DPD15-29,54,54,0
2025-02-06,44,DPD3-14,9,9,0
2025-02-06,44,DPD30-59,43,43,0
2025-02-06,44,DPD60-89,0,0,0
2025-02-06,44,DPD90+,0,0,0
2025-02-06,46,Current,0,0,0
2025-02-06,46,DPD30-59,1,1,0
2025-02-06,48,Current,6,6,0
2025-02-06,48,DPD15-29,88,88,0
2025-02-06,48,DPD3-14,21,21,0
2025-02-06,48,DPD30-59,63,63,0
2025-02-06,48,DPD60-89,0,0,0
2025-02-06,48,DPD90+,0,0,0
2025-02-06,6,Current,0,0,0
2025-02-05,100,Current,0,0,0
2025-02-05,102,Current,0,0,0
2025-02-05,102,DPD3-14,0,0,0
2025-02-05,104,Current,0,0,0
2025-02-05,20,Current,4,4,0
2025-02-05,20,DPD15-29,0,0,0
2025-02-05,20,DPD3-14,0,0,0
2025-02-05,20,DPD30-59,1,1,0
2025-02-05,20,DPD60-89,0,0,0
2025-02-05,20,DPD90+,0,0,0
2025-02-05,22,Current,0,0,0
2025-02-05,22,DPD3-14,0,0,0
2025-02-05,22,DPD90+,0,0,0
2025-02-05,24,Current,20,20,0
2025-02-05,24,DPD15-29,0,0,0
2025-02-05,24,DPD3-14,8,8,0
2025-02-05,24,DPD30-59,0,0,0
2025-02-05,24,DPD60-89,0,0,0
2025-02-05,24,DPD90+,0,0,0
2025-02-05,26,Current,0,0,0
2025-02-05,26,DPD15-29,1,1,0
2025-02-05,26,DPD3-14,0,0,0
2025-02-05,26,DPD30-59,0,0,0
2025-02-05,26,DPD60-89,0,0,0
2025-02-05,26,DPD90+,0,0,0
2025-02-05,32,Current,1,1,0
2025-02-05,32,DPD15-29,0,0,0
2025-02-05,32,DPD3-14,0,0,0
2025-02-05,32,DPD30-59,0,0,0
2025-02-05,32,DPD60-89,0,0,0
2025-02-05,32,DPD90+,0,0,0
2025-02-05,34,Current,0,0,0
2025-02-05,34,DPD15-29,0,0,0
2025-02-05,34,DPD3-14,0,0,0
2025-02-05,34,DPD30-59,0,0,0
2025-02-05,34,DPD60-89,0,0,0
2025-02-05,34,DPD90+,0,0,0
2025-02-05,36,Current,3,3,0
2025-02-05,36,DPD15-29,0,0,0
2025-02-05,36,DPD3-14,0,0,0
2025-02-05,36,DPD30-59,0,0,0
2025-02-05,36,DPD60-89,0,0,0
2025-02-05,36,DPD90+,0,0,0
2025-02-05,38,Current,2,2,0
2025-02-05,38,DPD15-29,0,0,0
2025-02-05,38,DPD3-14,0,0,0
2025-02-05,38,DPD30-59,0,0,0
2025-02-05,38,DPD60-89,0,0,0
2025-02-05,38,DPD90+,0,0,0
2025-02-05,40,Current,0,0,0
2025-02-05,40,DPD15-29,0,0,0
2025-02-05,40,DPD3-14,0,0,0
2025-02-05,40,DPD30-59,0,0,0
2025-02-05,40,DPD60-89,0,0,0
2025-02-05,40,DPD90+,0,0,0
2025-02-05,42,Current,0,0,0
2025-02-05,42,DPD15-29,0,0,0
2025-02-05,42,DPD3-14,0,0,0
2025-02-05,42,DPD30-59,0,0,0
2025-02-05,42,DPD60-89,0,0,0
2025-02-05,42,DPD90+,0,0,0
2025-02-05,44,Current,5,5,0
2025-02-05,44,DPD15-29,0,0,0
2025-02-05,44,DPD3-14,0,0,0
2025-02-05,44,DPD30-59,0,0,0
2025-02-05,44,DPD60-89,0,0,0
2025-02-05,44,DPD90+,0,0,0
2025-02-05,46,Current,0,0,0
2025-02-05,46,DPD15-29,0,0,0
2025-02-05,46,DPD30-59,0,0,0
2025-02-05,48,Current,9,9,0
2025-02-05,48,DPD15-29,0,0,0
2025-02-05,48,DPD3-14,0,0,0
2025-02-05,48,DPD30-59,0,0,0
2025-02-05,48,DPD60-89,0,0,0
2025-02-05,48,DPD90+,0,0,0
2025-02-05,6,Current,0,0,0
2025-02-04,100,Current,0,0,0
2025-02-04,102,Current,0,0,0
2025-02-04,102,DPD15-29,0,0,0
2025-02-04,102,DPD3-14,0,0,0
2025-02-04,104,Current,0,0,0
2025-02-04,20,Current,1,1,0
2025-02-04,20,DPD15-29,0,0,0
2025-02-04,20,DPD3-14,0,0,0
2025-02-04,20,DPD30-59,0,0,0
2025-02-04,20,DPD60-89,0,0,0
2025-02-04,20,DPD90+,0,0,0
2025-02-04,22,Current,0,0,0
2025-02-04,22,DPD3-14,0,0,0
2025-02-04,22,DPD60-89,0,0,0
2025-02-04,24,Current,19,19,0
2025-02-04,24,DPD15-29,1,1,0
2025-02-04,24,DPD3-14,0,0,0
2025-02-04,24,DPD30-59,0,0,0
2025-02-04,24,DPD60-89,0,0,0
2025-02-04,24,DPD90+,0,0,0
2025-02-04,26,Current,0,0,0
2025-02-04,26,DPD15-29,0,0,0
2025-02-04,26,DPD3-14,0,0,0
2025-02-04,26,DPD30-59,0,0,0
2025-02-04,26,DPD60-89,0,0,0
2025-02-04,26,DPD90+,0,0,0
2025-02-04,32,Current,0,0,0
2025-02-04,32,DPD15-29,0,0,0
2025-02-04,32,DPD3-14,0,0,0
2025-02-04,32,DPD30-59,0,0,0
2025-02-04,32,DPD60-89,0,0,0
2025-02-04,32,DPD90+,0,0,0
2025-02-04,34,Current,0,0,0
2025-02-04,34,DPD15-29,0,0,0
2025-02-04,34,DPD3-14,0,0,0
2025-02-04,34,DPD30-59,0,0,0
2025-02-04,34,DPD60-89,0,0,0
2025-02-04,34,DPD90+,0,0,0
2025-02-04,36,Current,0,0,0
2025-02-04,36,DPD15-29,0,0,0
2025-02-04,36,DPD3-14,0,0,0
2025-02-04,36,DPD30-59,0,0,0
2025-02-04,36,DPD60-89,0,0,0
2025-02-04,36,DPD90+,0,0,0
2025-02-04,38,Current,1,1,0
2025-02-04,38,DPD15-29,0,0,0
2025-02-04,38,DPD3-14,0,0,0
2025-02-04,38,DPD30-59,0,0,0
2025-02-04,38,DPD60-89,0,0,0
2025-02-04,38,DPD90+,0,0,0
2025-02-04,40,Current,0,0,0
2025-02-04,40,DPD15-29,0,0,0
2025-02-04,40,DPD3-14,0,0,0
2025-02-04,40,DPD30-59,0,0,0
2025-02-04,40,DPD60-89,0,0,0
2025-02-04,40,DPD90+,0,0,0
2025-02-04,42,Current,0,0,0
2025-02-04,42,DPD15-29,0,0,0
2025-02-04,42,DPD3-14,0,0,0
2025-02-04,42,DPD30-59,0,0,0
2025-02-04,42,DPD60-89,0,0,0
2025-02-04,42,DPD90+,0,0,0
2025-02-04,44,Current,1,1,0
2025-02-04,44,DPD15-29,0,0,0
2025-02-04,44,DPD3-14,0,0,0
2025-02-04,44,DPD30-59,0,0,0
2025-02-04,44,DPD60-89,0,0,0
2025-02-04,44,DPD90+,0,0,0
2025-02-04,46,Current,0,0,0
2025-02-04,46,DPD15-29,0,0,0
2025-02-04,46,DPD3-14,0,0,0
2025-02-04,46,DPD30-59,0,0,0
2025-02-04,48,Current,22,22,0
2025-02-04,48,DPD15-29,0,0,0
2025-02-04,48,DPD3-14,0,0,0
2025-02-04,48,DPD30-59,0,0,0
2025-02-04,48,DPD60-89,0,0,0
2025-02-04,48,DPD90+,0,0,0
2025-02-04,6,Current,0,0,0
2025-02-03,100,Current,0,0,0
2025-02-03,102,Current,0,0,0
2025-02-03,102,DPD15-29,0,0,0
2025-02-03,102,DPD3-14,0,0,0
2025-02-03,104,Current,0,0,0
2025-02-03,20,Current,0,0,0
2025-02-03,20,DPD15-29,0,0,0
2025-02-03,20,DPD3-14,0,0,0
2025-02-03,20,DPD30-59,0,0,0
2025-02-03,20,DPD60-89,0,0,0
2025-02-03,20,DPD90+,0,0,0
2025-02-03,22,Current,0,0,0
2025-02-03,22,DPD3-14,0,0,0
2025-02-03,22,DPD60-89,0,0,0
2025-02-03,24,Current,10,10,0
2025-02-03,24,DPD15-29,3,3,0
2025-02-03,24,DPD3-14,0,0,0
2025-02-03,24,DPD30-59,0,0,0
2025-02-03,24,DPD60-89,0,0,0
2025-02-03,24,DPD90+,0,0,0
2025-02-03,26,Current,0,0,0
2025-02-03,26,DPD15-29,0,0,0
2025-02-03,26,DPD3-14,0,0,0
2025-02-03,26,DPD30-59,0,0,0
2025-02-03,26,DPD60-89,0,0,0
2025-02-03,26,DPD90+,0,0,0
2025-02-03,32,Current,3,3,0
2025-02-03,32,DPD15-29,0,0,0
2025-02-03,32,DPD3-14,0,0,0
2025-02-03,32,DPD30-59,0,0,0
2025-02-03,32,DPD60-89,0,0,0
2025-02-03,32,DPD90+,0,0,0
2025-02-03,34,Current,0,0,0
2025-02-03,34,DPD15-29,0,0,0
2025-02-03,34,DPD3-14,0,0,0
2025-02-03,34,DPD30-59,0,0,0
2025-02-03,34,DPD60-89,0,0,0
2025-02-03,34,DPD90+,0,0,0
2025-02-03,36,Current,0,0,0
2025-02-03,36,DPD15-29,0,0,0
2025-02-03,36,DPD3-14,0,0,0
2025-02-03,36,DPD30-59,0,0,0
2025-02-03,36,DPD60-89,0,0,0
2025-02-03,36,DPD90+,0,0,0
2025-02-03,38,Current,5,5,0
2025-02-03,38,DPD15-29,0,0,0
2025-02-03,38,DPD3-14,0,0,0
2025-02-03,38,DPD30-59,0,0,0
2025-02-03,38,DPD60-89,0,0,0
2025-02-03,38,DPD90+,0,0,0
2025-02-03,40,Current,0,0,0
2025-02-03,40,DPD15-29,0,0,0
2025-02-03,40,DPD3-14,0,0,0
2025-02-03,40,DPD30-59,0,0,0
2025-02-03,40,DPD60-89,0,0,0
2025-02-03,40,DPD90+,0,0,0
2025-02-03,42,Current,0,0,0
2025-02-03,42,DPD15-29,0,0,0
2025-02-03,42,DPD3-14,0,0,0
2025-02-03,42,DPD30-59,0,0,0
2025-02-03,42,DPD60-89,0,0,0
2025-02-03,42,DPD90+,0,0,0
2025-02-03,44,Current,4,4,0
2025-02-03,44,DPD15-29,0,0,0
2025-02-03,44,DPD3-14,0,0,0
2025-02-03,44,DPD30-59,0,0,0
2025-02-03,44,DPD60-89,0,0,0
2025-02-03,44,DPD90+,0,0,0
2025-02-03,46,Current,0,0,0
2025-02-03,46,DPD15-29,0,0,0
2025-02-03,46,DPD30-59,0,0,0
2025-02-03,48,Current,10,10,0
2025-02-03,48,DPD15-29,0,0,0
2025-02-03,48,DPD3-14,0,0,0
2025-02-03,48,DPD30-59,0,0,0
2025-02-03,48,DPD60-89,0,0,0
2025-02-03,48,DPD90+,0,0,0
2025-02-03,6,Current,0,0,0
2025-02-02,100,Current,0,0,0
2025-02-02,102,Current,0,0,0
2025-02-02,102,DPD15-29,0,0,0
2025-02-02,102,DPD3-14,0,0,0
2025-02-02,104,Current,0,0,0
2025-02-02,20,Current,0,0,0
2025-02-02,20,DPD15-29,0,0,0
2025-02-02,20,DPD3-14,0,0,0
2025-02-02,20,DPD30-59,0,0,0
2025-02-02,20,DPD60-89,0,0,0
2025-02-02,20,DPD90+,0,0,0
2025-02-02,22,Current,0,0,0
2025-02-02,22,DPD3-14,0,0,0
2025-02-02,22,DPD60-89,0,0,0
2025-02-02,24,Current,21,21,0
2025-02-02,24,DPD15-29,0,0,0
2025-02-02,24,DPD3-14,0,0,0
2025-02-02,24,DPD30-59,0,0,0
2025-02-02,24,DPD60-89,0,0,0
2025-02-02,24,DPD90+,0,0,0
2025-02-02,26,Current,0,0,0
2025-02-02,26,DPD15-29,0,0,0
2025-02-02,26,DPD3-14,0,0,0
2025-02-02,26,DPD30-59,0,0,0
2025-02-02,26,DPD60-89,0,0,0
2025-02-02,26,DPD90+,0,0,0
2025-02-02,32,Current,0,0,0
2025-02-02,32,DPD15-29,0,0,0
2025-02-02,32,DPD3-14,0,0,0
2025-02-02,32,DPD30-59,0,0,0
2025-02-02,32,DPD60-89,0,0,0
2025-02-02,32,DPD90+,0,0,0
2025-02-02,34,Current,0,0,0
2025-02-02,34,DPD15-29,0,0,0
2025-02-02,34,DPD3-14,0,0,0
2025-02-02,34,DPD30-59,0,0,0
2025-02-02,34,DPD60-89,0,0,0
2025-02-02,34,DPD90+,0,0,0
2025-02-02,36,Current,0,0,0
2025-02-02,36,DPD15-29,0,0,0
2025-02-02,36,DPD3-14,0,0,0
2025-02-02,36,DPD30-59,0,0,0
2025-02-02,36,DPD60-89,0,0,0
2025-02-02,36,DPD90+,0,0,0
2025-02-02,38,Current,5,5,0
2025-02-02,38,DPD15-29,0,0,0
2025-02-02,38,DPD3-14,0,0,0
2025-02-02,38,DPD30-59,0,0,0
2025-02-02,38,DPD60-89,0,0,0
2025-02-02,38,DPD90+,0,0,0
2025-02-02,40,Current,0,0,0
2025-02-02,40,DPD15-29,0,0,0
2025-02-02,40,DPD3-14,0,0,0
2025-02-02,40,DPD30-59,0,0,0
2025-02-02,40,DPD60-89,0,0,0
2025-02-02,40,DPD90+,0,0,0
2025-02-02,42,Current,0,0,0
2025-02-02,42,DPD15-29,0,0,0
2025-02-02,42,DPD3-14,0,0,0
2025-02-02,42,DPD30-59,0,0,0
2025-02-02,42,DPD60-89,0,0,0
2025-02-02,42,DPD90+,0,0,0
2025-02-02,44,Current,2,2,0
2025-02-02,44,DPD15-29,0,0,0
2025-02-02,44,DPD3-14,0,0,0
2025-02-02,44,DPD30-59,0,0,0
2025-02-02,44,DPD60-89,0,0,0
2025-02-02,44,DPD90+,0,0,0
2025-02-02,46,Current,0,0,0
2025-02-02,46,DPD15-29,0,0,0
2025-02-02,46,DPD30-59,0,0,0
2025-02-02,48,Current,19,19,0
2025-02-02,48,DPD15-29,0,0,0
2025-02-02,48,DPD3-14,0,0,0
2025-02-02,48,DPD30-59,0,0,0
2025-02-02,48,DPD60-89,0,0,0
2025-02-02,48,DPD90+,0,0,0
2025-02-02,6,Current,0,0,0
2025-02-01,100,Current,0,0,0
2025-02-01,102,Current,0,0,0
2025-02-01,102,DPD15-29,0,0,0
2025-02-01,102,DPD3-14,0,0,0
2025-02-01,104,Current,0,0,0
2025-02-01,20,Current,3450,3450,0
2025-02-01,20,DPD15-29,80,80,0
2025-02-01,20,DPD3-14,73,73,0
2025-02-01,20,DPD30-59,86,86,0
2025-02-01,20,DPD60-89,54,54,0
2025-02-01,20,DPD90+,46,46,0
2025-02-01,22,Current,0,0,0
2025-02-01,22,DPD3-14,0,0,0
2025-02-01,22,DPD60-89,0,0,0
2025-02-01,24,Current,4675,4675,0
2025-02-01,24,DPD15-29,54,54,0
2025-02-01,24,DPD3-14,73,73,0
2025-02-01,24,DPD30-59,58,58,0
2025-02-01,24,DPD60-89,31,31,0
2025-02-01,24,DPD90+,22,22,0
2025-02-01,26,Current,0,0,0
2025-02-01,26,DPD15-29,0,0,0
2025-02-01,26,DPD3-14,0,0,0
2025-02-01,26,DPD30-59,0,0,0
2025-02-01,26,DPD60-89,0,0,0
2025-02-01,26,DPD90+,0,0,0
2025-02-01,32,Current,168,168,0
2025-02-01,32,DPD15-29,4,4,0
2025-02-01,32,DPD3-14,10,10,0
2025-02-01,32,DPD30-59,5,5,0
2025-02-01,32,DPD60-89,3,3,0
2025-02-01,32,DPD90+,4,4,0
2025-02-01,34,Current,0,0,0
2025-02-01,34,DPD15-29,0,0,0
2025-02-01,34,DPD3-14,0,0,0
2025-02-01,34,DPD30-59,0,0,0
2025-02-01,34,DPD60-89,0,0,0
2025-02-01,34,DPD90+,0,0,0
2025-02-01,36,Current,181,181,0
2025-02-01,36,DPD15-29,1,1,0
2025-02-01,36,DPD3-14,5,5,0
2025-02-01,36,DPD30-59,2,2,0
2025-02-01,36,DPD60-89,2,2,0
2025-02-01,36,DPD90+,2,2,0
2025-02-01,38,Current,309,309,0
2025-02-01,38,DPD15-29,1,1,0
2025-02-01,38,DPD3-14,1,1,0
2025-02-01,38,DPD30-59,2,2,0
2025-02-01,38,DPD60-89,0,0,0
2025-02-01,38,DPD90+,0,0,0
2025-02-01,40,Current,195,195,0
2025-02-01,40,DPD15-29,4,4,0
2025-02-01,40,DPD3-14,5,5,0
2025-02-01,40,DPD30-59,4,4,0
2025-02-01,40,DPD60-89,1,1,0
2025-02-01,40,DPD90+,2,2,0
2025-02-01,42,Current,0,0,0
2025-02-01,42,DPD15-29,0,0,0
2025-02-01,42,DPD3-14,0,0,0
2025-02-01,42,DPD30-59,0,0,0
2025-02-01,42,DPD60-89,0,0,0
2025-02-01,42,DPD90+,0,0,0
2025-02-01,44,Current,141,141,0
2025-02-01,44,DPD15-29,2,2,0
2025-02-01,44,DPD3-14,0,0,0
2025-02-01,44,DPD30-59,2,2,0
2025-02-01,44,DPD60-89,1,1,0
2025-02-01,44,DPD90+,0,0,0
2025-02-01,46,Current,4,4,0
2025-02-01,46,DPD15-29,0,0,0
2025-02-01,46,DPD30-59,0,0,0
2025-02-01,48,Current,4342,4342,0
2025-02-01,48,DPD15-29,57,57,0
2025-02-01,48,DPD3-14,72,72,0
2025-02-01,48,DPD30-59,53,53,0
2025-02-01,48,DPD60-89,32,32,0
2025-02-01,48,DPD90+,21,21,0
2025-02-01,6,Current,0,0,0
2025-01-31,100,Current,0,0,0
2025-01-31,102,Current,0,0,0
2025-01-31,102,DPD15-29,0,0,0
2025-01-31,102,DPD3-14,1,1,0
2025-01-31,104,Current,0,0,0
2025-01-31,20,Current,22,22,0
2025-01-31,20,DPD15-29,186,186,0
2025-01-31,20,DPD3-14,256,256,0
2025-01-31,20,DPD30-59,89,89,0
2025-01-31,20,DPD60-89,0,0,0
2025-01-31,20,DPD90+,0,0,0
2025-01-31,22,Current,0,0,0
2025-01-31,22,DPD3-14,1,1,0
2025-01-31,22,DPD60-89,0,0,0
2025-01-31,24,Current,19,19,0
2025-01-31,24,DPD15-29,104,104,0
2025-01-31,24,DPD3-14,179,179,0
2025-01-31,24,DPD30-59,56,56,0
2025-01-31,24,DPD60-89,0,0,0
2025-01-31,24,DPD90+,0,0,0
2025-01-31,26,Current,0,0,0
2025-01-31,26,DPD15-29,11,11,0
2025-01-31,26,DPD3-14,17,17,0
2025-01-31,26,DPD30-59,4,4,0
2025-01-31,26,DPD60-89,0,0,0
2025-01-31,26,DPD90+,0,0,0
2025-01-31,32,Current,3,3,0
2025-01-31,32,DPD15-29,67,67,0
2025-01-31,32,DPD3-14,95,95,0
2025-01-31,32,DPD30-59,69,69,0
2025-01-31,32,DPD60-89,0,0,0
2025-01-31,32,DPD90+,0,0,0
2025-01-31,34,Current,0,0,0
2025-01-31,34,DPD15-29,20,20,0
2025-01-31,34,DPD3-14,44,44,0
2025-01-31,34,DPD30-59,24,24,0
2025-01-31,34,DPD60-89,0,0,0
2025-01-31,34,DPD90+,0,0,0
2025-01-31,36,Current,0,0,0
2025-01-31,36,DPD15-29,18,18,0
2025-01-31,36,DPD3-14,32,32,0
2025-01-31,36,DPD30-59,12,12,0
2025-01-31,36,DPD60-89,0,0,0
2025-01-31,36,DPD90+,0,0,0
2025-01-31,38,Current,2,2,0
2025-01-31,38,DPD15-29,31,31,0
2025-01-31,38,DPD3-14,48,48,0
2025-01-31,38,DPD30-59,16,16,0
2025-01-31,38,DPD60-89,0,0,0
2025-01-31,38,DPD90+,0,0,0
2025-01-31,40,Current,0,0,0
2025-01-31,40,DPD15-29,17,17,0
2025-01-31,40,DPD3-14,28,28,0
2025-01-31,40,DPD30-59,10,10,0
2025-01-31,40,DPD60-89,0,0,0
2025-01-31,40,DPD90+,0,0,0
2025-01-31,42,Current,0,0,0
2025-01-31,42,DPD15-29,13,13,0
2025-01-31,42,DPD3-14,12,12,0
2025-01-31,42,DPD30-59,5,5,0
2025-01-31,42,DPD60-89,0,0,0
2025-01-31,42,DPD90+,0,0,0
2025-01-31,44,Current,0,0,0
2025-01-31,44,DPD15-29,24,24,0
2025-01-31,44,DPD3-14,53,53,0
2025-01-31,44,DPD30-59,12,12,0
2025-01-31,44,DPD60-89,0,0,0
2025-01-31,44,DPD90+,0,0,0
2025-01-31,46,Current,0,0,0
2025-01-31,46,DPD15-29,1,1,0
2025-01-31,46,DPD30-59,0,0,0
2025-01-31,48,Current,24,24,0
2025-01-31,48,DPD15-29,14,14,0
2025-01-31,48,DPD3-14,35,35,0
2025-01-31,48,DPD30-59,16,16,0
2025-01-31,48,DPD60-89,0,0,0
2025-01-31,48,DPD90+,0,0,0
2025-01-31,6,Current,0,0,0
2025-01-30,100,Current,0,0,0
2025-01-30,102,Current,0,0,0
2025-01-30,102,DPD15-29,0,0,0
2025-01-30,102,DPD3-14,0,0,0
2025-01-30,104,Current,0,0,0
2025-01-30,20,Current,0,0,0
2025-01-30,20,DPD15-29,285,285,0
2025-01-30,20,DPD3-14,418,418,0
2025-01-30,20,DPD30-59,230,230,0
2025-01-30,20,DPD60-89,1,1,0
2025-01-30,20,DPD90+,0,0,0
2025-01-30,22,Current,0,0,0
2025-01-30,22,DPD3-14,0,0,0
2025-01-30,22,DPD60-89,0,0,0
2025-01-30,24,Current,21,21,0
2025-01-30,24,DPD15-29,163,163,0
2025-01-30,24,DPD3-14,285,285,0
2025-01-30,24,DPD30-59,136,136,0
2025-01-30,24,DPD60-89,0,0,0
2025-01-30,24,DPD90+,0,0,0
2025-01-30,26,Current,0,0,0
2025-01-30,26,DPD15-29,17,17,0
2025-01-30,26,DPD3-14,37,37,0
2025-01-30,26,DPD30-59,16,16,0
2025-01-30,26,DPD60-89,0,0,0
2025-01-30,26,DPD90+,1,1,0
2025-01-30,32,Current,0,0,0
2025-01-30,32,DPD15-29,127,127,0
2025-01-30,32,DPD3-14,234,234,0
2025-01-30,32,DPD30-59,161,161,0
2025-01-30,32,DPD60-89,0,0,0
2025-01-30,32,DPD90+,2,2,0
2025-01-30,34,Current,0,0,0
2025-01-30,34,DPD15-29,57,57,0
2025-01-30,34,DPD3-14,89,89,0
2025-01-30,34,DPD30-59,46,46,0
2025-01-30,34,DPD60-89,0,0,0
2025-01-30,34,DPD90+,0,0,0
2025-01-30,36,Current,0,0,0
2025-01-30,36,DPD15-29,30,30,0
2025-01-30,36,DPD3-14,48,48,0
2025-01-30,36,DPD30-59,22,22,0
2025-01-30,36,DPD60-89,0,0,0
2025-01-30,36,DPD90+,0,0,0
2025-01-30,38,Current,3,3,0
2025-01-30,38,DPD15-29,47,47,0
2025-01-30,38,DPD3-14,58,58,0
2025-01-30,38,DPD30-59,30,30,0
2025-01-30,38,DPD60-89,0,0,0
2025-01-30,38,DPD90+,0,0,0
2025-01-30,40,Current,0,0,0
2025-01-30,40,DPD15-29,29,29,0
2025-01-30,40,DPD3-14,35,35,0
2025-01-30,40,DPD30-59,17,17,0
2025-01-30,40,DPD60-89,0,0,0
2025-01-30,40,DPD90+,0,0,0
2025-01-30,42,Current,0,0,0
2025-01-30,42,DPD15-29,10,10,0
2025-01-30,42,DPD3-14,20,20,0
2025-01-30,42,DPD30-59,15,15,0
2025-01-30,42,DPD60-89,0,0,0
2025-01-30,42,DPD90+,0,0,0
2025-01-30,44,Current,1,1,0
2025-01-30,44,DPD15-29,22,22,0
2025-01-30,44,DPD3-14,43,43,0
2025-01-30,44,DPD30-59,29,29,0
2025-01-30,44,DPD60-89,0,0,0
2025-01-30,44,DPD90+,0,0,0
2025-01-30,46,Current,0,0,0
2025-01-30,46,DPD15-29,1,1,0
2025-01-30,46,DPD30-59,0,0,0
2025-01-30,48,Current,19,19,0
2025-01-30,48,DPD15-29,82,82,0
2025-01-30,48,DPD3-14,87,87,0
2025-01-30,48,DPD30-59,32,32,0
2025-01-30,48,DPD60-89,0,0,0
2025-01-30,48,DPD90+,0,0,0
2025-01-30,6,Current,0,0,0
2025-01-29,100,Current,0,0,0
2025-01-29,102,Current,0,0,0
2025-01-29,102,DPD15-29,0,0,0
2025-01-29,102,DPD3-14,1,1,0
2025-01-29,104,Current,0,0,0
2025-01-29,20,Current,3,3,0
2025-01-29,20,DPD15-29,155,155,0
2025-01-29,20,DPD3-14,279,279,0
2025-01-29,20,DPD30-59,120,120,0
2025-01-29,20,DPD60-89,0,0,0
2025-01-29,20,DPD90+,0,0,0
2025-01-29,22,Current,0,0,0
2025-01-29,22,DPD60-89,0,0,0
2025-01-29,24,Current,7,7,0
2025-01-29,24,DPD15-29,79,79,0
2025-01-29,24,DPD3-14,183,183,0
2025-01-29,24,DPD30-59,65,65,0
2025-01-29,24,DPD60-89,0,0,0
2025-01-29,24,DPD90+,0,0,0
2025-01-29,26,Current,0,0,0
2025-01-29,26,DPD15-29,8,8,0
2025-01-29,26,DPD3-14,18,18,0
2025-01-29,26,DPD30-59,8,8,0
2025-01-29,26,DPD60-89,0,0,0
2025-01-29,26,DPD90+,0,0,0
2025-01-29,32,Current,1,1,0
2025-01-29,32,DPD15-29,41,41,0
2025-01-29,32,DPD3-14,107,107,0
2025-01-29,32,DPD30-59,14,14,0
2025-01-29,32,DPD60-89,0,0,0
2025-01-29,32,DPD90+,0,0,0
2025-01-29,34,Current,0,0,0
2025-01-29,34,DPD15-29,15,15,0
2025-01-29,34,DPD3-14,37,37,0
2025-01-29,34,DPD30-59,4,4,0
2025-01-29,34,DPD60-89,0,0,0
2025-01-29,34,DPD90+,0,0,0
2025-01-29,36,Current,0,0,0
2025-01-29,36,DPD15-29,19,19,0
2025-01-29,36,DPD3-14,37,37,0
2025-01-29,36,DPD30-59,32,32,0
2025-01-29,36,DPD60-89,0,0,0
2025-01-29,36,DPD90+,0,0,0
2025-01-29,38,Current,4,4,0
2025-01-29,38,DPD15-29,26,26,0
2025-01-29,38,DPD3-14,51,51,0
2025-01-29,38,DPD30-59,39,39,0
2025-01-29,38,DPD60-89,0,0,0
2025-01-29,38,DPD90+,0,0,0
2025-01-29,40,Current,0,0,0
2025-01-29,40,DPD15-29,12,12,0
2025-01-29,40,DPD3-14,29,29,0
2025-01-29,40,DPD30-59,13,13,0
2025-01-29,40,DPD60-89,0,0,0
2025-01-29,40,DPD90+,0,0,0
2025-01-29,42,Current,0,0,0
2025-01-29,42,DPD15-29,11,11,0
2025-01-29,42,DPD3-14,12,12,0
2025-01-29,42,DPD30-59,11,11,0
2025-01-29,42,DPD60-89,0,0,0
2025-01-29,42,DPD90+,0,0,0
2025-01-29,44,Current,3,3,0
2025-01-29,44,DPD15-29,25,25,0
2025-01-29,44,DPD3-14,55,55,0
2025-01-29,44,DPD30-59,13,13,0
2025-01-29,44,DPD60-89,0,0,0
2025-01-29,44,DPD90+,0,0,0
2025-01-29,46,Current,0,0,0
2025-01-29,46,DPD15-29,1,1,0
2025-01-29,46,DPD3-14,0,0,0
2025-01-29,48,Current,13,13,0
2025-01-29,48,DPD15-29,12,12,0
2025-01-29,48,DPD3-14,29,29,0
2025-01-29,48,DPD30-59,14,14,0
2025-01-29,48,DPD60-89,0,0,0
2025-01-29,48,DPD90+,0,0,0
2025-01-29,6,Current,0,0,0
2025-01-28,100,Current,0,0,0
2025-01-28,102,Current,0,0,0
2025-01-28,102,DPD15-29,0,0,0
2025-01-28,102,DPD3-14,0,0,0
2025-01-28,102,DPD90+,0,0,0
2025-01-28,104,Current,0,0,0
2025-01-28,20,Current,0,0,0
2025-01-28,20,DPD15-29,256,256,0
2025-01-28,20,DPD3-14,419,419,0
2025-01-28,20,DPD30-59,291,291,0
2025-01-28,20,DPD60-89,0,0,0
2025-01-28,20,DPD90+,0,0,0
2025-01-28,22,Current,0,0,0
2025-01-28,22,DPD60-89,0,0,0
2025-01-28,22,DPD90+,0,0,0
2025-01-28,24,Current,34,34,0
2025-01-28,24,DPD15-29,172,172,0
2025-01-28,24,DPD3-14,312,312,0
2025-01-28,24,DPD30-59,183,183,0
2025-01-28,24,DPD60-89,0,0,0
2025-01-28,24,DPD90+,0,0,0
2025-01-28,26,Current,0,0,0
2025-01-28,26,DPD15-29,14,14,0
2025-01-28,26,DPD3-14,38,38,0
2025-01-28,26,DPD30-59,21,21,0
2025-01-28,26,DPD60-89,0,0,0
2025-01-28,26,DPD90+,0,0,0
2025-01-28,32,Current,0,0,0
2025-01-28,32,DPD15-29,66,66,0
2025-01-28,32,DPD3-14,150,150,0
2025-01-28,32,DPD30-59,83,83,0
2025-01-28,32,DPD60-89,0,0,0
2025-01-28,32,DPD90+,0,0,0
2025-01-28,34,Current,3,3,0
2025-01-28,34,DPD15-29,31,31,0
2025-01-28,34,DPD3-14,55,55,0
2025-01-28,34,DPD30-59,42,42,0
2025-01-28,34,DPD60-89,0,0,0
2025-01-28,34,DPD90+,0,0,0
2025-01-28,36,Current,0,0,0
2025-01-28,36,DPD15-29,33,33,0
2025-01-28,36,DPD3-14,48,48,0
2025-01-28,36,DPD30-59,41,41,0
2025-01-28,36,DPD60-89,0,0,0
2025-01-28,36,DPD90+,0,0,0
2025-01-28,38,Current,6,6,0
2025-01-28,38,DPD15-29,49,49,0
2025-01-28,38,DPD3-14,64,64,0
2025-01-28,38,DPD30-59,57,57,0
2025-01-28,38,DPD60-89,0,0,0
2025-01-28,38,DPD90+,0,0,0
2025-01-28,40,Current,0,0,0
2025-01-28,40,DPD15-29,28,28,0
2025-01-28,40,DPD3-14,41,41,0
2025-01-28,40,DPD30-59,27,27,0
2025-01-28,40,DPD60-89,0,0,0
2025-01-28,40,DPD90+,0,0,0
2025-01-28,42,Current,0,0,0
2025-01-28,42,DPD15-29,9,9,0
2025-01-28,42,DPD3-14,26,26,0
2025-01-28,42,DPD30-59,13,13,0
2025-01-28,42,DPD60-89,0,0,0
2025-01-28,42,DPD90+,0,0,0
2025-01-28,44,Current,0,0,0
2025-01-28,44,DPD15-29,25,25,0
2025-01-28,44,DPD3-14,47,47,0
2025-01-28,44,DPD30-59,30,30,0
2025-01-28,44,DPD60-89,0,0,0
2025-01-28,44,DPD90+,0,0,0
2025-01-28,46,Current,0,0,0
2025-01-28,46,DPD15-29,1,1,0
2025-01-28,46,DPD3-14,1,1,0
2025-01-28,48,Current,34,34,0
2025-01-28,48,DPD15-29,69,69,0
2025-01-28,48,DPD3-14,89,89,0
2025-01-28,48,DPD30-59,54,54,0
2025-01-28,48,DPD60-89,0,0,0
2025-01-28,48,DPD90+,0,0,0
2025-01-28,6,Current,0,0,0
2025-01-27,100,Current,0,0,0
2025-01-27,102,Current,0,0,0
2025-01-27,102,DPD15-29,0,0,0
2025-01-27,102,DPD90+,0,0,0
2025-01-27,104,Current,0,0,0
2025-01-27,20,Current,0,0,0
2025-01-27,20,DPD15-29,72,72,0
2025-01-27,20,DPD3-14,152,152,0
2025-01-27,20,DPD30-59,2,2,0
2025-01-27,20,DPD60-89,0,0,0
2025-01-27,20,DPD90+,0,0,0
2025-01-27,22,Current,0,0,0
2025-01-27,22,DPD60-89,0,0,0
2025-01-27,22,DPD90+,0,0,0
2025-01-27,24,Current,8,8,0
2025-01-27,24,DPD15-29,30,30,0
2025-01-27,24,DPD3-14,115,115,0
2025-01-27,24,DPD30-59,3,3,0
2025-01-27,24,DPD60-89,0,0,0
2025-01-27,24,DPD90+,0,0,0
2025-01-27,26,Current,0,0,0
2025-01-27,26,DPD15-29,6,6,0
2025-01-27,26,DPD3-14,12,12,0
2025-01-27,26,DPD30-59,0,0,0
2025-01-27,26,DPD60-89,0,0,0
2025-01-27,26,DPD90+,0,0,0
2025-01-27,32,Current,0,0,0
2025-01-27,32,DPD15-29,52,52,0
2025-01-27,32,DPD3-14,96,96,0
2025-01-27,32,DPD30-59,4,4,0
2025-01-27,32,DPD60-89,0,0,0
2025-01-27,32,DPD90+,0,0,0
2025-01-27,34,Current,0,0,0
2025-01-27,34,DPD15-29,21,21,0
2025-01-27,34,DPD3-14,29,29,0
2025-01-27,34,DPD30-59,1,1,0
2025-01-27,34,DPD60-89,0,0,0
2025-01-27,34,DPD90+,0,0,0
2025-01-27,36,Current,0,0,0
2025-01-27,36,DPD15-29,9,9,0
2025-01-27,36,DPD3-14,15,15,0
2025-01-27,36,DPD30-59,0,0,0
2025-01-27,36,DPD60-89,0,0,0
2025-01-27,36,DPD90+,0,0,0
2025-01-27,38,Current,3,3,0
2025-01-27,38,DPD15-29,16,16,0
2025-01-27,38,DPD3-14,39,39,0
2025-01-27,38,DPD30-59,0,0,0
2025-01-27,38,DPD60-89,0,0,0
2025-01-27,38,DPD90+,0,0,0
2025-01-27,40,Current,0,0,0
2025-01-27,40,DPD15-29,7,7,0
2025-01-27,40,DPD3-14,8,8,0
2025-01-27,40,DPD30-59,0,0,0
2025-01-27,40,DPD60-89,0,0,0
2025-01-27,40,DPD90+,0,0,0
2025-01-27,42,Current,0,0,0
2025-01-27,42,DPD15-29,3,3,0
2025-01-27,42,DPD3-14,11,11,0
2025-01-27,42,DPD30-59,2,2,0
2025-01-27,42,DPD60-89,0,0,0
2025-01-27,42,DPD90+,0,0,0
2025-01-27,44,Current,0,0,0
2025-01-27,44,DPD15-29,12,12,0
2025-01-27,44,DPD3-14,26,26,0
2025-01-27,44,DPD30-59,0,0,0
2025-01-27,44,DPD60-89,0,0,0
2025-01-27,44,DPD90+,0,0,0
2025-01-27,46,Current,0,0,0
2025-01-27,46,DPD15-29,1,1,0
2025-01-27,46,DPD3-14,0,0,0
2025-01-27,48,Current,4,4,0
2025-01-27,48,DPD15-29,6,6,0
2025-01-27,48,DPD3-14,23,23,0
2025-01-27,48,DPD30-59,0,0,0
2025-01-27,48,DPD60-89,0,0,0
2025-01-27,48,DPD90+,0,0,0
2025-01-27,6,Current,0,0,0
2025-01-26,100,Current,0,0,0
2025-01-26,102,Current,0,0,0
2025-01-26,102,DPD15-29,0,0,0
2025-01-26,102,DPD90+,0,0,0
2025-01-26,104,Current,0,0,0
2025-01-26,20,Current,0,0,0
2025-01-26,20,DPD15-29,272,272,0
2025-01-26,20,DPD3-14,404,404,0
2025-01-26,20,DPD30-59,172,172,0
2025-01-26,20,DPD60-89,0,0,0
2025-01-26,20,DPD90+,0,0,0
2025-01-26,22,Current,0,0,0
2025-01-26,22,DPD60-89,0,0,0
2025-01-26,22,DPD90+,0,0,0
2025-01-26,24,Current,1,1,0
2025-01-26,24,DPD15-29,173,173,0
2025-01-26,24,DPD3-14,324,324,0
2025-01-26,24,DPD30-59,92,92,0
2025-01-26,24,DPD60-89,0,0,0
2025-01-26,24,DPD90+,0,0,0
2025-01-26,26,Current,0,0,0
2025-01-26,26,DPD15-29,14,14,0
2025-01-26,26,DPD3-14,28,28,0
2025-01-26,26,DPD30-59,12,12,0
2025-01-26,26,DPD60-89,0,0,0
2025-01-26,26,DPD90+,0,0,0
2025-01-26,32,Current,0,0,0
2025-01-26,32,DPD15-29,80,80,0
2025-01-26,32,DPD3-14,149,149,0
2025-01-26,32,DPD30-59,96,96,0
2025-01-26,32,DPD60-89,0,0,0
2025-01-26,32,DPD90+,0,0,0
2025-01-26,34,Current,0,0,0
2025-01-26,34,DPD15-29,39,39,0
2025-01-26,34,DPD3-14,57,57,0
2025-01-26,34,DPD30-59,31,31,0
2025-01-26,34,DPD60-89,0,0,0
2025-01-26,34,DPD90+,0,0,0
2025-01-26,36,Current,0,0,0
2025-01-26,36,DPD15-29,34,34,0
2025-01-26,36,DPD3-14,41,41,0
2025-01-26,36,DPD30-59,19,19,0
2025-01-26,36,DPD60-89,0,0,0
2025-01-26,36,DPD90+,0,0,0
2025-01-26,38,Current,1,1,0
2025-01-26,38,DPD15-29,45,45,0
2025-01-26,38,DPD3-14,61,61,0
2025-01-26,38,DPD30-59,26,26,0
2025-01-26,38,DPD60-89,0,0,0
2025-01-26,38,DPD90+,0,0,0
2025-01-26,40,Current,0,0,0
2025-01-26,40,DPD15-29,35,35,0
2025-01-26,40,DPD3-14,42,42,0
2025-01-26,40,DPD30-59,11,11,0
2025-01-26,40,DPD60-89,0,0,0
2025-01-26,40,DPD90+,0,0,0
2025-01-26,42,Current,0,0,0
2025-01-26,42,DPD15-29,12,12,0
2025-01-26,42,DPD3-14,16,16,0
2025-01-26,42,DPD30-59,10,10,0
2025-01-26,42,DPD60-89,0,0,0
2025-01-26,42,DPD90+,0,0,0
2025-01-26,44,Current,0,0,0
2025-01-26,44,DPD15-29,26,26,0
2025-01-26,44,DPD3-14,40,40,0
2025-01-26,44,DPD30-59,26,26,0
2025-01-26,44,DPD60-89,0,0,0
2025-01-26,44,DPD90+,0,0,0
2025-01-26,46,Current,0,0,0
2025-01-26,46,DPD15-29,1,1,0
2025-01-26,46,DPD3-14,1,1,0
2025-01-26,48,Current,4,4,0
2025-01-26,48,DPD15-29,62,62,0
2025-01-26,48,DPD3-14,97,97,0
2025-01-26,48,DPD30-59,17,17,0
2025-01-26,48,DPD60-89,0,0,0
2025-01-26,48,DPD90+,0,0,0
2025-01-26,6,Current,0,0,0
2025-01-25,100,Current,0,0,0
2025-01-25,102,Current,0,0,0
2025-01-25,102,DPD15-29,0,0,0
2025-01-25,102,DPD90+,0,0,0
2025-01-25,104,Current,0,0,0
2025-01-25,20,Current,0,0,0
2025-01-25,20,DPD15-29,64,64,0
2025-01-25,20,DPD3-14,129,129,0
2025-01-25,20,DPD30-59,13,13,0
2025-01-25,20,DPD60-89,0,0,0
2025-01-25,20,DPD90+,0,0,0
2025-01-25,22,Current,0,0,0
2025-01-25,22,DPD60-89,0,0,0
2025-01-25,22,DPD90+,0,0,0
2025-01-25,24,Current,14,14,0
2025-01-25,24,DPD15-29,30,30,0
2025-01-25,24,DPD3-14,85,85,0
2025-01-25,24,DPD30-59,6,6,0
2025-01-25,24,DPD60-89,0,0,0
2025-01-25,24,DPD90+,0,0,0
2025-01-25,26,Current,0,0,0
2025-01-25,26,DPD15-29,7,7,0
2025-01-25,26,DPD3-14,10,10,0
2025-01-25,26,DPD30-59,0,0,0
2025-01-25,26,DPD60-89,0,0,0
2025-01-25,26,DPD90+,0,0,0
2025-01-25,32,Current,0,0,0
2025-01-25,32,DPD15-29,56,56,0
2025-01-25,32,DPD3-14,85,85,0
2025-01-25,32,DPD30-59,6,6,0
2025-01-25,32,DPD60-89,0,0,0
2025-01-25,32,DPD90+,0,0,0
2025-01-25,34,Current,0,0,0
2025-01-25,34,DPD15-29,19,19,0
2025-01-25,34,DPD3-14,23,23,0
2025-01-25,34,DPD30-59,2,2,0
2025-01-25,34,DPD60-89,0,0,0
2025-01-25,34,DPD90+,0,0,0
2025-01-25,36,Current,0,0,0
2025-01-25,36,DPD15-29,8,8,0
2025-01-25,36,DPD3-14,11,11,0
2025-01-25,36,DPD30-59,1,1,0
2025-01-25,36,DPD60-89,0,0,0
2025-01-25,36,DPD90+,0,0,0
2025-01-25,38,Current,1,1,0
2025-01-25,38,DPD15-29,16,16,0
2025-01-25,38,DPD3-14,25,25,0
2025-01-25,38,DPD30-59,3,3,0
2025-01-25,38,DPD60-89,0,0,0
2025-01-25,38,DPD90+,0,0,0
2025-01-25,40,Current,0,0,0
2025-01-25,40,DPD15-29,5,5,0
2025-01-25,40,DPD3-14,11,11,0
2025-01-25,40,DPD30-59,1,1,0
2025-01-25,40,DPD60-89,0,0,0
2025-01-25,40,DPD90+,0,0,0
2025-01-25,42,Current,0,0,0
2025-01-25,42,DPD15-29,4,4,0
2025-01-25,42,DPD3-14,9,9,0
2025-01-25,42,DPD30-59,3,3,0
2025-01-25,42,DPD60-89,0,0,0
2025-01-25,42,DPD90+,0,0,0
2025-01-25,44,Current,0,0,0
2025-01-25,44,DPD15-29,11,11,0
2025-01-25,44,DPD3-14,20,20,0
2025-01-25,44,DPD30-59,3,3,0
2025-01-25,44,DPD60-89,0,0,0
2025-01-25,44,DPD90+,0,0,0
2025-01-25,46,Current,0,0,0
2025-01-25,46,DPD15-29,1,1,0
2025-01-25,46,DPD3-14,0,0,0
2025-01-25,48,Current,14,14,0
2025-01-25,48,DPD15-29,4,4,0
2025-01-25,48,DPD3-14,17,17,0
2025-01-25,48,DPD30-59,4,4,0
2025-01-25,48,DPD60-89,0,0,0
2025-01-25,48,DPD90+,0,0,0
2025-01-25,6,Current,0,0,0
2025-01-24,100,Current,0,0,0
2025-01-24,102,Current,0,0,0
2025-01-24,102,DPD15-29,0,0,0
2025-01-24,102,DPD90+,0,0,0
2025-01-24,104,Current,0,0,0
2025-01-24,20,Current,0,0,0
2025-01-24,20,DPD15-29,315,315,0
2025-01-24,20,DPD3-14,466,466,0
2025-01-24,20,DPD30-59,266,266,0
2025-01-24,20,DPD60-89,0,0,0
2025-01-24,20,DPD90+,0,0,0
2025-01-24,22,Current,0,0,0
2025-01-24,22,DPD60-89,0,0,0
2025-01-24,22,DPD90+,0,0,0
2025-01-24,24,Current,2,2,0
2025-01-24,24,DPD15-29,213,213,0
2025-01-24,24,DPD3-14,382,382,0
2025-01-24,24,DPD30-59,187,187,0
2025-01-24,24,DPD60-89,0,0,0
2025-01-24,24,DPD90+,0,0,0
2025-01-24,26,Current,0,0,0
2025-01-24,26,DPD15-29,12,12,0
2025-01-24,26,DPD3-14,36,36,0
2025-01-24,26,DPD30-59,20,20,0
2025-01-24,26,DPD60-89,0,0,0
2025-01-24,26,DPD90+,0,0,0
2025-01-24,32,Current,0,0,0
2025-01-24,32,DPD15-29,100,100,0
2025-01-24,32,DPD3-14,164,164,0
2025-01-24,32,DPD30-59,93,93,0
2025-01-24,32,DPD60-89,0,0,0
2025-01-24,32,DPD90+,0,0,0
2025-01-24,34,Current,0,0,0
2025-01-24,34,DPD15-29,50,50,0
2025-01-24,34,DPD3-14,67,67,0
2025-01-24,34,DPD30-59,37,37,0
2025-01-24,34,DPD60-89,0,0,0
2025-01-24,34,DPD90+,0,0,0
2025-01-24,36,Current,0,0,0
2025-01-24,36,DPD15-29,41,41,0
2025-01-24,36,DPD3-14,48,48,0
2025-01-24,36,DPD30-59,38,38,0
2025-01-24,36,DPD60-89,0,0,0
2025-01-24,36,DPD90+,0,0,0
2025-01-24,38,Current,0,0,0
2025-01-24,38,DPD15-29,60,60,0
2025-01-24,38,DPD3-14,63,63,0
2025-01-24,38,DPD30-59,51,51,0
2025-01-24,38,DPD60-89,0,0,0
2025-01-24,38,DPD90+,0,0,0
2025-01-24,40,Current,0,0,0
2025-01-24,40,DPD15-29,43,43,0
2025-01-24,40,DPD3-14,53,53,0
2025-01-24,40,DPD30-59,22,22,0
2025-01-24,40,DPD60-89,0,0,0
2025-01-24,40,DPD90+,0,0,0
2025-01-24,42,Current,0,0,0
2025-01-24,42,DPD15-29,15,15,0
2025-01-24,42,DPD3-14,17,17,0
2025-01-24,42,DPD30-59,9,9,0
2025-01-24,42,DPD60-89,0,0,0
2025-01-24,42,DPD90+,0,0,0
2025-01-24,44,Current,0,0,0
2025-01-24,44,DPD15-29,29,29,0
2025-01-24,44,DPD3-14,53,53,0
2025-01-24,44,DPD30-59,24,24,0
2025-01-24,44,DPD60-89,0,0,0
2025-01-24,44,DPD90+,0,0,0
2025-01-24,46,Current,0,0,0
2025-01-24,46,DPD15-29,1,1,0
2025-01-24,48,Current,2,2,0
2025-01-24,48,DPD15-29,79,79,0
2025-01-24,48,DPD3-14,122,122,0
2025-01-24,48,DPD30-59,63,63,0
2025-01-24,48,DPD60-89,0,0,0
2025-01-24,48,DPD90+,0,0,0
2025-01-24,6,Current,0,0,0
2025-01-23,100,Current,0,0,0
2025-01-23,100,DPD15-29,1,1,0
2025-01-23,102,Current,0,0,0
2025-01-23,102,DPD15-29,0,0,0
2025-01-23,102,DPD90+,0,0,0
2025-01-23,104,Current,0,0,0
2025-01-23,20,Current,5,5,0
2025-01-23,20,DPD15-29,85,85,0
2025-01-23,20,DPD3-14,102,102,0
2025-01-23,20,DPD30-59,26,26,0
2025-01-23,20,DPD60-89,2,2,0
2025-01-23,20,DPD90+,6,6,0
2025-01-23,22,Current,0,0,0
2025-01-23,22,DPD60-89,0,0,0
2025-01-23,22,DPD90+,0,0,0
2025-01-23,24,Current,23,23,0
2025-01-23,24,DPD15-29,35,35,0
2025-01-23,24,DPD3-14,51,51,0
2025-01-23,24,DPD30-59,8,8,0
2025-01-23,24,DPD60-89,0,0,0
2025-01-23,24,DPD90+,0,0,0
2025-01-23,26,Current,1,1,0
2025-01-23,26,DPD15-29,9,9,0
2025-01-23,26,DPD3-14,5,5,0
2025-01-23,26,DPD30-59,7,7,0
2025-01-23,26,DPD60-89,1,1,0
2025-01-23,26,DPD90+,1,1,0
2025-01-23,32,Current,5,5,0
2025-01-23,32,DPD15-29,57,57,0
2025-01-23,32,DPD3-14,68,68,0
2025-01-23,32,DPD30-59,19,19,0
2025-01-23,32,DPD60-89,3,3,0
2025-01-23,32,DPD90+,7,7,0
2025-01-23,34,Current,0,0,0
2025-01-23,34,DPD15-29,25,25,0
2025-01-23,34,DPD3-14,21,21,0
2025-01-23,34,DPD30-59,6,6,0
2025-01-23,34,DPD60-89,2,2,0
2025-01-23,34,DPD90+,1,1,0
2025-01-23,36,Current,6,6,0
2025-01-23,36,DPD15-29,11,11,0
2025-01-23,36,DPD3-14,10,10,0
2025-01-23,36,DPD30-59,6,6,0
2025-01-23,36,DPD60-89,1,1,0
2025-01-23,36,DPD90+,1,1,0
2025-01-23,38,Current,8,8,0
2025-01-23,38,DPD15-29,16,16,0
2025-01-23,38,DPD3-14,20,20,0
2025-01-23,38,DPD30-59,4,4,0
2025-01-23,38,DPD60-89,1,1,0
2025-01-23,38,DPD90+,1,1,0
2025-01-23,40,Current,0,0,0
2025-01-23,40,DPD15-29,6,6,0
2025-01-23,40,DPD3-14,8,8,0
2025-01-23,40,DPD30-59,3,3,0
2025-01-23,40,DPD60-89,0,0,0
2025-01-23,40,DPD90+,0,0,0
2025-01-23,42,Current,1,1,0
2025-01-23,42,DPD15-29,3,3,0
2025-01-23,42,DPD3-14,10,10,0
2025-01-23,42,DPD30-59,0,0,0
2025-01-23,42,DPD60-89,1,1,0
2025-01-23,42,DPD90+,0,0,0
2025-01-23,44,Current,1,1,0
2025-01-23,44,DPD15-29,14,14,0
2025-01-23,44,DPD3-14,14,14,0
2025-01-23,44,DPD30-59,3,3,0
2025-01-23,44,DPD60-89,3,3,0
2025-01-23,44,DPD90+,1,1,0
2025-01-23,46,Current,0,0,0
2025-01-23,46,DPD15-29,1,1,0
2025-01-23,48,Current,18,18,0
2025-01-23,48,DPD15-29,5,5,0
2025-01-23,48,DPD3-14,13,13,0
2025-01-23,48,DPD30-59,0,0,0
2025-01-23,48,DPD60-89,0,0,0
2025-01-23,48,DPD90+,1,1,0
2025-01-23,6,Current,0,0,0
2025-01-22,100,Current,0,0,0
2025-01-22,100,DPD15-29,0,0,0
2025-01-22,102,Current,0,0,0
2025-01-22,102,DPD15-29,0,0,0
2025-01-22,102,DPD90+,0,0,0
2025-01-22,104,Current,0,0,0
2025-01-22,20,Current,0,0,0
2025-01-22,20,DPD15-29,73,73,0
2025-01-22,20,DPD3-14,78,78,0
2025-01-22,20,DPD30-59,154,154,0
2025-01-22,20,DPD60-89,0,0,0
2025-01-22,20,DPD90+,1,1,0
2025-01-22,22,Current,0,0,0
2025-01-22,22,DPD60-89,0,0,0
2025-01-22,22,DPD90+,0,0,0
2025-01-22,24,Current,29,29,0
2025-01-22,24,DPD15-29,46,46,0
2025-01-22,24,DPD3-14,46,46,0
2025-01-22,24,DPD30-59,88,88,0
2025-01-22,24,DPD60-89,0,0,0
2025-01-22,24,DPD90+,0,0,0
2025-01-22,26,Current,0,0,0
2025-01-22,26,DPD15-29,5,5,0
2025-01-22,26,DPD3-14,7,7,0
2025-01-22,26,DPD30-59,10,10,0
2025-01-22,26,DPD60-89,0,0,0
2025-01-22,26,DPD90+,0,0,0
2025-01-22,32,Current,1,1,0
2025-01-22,32,DPD15-29,38,38,0
2025-01-22,32,DPD3-14,51,51,0
2025-01-22,32,DPD30-59,86,86,0
2025-01-22,32,DPD60-89,0,0,0
2025-01-22,32,DPD90+,0,0,0
2025-01-22,34,Current,0,0,0
2025-01-22,34,DPD15-29,19,19,0
2025-01-22,34,DPD3-14,22,22,0
2025-01-22,34,DPD30-59,30,30,0
2025-01-22,34,DPD60-89,0,0,0
2025-01-22,34,DPD90+,0,0,0
2025-01-22,36,Current,0,0,0
2025-01-22,36,DPD15-29,6,6,0
2025-01-22,36,DPD3-14,6,6,0
2025-01-22,36,DPD30-59,16,16,0
2025-01-22,36,DPD60-89,0,0,0
2025-01-22,36,DPD90+,0,0,0
2025-01-22,38,Current,5,5,0
2025-01-22,38,DPD15-29,12,12,0
2025-01-22,38,DPD3-14,13,13,0
2025-01-22,38,DPD30-59,20,20,0
2025-01-22,38,DPD60-89,0,0,0
2025-01-22,38,DPD90+,0,0,0
2025-01-22,40,Current,0,0,0
2025-01-22,40,DPD15-29,7,7,0
2025-01-22,40,DPD3-14,10,10,0
2025-01-22,40,DPD30-59,10,10,0
2025-01-22,40,DPD60-89,0,0,0
2025-01-22,40,DPD90+,0,0,0
2025-01-22,42,Current,0,0,0
2025-01-22,42,DPD15-29,3,3,0
2025-01-22,42,DPD3-14,4,4,0
2025-01-22,42,DPD30-59,11,11,0
2025-01-22,42,DPD60-89,0,0,0
2025-01-22,42,DPD90+,0,0,0
2025-01-22,44,Current,0,0,0
2025-01-22,44,DPD15-29,6,6,0
2025-01-22,44,DPD3-14,15,15,0
2025-01-22,44,DPD30-59,24,24,0
2025-01-22,44,DPD60-89,0,0,0
2025-01-22,44,DPD90+,0,0,0
2025-01-22,46,Current,0,0,0
2025-01-22,46,DPD15-29,0,0,0
2025-01-22,48,Current,24,24,0
2025-01-22,48,DPD15-29,6,6,0
2025-01-22,48,DPD3-14,13,13,0
2025-01-22,48,DPD30-59,11,11,0
2025-01-22,48,DPD60-89,0,0,0
2025-01-22,48,DPD90+,0,0,0
2025-01-22,6,Current,0,0,0
2025-01-21,100,Current,0,0,0
2025-01-21,100,DPD15-29,1,1,0
2025-01-21,102,Current,0,0,0
2025-01-21,102,DPD15-29,0,0,0
2025-01-21,102,DPD90+,0,0,0
2025-01-21,104,Current,0,0,0
2025-01-21,20,Current,1,1,0
2025-01-21,20,DPD15-29,84,84,0
2025-01-21,20,DPD3-14,111,111,0
2025-01-21,20,DPD30-59,16,16,0
2025-01-21,20,DPD60-89,0,0,0
2025-01-21,20,DPD90+,0,0,0
2025-01-21,22,Current,0,0,0
2025-01-21,22,DPD60-89,0,0,0
2025-01-21,22,DPD90+,0,0,0
2025-01-21,24,Current,1,1,0
2025-01-21,24,DPD15-29,34,34,0
2025-01-21,24,DPD3-14,60,60,0
2025-01-21,24,DPD30-59,6,6,0
2025-01-21,24,DPD60-89,0,0,0
2025-01-21,24,DPD90+,0,0,0
2025-01-21,26,Current,0,0,0
2025-01-21,26,DPD15-29,10,10,0
2025-01-21,26,DPD3-14,9,9,0
2025-01-21,26,DPD30-59,1,1,0
2025-01-21,26,DPD60-89,0,0,0
2025-01-21,26,DPD90+,0,0,0
2025-01-21,32,Current,0,0,0
2025-01-21,32,DPD15-29,54,54,0
2025-01-21,32,DPD3-14,72,72,0
2025-01-21,32,DPD30-59,10,10,0
2025-01-21,32,DPD60-89,0,0,0
2025-01-21,32,DPD90+,0,0,0
2025-01-21,34,Current,0,0,0
2025-01-21,34,DPD15-29,23,23,0
2025-01-21,34,DPD3-14,28,28,0
2025-01-21,34,DPD30-59,4,4,0
2025-01-21,34,DPD60-89,0,0,0
2025-01-21,34,DPD90+,0,0,0
2025-01-21,36,Current,0,0,0
2025-01-21,36,DPD15-29,11,11,0
2025-01-21,36,DPD3-14,11,11,0
2025-01-21,36,DPD30-59,5,5,0
2025-01-21,36,DPD60-89,0,0,0
2025-01-21,36,DPD90+,0,0,0
2025-01-21,38,Current,5,5,0
2025-01-21,38,DPD15-29,18,18,0
2025-01-21,38,DPD3-14,21,21,0
2025-01-21,38,DPD30-59,4,4,0
2025-01-21,38,DPD60-89,0,0,0
2025-01-21,38,DPD90+,0,0,0
2025-01-21,40,Current,0,0,0
2025-01-21,40,DPD15-29,5,5,0
2025-01-21,40,DPD3-14,10,10,0
2025-01-21,40,DPD30-59,2,2,0
2025-01-21,40,DPD60-89,0,0,0
2025-01-21,40,DPD90+,0,0,0
2025-01-21,42,Current,0,0,0
2025-01-21,42,DPD15-29,4,4,0
2025-01-21,42,DPD3-14,9,9,0
2025-01-21,42,DPD30-59,2,2,0
2025-01-21,42,DPD60-89,0,0,0
2025-01-21,42,DPD90+,0,0,0
2025-01-21,44,Current,0,0,0
2025-01-21,44,DPD15-29,12,12,0
2025-01-21,44,DPD3-14,16,16,0
2025-01-21,44,DPD30-59,1,1,0
2025-01-21,44,DPD60-89,0,0,0
2025-01-21,44,DPD90+,0,0,0
2025-01-21,46,Current,0,0,0
2025-01-21,46,DPD3-14,1,1,0
2025-01-21,48,Current,5,5,0
2025-01-21,48,DPD15-29,6,6,0
2025-01-21,48,DPD3-14,13,13,0
2025-01-21,48,DPD30-59,2,2,0
2025-01-21,48,DPD60-89,0,0,0
2025-01-21,48,DPD90+,0,0,0
2025-01-21,6,Current,0,0,0
2025-01-20,100,Current,0,0,0
2025-01-20,100,DPD15-29,0,0,0
2025-01-20,102,Current,0,0,0
2025-01-20,102,DPD3-14,0,0,0
2025-01-20,102,DPD90+,0,0,0
2025-01-20,104,Current,0,0,0
2025-01-20,20,Current,4,4,0
2025-01-20,20,DPD15-29,76,76,0
2025-01-20,20,DPD3-14,91,91,0
2025-01-20,20,DPD30-59,119,119,0
2025-01-20,20,DPD60-89,0,0,0
2025-01-20,20,DPD90+,0,0,0
2025-01-20,22,Current,0,0,0
2025-01-20,22,DPD60-89,0,0,0
2025-01-20,22,DPD90+,0,0,0
2025-01-20,24,Current,14,14,0
2025-01-20,24,DPD15-29,41,41,0
2025-01-20,24,DPD3-14,55,55,0
2025-01-20,24,DPD30-59,49,49,0
2025-01-20,24,DPD60-89,0,0,0
2025-01-20,24,DPD90+,0,0,0
2025-01-20,26,Current,0,0,0
2025-01-20,26,DPD15-29,4,4,0
2025-01-20,26,DPD3-14,9,9,0
2025-01-20,26,DPD30-59,8,8,0
2025-01-20,26,DPD60-89,0,0,0
2025-01-20,26,DPD90+,0,0,0
2025-01-20,32,Current,0,0,0
2025-01-20,32,DPD15-29,42,42,0
2025-01-20,32,DPD3-14,57,57,0
2025-01-20,32,DPD30-59,59,59,0
2025-01-20,32,DPD60-89,0,0,0
2025-01-20,32,DPD90+,0,0,0
2025-01-20,34,Current,0,0,0
2025-01-20,34,DPD15-29,17,17,0
2025-01-20,34,DPD3-14,27,27,0
2025-01-20,34,DPD30-59,20,20,0
2025-01-20,34,DPD60-89,0,0,0
2025-01-20,34,DPD90+,0,0,0
2025-01-20,36,Current,0,0,0
2025-01-20,36,DPD15-29,6,6,0
2025-01-20,36,DPD3-14,7,7,0
2025-01-20,36,DPD30-59,11,11,0
2025-01-20,36,DPD60-89,0,0,0
2025-01-20,36,DPD90+,0,0,0
2025-01-20,38,Current,4,4,0
2025-01-20,38,DPD15-29,11,11,0
2025-01-20,38,DPD3-14,14,14,0
2025-01-20,38,DPD30-59,12,12,0
2025-01-20,38,DPD60-89,0,0,0
2025-01-20,38,DPD90+,0,0,0
2025-01-20,40,Current,0,0,0
2025-01-20,40,DPD15-29,7,7,0
2025-01-20,40,DPD3-14,10,10,0
2025-01-20,40,DPD30-59,9,9,0
2025-01-20,40,DPD60-89,0,0,0
2025-01-20,40,DPD90+,0,0,0
2025-01-20,42,Current,0,0,0
2025-01-20,42,DPD15-29,4,4,0
2025-01-20,42,DPD3-14,4,4,0
2025-01-20,42,DPD30-59,4,4,0
2025-01-20,42,DPD60-89,0,0,0
2025-01-20,42,DPD90+,0,0,0
2025-01-20,44,Current,0,0,0
2025-01-20,44,DPD15-29,7,7,0
2025-01-20,44,DPD3-14,15,15,0
2025-01-20,44,DPD30-59,14,14,0
2025-01-20,44,DPD60-89,0,0,0
2025-01-20,44,DPD90+,0,0,0
2025-01-20,46,Current,0,0,0
2025-01-20,46,DPD3-14,0,0,0
2025-01-20,48,Current,18,18,0
2025-01-20,48,DPD15-29,4,4,0
2025-01-20,48,DPD3-14,16,16,0
2025-01-20,48,DPD30-59,11,11,0
2025-01-20,48,DPD60-89,0,0,0
2025-01-20,48,DPD90+,0,0,0
2025-01-20,6,Current,0,0,0
2025-01-19,100,Current,0,0,0
2025-01-19,100,DPD15-29,0,0,0
2025-01-19,100,DPD3-14,1,1,0
2025-01-19,102,Current,0,0,0
2025-01-19,102,DPD3-14,1,1,0
2025-01-19,102,DPD90+,0,0,0
2025-01-19,104,Current,0,0,0
2025-01-19,20,Current,0,0,0
2025-01-19,20,DPD15-29,85,85,0
2025-01-19,20,DPD3-14,118,118,0
2025-01-19,20,DPD30-59,22,22,0
2025-01-19,20,DPD60-89,0,0,0
2025-01-19,20,DPD90+,0,0,0
2025-01-19,22,Current,0,0,0
2025-01-19,22,DPD60-89,0,0,0
2025-01-19,22,DPD90+,0,0,0
2025-01-19,24,Current,84,84,0
2025-01-19,24,DPD15-29,40,40,0
2025-01-19,24,DPD3-14,69,69,0
2025-01-19,24,DPD30-59,8,8,0
2025-01-19,24,DPD60-89,0,0,0
2025-01-19,24,DPD90+,0,0,0
2025-01-19,26,Current,0,0,0
2025-01-19,26,DPD15-29,9,9,0
2025-01-19,26,DPD3-14,10,10,0
2025-01-19,26,DPD30-59,3,3,0
2025-01-19,26,DPD60-89,0,0,0
2025-01-19,26,DPD90+,0,0,0
2025-01-19,32,Current,0,0,0
2025-01-19,32,DPD15-29,57,57,0
2025-01-19,32,DPD3-14,78,78,0
2025-01-19,32,DPD30-59,11,11,0
2025-01-19,32,DPD60-89,0,0,0
2025-01-19,32,DPD90+,0,0,0
2025-01-19,34,Current,0,0,0
2025-01-19,34,DPD15-29,29,29,0
2025-01-19,34,DPD3-14,28,28,0
2025-01-19,34,DPD30-59,5,5,0
2025-01-19,34,DPD60-89,0,0,0
2025-01-19,34,DPD90+,0,0,0
2025-01-19,36,Current,1,1,0
2025-01-19,36,DPD15-29,14,14,0
2025-01-19,36,DPD3-14,13,13,0
2025-01-19,36,DPD30-59,4,4,0
2025-01-19,36,DPD60-89,0,0,0
2025-01-19,36,DPD90+,0,0,0
2025-01-19,38,Current,18,18,0
2025-01-19,38,DPD15-29,15,15,0
2025-01-19,38,DPD3-14,27,27,0
2025-01-19,38,DPD30-59,3,3,0
2025-01-19,38,DPD60-89,0,0,0
2025-01-19,38,DPD90+,0,0,0
2025-01-19,40,Current,0,0,0
2025-01-19,40,DPD15-29,5,5,0
2025-01-19,40,DPD3-14,11,11,0
2025-01-19,40,DPD30-59,2,2,0
2025-01-19,40,DPD60-89,0,0,0
2025-01-19,40,DPD90+,0,0,0
2025-01-19,42,Current,0,0,0
2025-01-19,42,DPD15-29,4,4,0
2025-01-19,42,DPD3-14,10,10,0
2025-01-19,42,DPD30-59,0,0,0
2025-01-19,42,DPD60-89,0,0,0
2025-01-19,42,DPD90+,0,0,0
2025-01-19,44,Current,0,0,0
2025-01-19,44,DPD15-29,13,13,0
2025-01-19,44,DPD3-14,15,15,0
2025-01-19,44,DPD30-59,4,4,0
2025-01-19,44,DPD60-89,0,0,0
2025-01-19,44,DPD90+,0,0,0
2025-01-19,46,Current,0,0,0
2025-01-19,46,DPD3-14,1,1,0
2025-01-19,48,Current,43,43,0
2025-01-19,48,DPD15-29,5,5,0
2025-01-19,48,DPD3-14,15,15,0
2025-01-19,48,DPD30-59,0,0,0
2025-01-19,48,DPD60-89,0,0,0
2025-01-19,48,DPD90+,0,0,0
2025-01-19,6,Current,0,0,0
2025-01-18,100,Current,0,0,0
2025-01-18,100,DPD15-29,0,0,0
2025-01-18,100,DPD3-14,0,0,0
2025-01-18,102,Current,0,0,0
2025-01-18,102,DPD3-14,0,0,0
2025-01-18,102,DPD90+,0,0,0
2025-01-18,104,Current,0,0,0
2025-01-18,20,Current,0,0,0
2025-01-18,20,DPD15-29,68,68,0
2025-01-18,20,DPD3-14,94,94,0
2025-01-18,20,DPD30-59,161,161,0
2025-01-18,20,DPD60-89,0,0,0
2025-01-18,20,DPD90+,0,0,0
2025-01-18,22,Current,0,0,0
2025-01-18,22,DPD60-89,0,0,0
2025-01-18,22,DPD90+,0,0,0
2025-01-18,24,Current,3,3,0
2025-01-18,24,DPD15-29,39,39,0
2025-01-18,24,DPD3-14,57,57,0
2025-01-18,24,DPD30-59,95,95,0
2025-01-18,24,DPD60-89,0,0,0
2025-01-18,24,DPD90+,0,0,0
2025-01-18,26,Current,3,3,0
2025-01-18,26,DPD15-29,4,4,0
2025-01-18,26,DPD3-14,10,10,0
2025-01-18,26,DPD30-59,12,12,0
2025-01-18,26,DPD60-89,0,0,0
2025-01-18,26,DPD90+,0,0,0
2025-01-18,32,Current,0,0,0
2025-01-18,32,DPD15-29,42,42,0
2025-01-18,32,DPD3-14,45,45,0
2025-01-18,32,DPD30-59,89,89,0
2025-01-18,32,DPD60-89,0,0,0
2025-01-18,32,DPD90+,0,0,0
2025-01-18,34,Current,0,0,0
2025-01-18,34,DPD15-29,15,15,0
2025-01-18,34,DPD3-14,26,26,0
2025-01-18,34,DPD30-59,29,29,0
2025-01-18,34,DPD60-89,0,0,0
2025-01-18,34,DPD90+,0,0,0
2025-01-18,36,Current,0,0,0
2025-01-18,36,DPD15-29,7,7,0
2025-01-18,36,DPD3-14,6,6,0
2025-01-18,36,DPD30-59,18,18,0
2025-01-18,36,DPD60-89,0,0,0
2025-01-18,36,DPD90+,0,0,0
2025-01-18,38,Current,4,4,0
2025-01-18,38,DPD15-29,13,13,0
2025-01-18,38,DPD3-14,15,15,0
2025-01-18,38,DPD30-59,21,21,0
2025-01-18,38,DPD60-89,0,0,0
2025-01-18,38,DPD90+,0,0,0
2025-01-18,40,Current,0,0,0
2025-01-18,40,DPD15-29,8,8,0
2025-01-18,40,DPD3-14,11,11,0
2025-01-18,40,DPD30-59,9,9,0
2025-01-18,40,DPD60-89,0,0,0
2025-01-18,40,DPD90+,0,0,0
2025-01-18,42,Current,0,0,0
2025-01-18,42,DPD15-29,5,5,0
2025-01-18,42,DPD3-14,4,4,0
2025-01-18,42,DPD30-59,10,10,0
2025-01-18,42,DPD60-89,0,0,0
2025-01-18,42,DPD90+,0,0,0
2025-01-18,44,Current,0,0,0
2025-01-18,44,DPD15-29,10,10,0
2025-01-18,44,DPD3-14,12,12,0
2025-01-18,44,DPD30-59,25,25,0
2025-01-18,44,DPD60-89,0,0,0
2025-01-18,44,DPD90+,0,0,0
2025-01-18,46,Current,0,0,0
2025-01-18,46,DPD3-14,0,0,0
2025-01-18,48,Current,5,5,0
2025-01-18,48,DPD15-29,4,4,0
2025-01-18,48,DPD3-14,17,17,0
2025-01-18,48,DPD30-59,16,16,0
2025-01-18,48,DPD60-89,0,0,0
2025-01-18,48,DPD90+,0,0,0
2025-01-18,6,Current,0,0,0
2025-01-17,100,Current,0,0,0
2025-01-17,100,DPD3-14,1,1,0
2025-01-17,102,Current,0,0,0
2025-01-17,102,DPD3-14,0,0,0
2025-01-17,102,DPD90+,0,0,0
2025-01-17,104,Current,0,0,0
2025-01-17,20,Current,1,1,0
2025-01-17,20,DPD15-29,90,90,0
2025-01-17,20,DPD3-14,69,69,0
2025-01-17,20,DPD30-59,14,14,0
2025-01-17,20,DPD60-89,0,0,0
2025-01-17,20,DPD90+,0,0,0
2025-01-17,22,Current,0,0,0
2025-01-17,22,DPD60-89,0,0,0
2025-01-17,22,DPD90+,0,0,0
2025-01-17,24,Current,12,12,0
2025-01-17,24,DPD15-29,45,45,0
2025-01-17,24,DPD3-14,37,37,0
2025-01-17,24,DPD30-59,2,2,0
2025-01-17,24,DPD60-89,0,0,0
2025-01-17,24,DPD90+,0,0,0
2025-01-17,26,Current,0,0,0
2025-01-17,26,DPD15-29,6,6,0
2025-01-17,26,DPD3-14,6,6,0
2025-01-17,26,DPD30-59,1,1,0
2025-01-17,26,DPD60-89,0,0,0
2025-01-17,26,DPD90+,0,0,0
2025-01-17,32,Current,0,0,0
2025-01-17,32,DPD15-29,63,63,0
2025-01-17,32,DPD3-14,43,43,0
2025-01-17,32,DPD30-59,9,9,0
2025-01-17,32,DPD60-89,0,0,0
2025-01-17,32,DPD90+,0,0,0
2025-01-17,34,Current,0,0,0
2025-01-17,34,DPD15-29,27,27,0
2025-01-17,34,DPD3-14,18,18,0
2025-01-17,34,DPD30-59,3,3,0
2025-01-17,34,DPD60-89,0,0,0
2025-01-17,34,DPD90+,0,0,0
2025-01-17,36,Current,0,0,0
2025-01-17,36,DPD15-29,16,16,0
2025-01-17,36,DPD3-14,6,6,0
2025-01-17,36,DPD30-59,5,5,0
2025-01-17,36,DPD60-89,0,0,0
2025-01-17,36,DPD90+,0,0,0
2025-01-17,38,Current,1,1,0
2025-01-17,38,DPD15-29,15,15,0
2025-01-17,38,DPD3-14,11,11,0
2025-01-17,38,DPD30-59,3,3,0
2025-01-17,38,DPD60-89,0,0,0
2025-01-17,38,DPD90+,0,0,0
2025-01-17,40,Current,0,0,0
2025-01-17,40,DPD15-29,6,6,0
2025-01-17,40,DPD3-14,6,6,0
2025-01-17,40,DPD30-59,1,1,0
2025-01-17,40,DPD60-89,0,0,0
2025-01-17,40,DPD90+,0,0,0
2025-01-17,42,Current,0,0,0
2025-01-17,42,DPD15-29,4,4,0
2025-01-17,42,DPD3-14,3,3,0
2025-01-17,42,DPD30-59,3,3,0
2025-01-17,42,DPD60-89,0,0,0
2025-01-17,42,DPD90+,0,0,0
2025-01-17,44,Current,0,0,0
2025-01-17,44,DPD15-29,15,15,0
2025-01-17,44,DPD3-14,9,9,0
2025-01-17,44,DPD30-59,1,1,0
2025-01-17,44,DPD60-89,0,0,0
2025-01-17,44,DPD90+,0,0,0
2025-01-17,46,Current,0,0,0
2025-01-17,46,DPD3-14,1,1,0
2025-01-17,48,Current,26,26,0
2025-01-17,48,DPD15-29,5,5,0
2025-01-17,48,DPD3-14,12,12,0
2025-01-17,48,DPD30-59,2,2,0
2025-01-17,48,DPD60-89,0,0,0
2025-01-17,48,DPD90+,0,0,0
2025-01-17,6,Current,0,0,0
2025-01-16,100,Current,0,0,0
2025-01-16,100,DPD3-14,0,0,0
2025-01-16,102,Current,0,0,0
2025-01-16,102,DPD3-14,0,0,0
2025-01-16,102,DPD90+,0,0,0
2025-01-16,104,Current,0,0,0
2025-01-16,20,Current,3,3,0
2025-01-16,20,DPD15-29,68,68,0
2025-01-16,20,DPD3-14,99,99,0
2025-01-16,20,DPD30-59,147,147,0
2025-01-16,20,DPD60-89,0,0,0
2025-01-16,20,DPD90+,0,0,0
2025-01-16,22,Current,0,0,0
2025-01-16,22,DPD60-89,0,0,0
2025-01-16,22,DPD90+,0,0,0
2025-01-16,24,Current,3,3,0
2025-01-16,24,DPD15-29,32,32,0
2025-01-16,24,DPD3-14,55,55,0
2025-01-16,24,DPD30-59,62,62,0
2025-01-16,24,DPD60-89,0,0,0
2025-01-16,24,DPD90+,0,0,0
2025-01-16,26,Current,0,0,0
2025-01-16,26,DPD15-29,4,4,0
2025-01-16,26,DPD3-14,8,8,0
2025-01-16,26,DPD30-59,9,9,0
2025-01-16,26,DPD60-89,0,0,0
2025-01-16,26,DPD90+,0,0,0
2025-01-16,32,Current,0,0,0
2025-01-16,32,DPD15-29,44,44,0
2025-01-16,32,DPD3-14,35,35,0
2025-01-16,32,DPD30-59,68,68,0
2025-01-16,32,DPD60-89,0,0,0
2025-01-16,32,DPD90+,0,0,0
2025-01-16,34,Current,0,0,0
2025-01-16,34,DPD15-29,19,19,0
2025-01-16,34,DPD3-14,21,21,0
2025-01-16,34,DPD30-59,25,25,0
2025-01-16,34,DPD60-89,0,0,0
2025-01-16,34,DPD90+,0,0,0
2025-01-16,36,Current,0,0,0
2025-01-16,36,DPD15-29,6,6,0
2025-01-16,36,DPD3-14,5,5,0
2025-01-16,36,DPD30-59,18,18,0
2025-01-16,36,DPD60-89,0,0,0
2025-01-16,36,DPD90+,0,0,0
2025-01-16,38,Current,0,0,0
2025-01-16,38,DPD15-29,12,12,0
2025-01-16,38,DPD3-14,16,16,0
2025-01-16,38,DPD30-59,17,17,0
2025-01-16,38,DPD60-89,0,0,0
2025-01-16,38,DPD90+,0,0,0
2025-01-16,40,Current,0,0,0
2025-01-16,40,DPD15-29,8,8,0
2025-01-16,40,DPD3-14,12,12,0
2025-01-16,40,DPD30-59,9,9,0
2025-01-16,40,DPD60-89,0,0,0
2025-01-16,40,DPD90+,0,0,0
2025-01-16,42,Current,0,0,0
2025-01-16,42,DPD15-29,4,4,0
2025-01-16,42,DPD3-14,5,5,0
2025-01-16,42,DPD30-59,3,3,0
2025-01-16,42,DPD60-89,0,0,0
2025-01-16,42,DPD90+,0,0,0
2025-01-16,44,Current,0,0,0
2025-01-16,44,DPD15-29,9,9,0
2025-01-16,44,DPD3-14,14,14,0
2025-01-16,44,DPD30-59,17,17,0
2025-01-16,44,DPD60-89,0,0,0
2025-01-16,44,DPD90+,0,0,0
2025-01-16,46,Current,0,0,0
2025-01-16,46,DPD3-14,0,0,0
2025-01-16,48,Current,25,25,0
2025-01-16,48,DPD15-29,4,4,0
2025-01-16,48,DPD3-14,11,11,0
2025-01-16,48,DPD30-59,15,15,0
2025-01-16,48,DPD60-89,0,0,0
2025-01-16,48,DPD90+,0,0,0
2025-01-16,6,Current,0,0,0
2025-01-15,100,Current,0,0,0
2025-01-15,100,DPD3-14,1,1,0
2025-01-15,102,Current,0,0,0
2025-01-15,102,DPD3-14,0,0,0
2025-01-15,102,DPD90+,0,0,0
2025-01-15,104,Current,0,0,0
2025-01-15,20,Current,3580,3580,0
2025-01-15,20,DPD15-29,142,142,0
2025-01-15,20,DPD3-14,155,155,0
2025-01-15,20,DPD30-59,90,90,0
2025-01-15,20,DPD60-89,58,58,0
2025-01-15,20,DPD90+,38,38,0
2025-01-15,22,Current,0,0,0
2025-01-15,22,DPD60-89,0,0,0
2025-01-15,22,DPD90+,0,0,0
2025-01-15,24,Current,4791,4791,0
2025-01-15,24,DPD15-29,112,112,0
2025-01-15,24,DPD3-14,105,105,0
2025-01-15,24,DPD30-59,63,63,0
2025-01-15,24,DPD60-89,22,22,0
2025-01-15,24,DPD90+,20,20,0
2025-01-15,26,Current,1,1,0
2025-01-15,26,DPD15-29,8,8,0
2025-01-15,26,DPD3-14,7,7,0
2025-01-15,26,DPD30-59,1,1,0
2025-01-15,26,DPD60-89,0,0,0
2025-01-15,26,DPD90+,0,0,0
2025-01-15,32,Current,182,182,0
2025-01-15,32,DPD15-29,66,66,0
2025-01-15,32,DPD3-14,48,48,0
2025-01-15,32,DPD30-59,18,18,0
2025-01-15,32,DPD60-89,5,5,0
2025-01-15,32,DPD90+,3,3,0
2025-01-15,34,Current,0,0,0
2025-01-15,34,DPD15-29,28,28,0
2025-01-15,34,DPD3-14,26,26,0
2025-01-15,34,DPD30-59,5,5,0
2025-01-15,34,DPD60-89,0,0,0
2025-01-15,34,DPD90+,0,0,0
2025-01-15,36,Current,193,193,0
2025-01-15,36,DPD15-29,20,20,0
2025-01-15,36,DPD3-14,10,10,0
2025-01-15,36,DPD30-59,4,4,0
2025-01-15,36,DPD60-89,3,3,0
2025-01-15,36,DPD90+,1,1,0
2025-01-15,38,Current,308,308,0
2025-01-15,38,DPD15-29,17,17,0
2025-01-15,38,DPD3-14,20,20,0
2025-01-15,38,DPD30-59,3,3,0
2025-01-15,38,DPD60-89,0,0,0
2025-01-15,38,DPD90+,0,0,0
2025-01-15,40,Current,214,214,0
2025-01-15,40,DPD15-29,8,8,0
2025-01-15,40,DPD3-14,11,11,0
2025-01-15,40,DPD30-59,2,2,0
2025-01-15,40,DPD60-89,1,1,0
2025-01-15,40,DPD90+,1,1,0
2025-01-15,42,Current,3,3,0
2025-01-15,42,DPD15-29,2,2,0
2025-01-15,42,DPD3-14,4,4,0
2025-01-15,42,DPD30-59,1,1,0
2025-01-15,42,DPD60-89,0,0,0
2025-01-15,42,DPD90+,0,0,0
2025-01-15,44,Current,145,145,0
2025-01-15,44,DPD15-29,18,18,0
2025-01-15,44,DPD3-14,12,12,0
2025-01-15,44,DPD30-59,4,4,0
2025-01-15,44,DPD60-89,1,1,0
2025-01-15,44,DPD90+,0,0,0
2025-01-15,46,Current,4,4,0
2025-01-15,46,DPD3-14,1,1,0
2025-01-15,48,Current,4434,4434,0
2025-01-15,48,DPD15-29,68,68,0
2025-01-15,48,DPD3-14,92,92,0
2025-01-15,48,DPD30-59,42,42,0
2025-01-15,48,DPD60-89,23,23,0
2025-01-15,48,DPD90+,23,23,0
2025-01-15,6,Current,0,0,0
2025-01-14,100,Current,0,0,0
2025-01-14,100,DPD3-14,0,0,0
2025-01-14,102,Current,0,0,0
2025-01-14,102,DPD3-14,0,0,0
2025-01-14,102,DPD90+,0,0,0
2025-01-14,104,Current,0,0,0
2025-01-14,20,Current,0,0,0
2025-01-14,20,DPD15-29,121,121,0
2025-01-14,20,DPD3-14,81,81,0
2025-01-14,20,DPD30-59,196,196,0
2025-01-14,20,DPD60-89,0,0,0
2025-01-14,20,DPD90+,0,0,0
2025-01-14,22,Current,0,0,0
2025-01-14,22,DPD60-89,0,0,0
2025-01-14,22,DPD90+,0,0,0
2025-01-14,24,Current,25,25,0
2025-01-14,24,DPD15-29,48,48,0
2025-01-14,24,DPD3-14,51,51,0
2025-01-14,24,DPD30-59,120,120,0
2025-01-14,24,DPD60-89,0,0,0
2025-01-14,24,DPD90+,0,0,0
2025-01-14,26,Current,0,0,0
2025-01-14,26,DPD15-29,5,5,0
2025-01-14,26,DPD3-14,5,5,0
2025-01-14,26,DPD30-59,13,13,0
2025-01-14,26,DPD60-89,0,0,0
2025-01-14,26,DPD90+,0,0,0
2025-01-14,32,Current,0,0,0
2025-01-14,32,DPD15-29,69,69,0
2025-01-14,32,DPD3-14,37,37,0
2025-01-14,32,DPD30-59,107,107,0
2025-01-14,32,DPD60-89,0,0,0
2025-01-14,32,DPD90+,0,0,0
2025-01-14,34,Current,0,0,0
2025-01-14,34,DPD15-29,25,25,0
2025-01-14,34,DPD3-14,19,19,0
2025-01-14,34,DPD30-59,33,33,0
2025-01-14,34,DPD60-89,0,0,0
2025-01-14,34,DPD90+,0,0,0
2025-01-14,36,Current,0,0,0
2025-01-14,36,DPD15-29,10,10,0
2025-01-14,36,DPD3-14,2,2,0
2025-01-14,36,DPD30-59,29,29,0
2025-01-14,36,DPD60-89,0,0,0
2025-01-14,36,DPD90+,0,0,0
2025-01-14,38,Current,2,2,0
2025-01-14,38,DPD15-29,16,16,0
2025-01-14,38,DPD3-14,12,12,0
2025-01-14,38,DPD30-59,24,24,0
2025-01-14,38,DPD60-89,0,0,0
2025-01-14,38,DPD90+,0,0,0
2025-01-14,40,Current,0,0,0
2025-01-14,40,DPD15-29,14,14,0
2025-01-14,40,DPD3-14,11,11,0
2025-01-14,40,DPD30-59,15,15,0
2025-01-14,40,DPD60-89,0,0,0
2025-01-14,40,DPD90+,0,0,0
2025-01-14,42,Current,0,0,0
2025-01-14,42,DPD15-29,4,4,0
2025-01-14,42,DPD3-14,5,5,0
2025-01-14,42,DPD30-59,13,13,0
2025-01-14,42,DPD60-89,0,0,0
2025-01-14,42,DPD90+,0,0,0
2025-01-14,44,Current,3,3,0
2025-01-14,44,DPD15-29,16,16,0
2025-01-14,44,DPD3-14,13,13,0
2025-01-14,44,DPD30-59,28,28,0
2025-01-14,44,DPD60-89,0,0,0
2025-01-14,44,DPD90+,0,0,0
2025-01-14,46,Current,0,0,0
2025-01-14,46,DPD3-14,0,0,0
2025-01-14,48,Current,10,10,0
2025-01-14,48,DPD15-29,8,8,0
2025-01-14,48,DPD3-14,9,9,0
2025-01-14,48,DPD30-59,19,19,0
2025-01-14,48,DPD60-89,0,0,0
2025-01-14,48,DPD90+,0,0,0
2025-01-14,6,Current,0,0,0
2025-01-13,100,Current,0,0,0
2025-01-13,100,DPD3-14,1,1,0
2025-01-13,102,Current,0,0,0
2025-01-13,102,DPD3-14,0,0,0
2025-01-13,102,DPD90+,0,0,0
2025-01-13,104,Current,0,0,0
2025-01-13,20,Current,5,5,0
2025-01-13,20,DPD15-29,104,104,0
2025-01-13,20,DPD3-14,58,58,0
2025-01-13,20,DPD30-59,7,7,0
2025-01-13,20,DPD60-89,0,0,0
2025-01-13,20,DPD90+,0,0,0
2025-01-13,22,Current,0,0,0
2025-01-13,22,DPD60-89,0,0,0
2025-01-13,22,DPD90+,0,0,0
2025-01-13,24,Current,22,22,0
2025-01-13,24,DPD15-29,51,51,0
2025-01-13,24,DPD3-14,34,34,0
2025-01-13,24,DPD30-59,1,1,0
2025-01-13,24,DPD60-89,0,0,0
2025-01-13,24,DPD90+,0,0,0
2025-01-13,26,Current,0,0,0
2025-01-13,26,DPD15-29,10,10,0
2025-01-13,26,DPD3-14,6,6,0
2025-01-13,26,DPD30-59,1,1,0
2025-01-13,26,DPD60-89,0,0,0
2025-01-13,26,DPD90+,0,0,0
2025-01-13,32,Current,0,0,0
2025-01-13,32,DPD15-29,82,82,0
2025-01-13,32,DPD3-14,41,41,0
2025-01-13,32,DPD30-59,4,4,0
2025-01-13,32,DPD60-89,0,0,0
2025-01-13,32,DPD90+,0,0,0
2025-01-13,34,Current,0,0,0
2025-01-13,34,DPD15-29,33,33,0
2025-01-13,34,DPD3-14,22,22,0
2025-01-13,34,DPD30-59,0,0,0
2025-01-13,34,DPD60-89,0,0,0
2025-01-13,34,DPD90+,0,0,0
2025-01-13,36,Current,0,0,0
2025-01-13,36,DPD15-29,18,18,0
2025-01-13,36,DPD3-14,8,8,0
2025-01-13,36,DPD30-59,1,1,0
2025-01-13,36,DPD60-89,0,0,0
2025-01-13,36,DPD90+,0,0,0
2025-01-13,38,Current,10,10,0
2025-01-13,38,DPD15-29,15,15,0
2025-01-13,38,DPD3-14,16,16,0
2025-01-13,38,DPD30-59,3,3,0
2025-01-13,38,DPD60-89,0,0,0
2025-01-13,38,DPD90+,0,0,0
2025-01-13,40,Current,0,0,0
2025-01-13,40,DPD15-29,6,6,0
2025-01-13,40,DPD3-14,4,4,0
2025-01-13,40,DPD30-59,0,0,0
2025-01-13,40,DPD60-89,0,0,0
2025-01-13,40,DPD90+,0,0,0
2025-01-13,42,Current,0,0,0
2025-01-13,42,DPD15-29,4,4,0
2025-01-13,42,DPD3-14,4,4,0
2025-01-13,42,DPD30-59,2,2,0
2025-01-13,42,DPD60-89,0,0,0
2025-01-13,42,DPD90+,0,0,0
2025-01-13,44,Current,0,0,0
2025-01-13,44,DPD15-29,19,19,0
2025-01-13,44,DPD3-14,11,11,0
2025-01-13,44,DPD30-59,0,0,0
2025-01-13,44,DPD60-89,0,0,0
2025-01-13,44,DPD90+,0,0,0
2025-01-13,46,Current,0,0,0
2025-01-13,46,DPD3-14,1,1,0
2025-01-13,48,Current,16,16,0
2025-01-13,48,DPD15-29,6,6,0
2025-01-13,48,DPD3-14,7,7,0
2025-01-13,48,DPD30-59,2,2,0
2025-01-13,48,DPD60-89,0,0,0
2025-01-13,48,DPD90+,0,0,0
2025-01-13,6,Current,0,0,0
2025-01-12,100,Current,0,0,0
2025-01-12,100,DPD3-14,0,0,0
2025-01-12,102,Current,0,0,0
2025-01-12,102,DPD3-14,0,0,0
2025-01-12,102,DPD90+,0,0,0
2025-01-12,104,Current,0,0,0
2025-01-12,20,Current,8,8,0
2025-01-12,20,DPD15-29,124,124,0
2025-01-12,20,DPD3-14,60,60,0
2025-01-12,20,DPD30-59,139,139,0
2025-01-12,20,DPD60-89,0,0,0
2025-01-12,20,DPD90+,0,0,0
2025-01-12,22,Current,0,0,0
2025-01-12,22,DPD60-89,0,0,0
2025-01-12,22,DPD90+,0,0,0
2025-01-12,24,Current,118,118,0
2025-01-12,24,DPD15-29,45,45,0
2025-01-12,24,DPD3-14,41,41,0
2025-01-12,24,DPD30-59,56,56,0
2025-01-12,24,DPD60-89,0,0,0
2025-01-12,24,DPD90+,0,0,0
2025-01-12,26,Current,0,0,0
2025-01-12,26,DPD15-29,5,5,0
2025-01-12,26,DPD3-14,2,2,0
2025-01-12,26,DPD30-59,8,8,0
2025-01-12,26,DPD60-89,0,0,0
2025-01-12,26,DPD90+,0,0,0
2025-01-12,32,Current,0,0,0
2025-01-12,32,DPD15-29,70,70,0
2025-01-12,32,DPD3-14,29,29,0
2025-01-12,32,DPD30-59,62,62,0
2025-01-12,32,DPD60-89,0,0,0
2025-01-12,32,DPD90+,0,0,0
2025-01-12,34,Current,0,0,0
2025-01-12,34,DPD15-29,24,24,0
2025-01-12,34,DPD3-14,18,18,0
2025-01-12,34,DPD30-59,24,24,0
2025-01-12,34,DPD60-89,0,0,0
2025-01-12,34,DPD90+,0,0,0
2025-01-12,36,Current,0,0,0
2025-01-12,36,DPD15-29,7,7,0
2025-01-12,36,DPD3-14,5,5,0
2025-01-12,36,DPD30-59,18,18,0
2025-01-12,36,DPD60-89,0,0,0
2025-01-12,36,DPD90+,0,0,0
2025-01-12,38,Current,29,29,0
2025-01-12,38,DPD15-29,14,14,0
2025-01-12,38,DPD3-14,12,12,0
2025-01-12,38,DPD30-59,15,15,0
2025-01-12,38,DPD60-89,0,0,0
2025-01-12,38,DPD90+,0,0,0
2025-01-12,40,Current,0,0,0
2025-01-12,40,DPD15-29,16,16,0
2025-01-12,40,DPD3-14,8,8,0
2025-01-12,40,DPD30-59,4,4,0
2025-01-12,40,DPD60-89,0,0,0
2025-01-12,40,DPD90+,0,0,0
2025-01-12,42,Current,0,0,0
2025-01-12,42,DPD15-29,4,4,0
2025-01-12,42,DPD3-14,3,3,0
2025-01-12,42,DPD30-59,5,5,0
2025-01-12,42,DPD60-89,0,0,0
2025-01-12,42,DPD90+,0,0,0
2025-01-12,44,Current,0,0,0
2025-01-12,44,DPD15-29,17,17,0
2025-01-12,44,DPD3-14,11,11,0
2025-01-12,44,DPD30-59,14,14,0
2025-01-12,44,DPD60-89,0,0,0
2025-01-12,44,DPD90+,0,0,0
2025-01-12,46,Current,0,0,0
2025-01-12,46,DPD3-14,0,0,0
2025-01-12,48,Current,64,64,0
2025-01-12,48,DPD15-29,10,10,0
2025-01-12,48,DPD3-14,5,5,0
2025-01-12,48,DPD30-59,12,12,0
2025-01-12,48,DPD60-89,0,0,0
2025-01-12,48,DPD90+,0,0,0
2025-01-12,6,Current,0,0,0
2025-01-11,100,Current,0,0,0
2025-01-11,100,DPD3-14,1,1,0
2025-01-11,102,Current,0,0,0
2025-01-11,102,DPD3-14,0,0,0
2025-01-11,102,DPD90+,0,0,0
2025-01-11,104,Current,0,0,0
2025-01-11,20,Current,6,6,0
2025-01-11,20,DPD15-29,82,82,0
2025-01-11,20,DPD3-14,86,86,0
2025-01-11,20,DPD30-59,17,17,0
2025-01-11,20,DPD60-89,0,0,0
2025-01-11,20,DPD90+,0,0,0
2025-01-11,22,Current,0,0,0
2025-01-11,22,DPD60-89,0,0,0
2025-01-11,22,DPD90+,0,0,0
2025-01-11,24,Current,5,5,0
2025-01-11,24,DPD15-29,35,35,0
2025-01-11,24,DPD3-14,46,46,0
2025-01-11,24,DPD30-59,10,10,0
2025-01-11,24,DPD60-89,0,0,0
2025-01-11,24,DPD90+,0,0,0
2025-01-11,26,Current,0,0,0
2025-01-11,26,DPD15-29,6,6,0
2025-01-11,26,DPD3-14,12,12,0
2025-01-11,26,DPD30-59,1,1,0
2025-01-11,26,DPD60-89,0,0,0
2025-01-11,26,DPD90+,0,0,0
2025-01-11,32,Current,4,4,0
2025-01-11,32,DPD15-29,60,60,0
2025-01-11,32,DPD3-14,56,56,0
2025-01-11,32,DPD30-59,6,6,0
2025-01-11,32,DPD60-89,0,0,0
2025-01-11,32,DPD90+,0,0,0
2025-01-11,34,Current,0,0,0
2025-01-11,34,DPD15-29,21,21,0
2025-01-11,34,DPD3-14,29,29,0
2025-01-11,34,DPD30-59,6,6,0
2025-01-11,34,DPD60-89,0,0,0
2025-01-11,34,DPD90+,0,0,0
2025-01-11,36,Current,0,0,0
2025-01-11,36,DPD15-29,12,12,0
2025-01-11,36,DPD3-14,13,13,0
2025-01-11,36,DPD30-59,0,0,0
2025-01-11,36,DPD60-89,0,0,0
2025-01-11,36,DPD90+,0,0,0
2025-01-11,38,Current,3,3,0
2025-01-11,38,DPD15-29,11,11,0
2025-01-11,38,DPD3-14,20,20,0
2025-01-11,38,DPD30-59,3,3,0
2025-01-11,38,DPD60-89,0,0,0
2025-01-11,38,DPD90+,0,0,0
2025-01-11,40,Current,0,0,0
2025-01-11,40,DPD15-29,5,5,0
2025-01-11,40,DPD3-14,5,5,0
2025-01-11,40,DPD30-59,1,1,0
2025-01-11,40,DPD60-89,0,0,0
2025-01-11,40,DPD90+,0,0,0
2025-01-11,42,Current,0,0,0
2025-01-11,42,DPD15-29,5,5,0
2025-01-11,42,DPD3-14,3,3,0
2025-01-11,42,DPD30-59,2,2,0
2025-01-11,42,DPD60-89,0,0,0
2025-01-11,42,DPD90+,0,0,0
2025-01-11,44,Current,7,7,0
2025-01-11,44,DPD15-29,14,14,0
2025-01-11,44,DPD3-14,15,15,0
2025-01-11,44,DPD30-59,3,3,0
2025-01-11,44,DPD60-89,0,0,0
2025-01-11,44,DPD90+,0,0,0
2025-01-11,46,Current,0,0,0
2025-01-11,46,DPD3-14,1,1,0
2025-01-11,48,Current,1,1,0
2025-01-11,48,DPD15-29,6,6,0
2025-01-11,48,DPD3-14,8,8,0
2025-01-11,48,DPD30-59,1,1,0
2025-01-11,48,DPD60-89,0,0,0
2025-01-11,48,DPD90+,0,0,0
2025-01-11,6,Current,0,0,0
2025-01-10,100,Current,0,0,0
2025-01-10,100,DPD3-14,0,0,0
2025-01-10,102,Current,0,0,0
2025-01-10,102,DPD3-14,0,0,0
2025-01-10,102,DPD90+,0,0,0
2025-01-10,104,Current,0,0,0
2025-01-10,20,Current,1,1,0
2025-01-10,20,DPD15-29,111,111,0
2025-01-10,20,DPD3-14,66,66,0
2025-01-10,20,DPD30-59,211,211,0
2025-01-10,20,DPD60-89,0,0,0
2025-01-10,20,DPD90+,0,0,0
2025-01-10,22,Current,0,0,0
2025-01-10,22,DPD60-89,0,0,0
2025-01-10,22,DPD90+,0,0,0
2025-01-10,24,Current,8,8,0
2025-01-10,24,DPD15-29,44,44,0
2025-01-10,24,DPD3-14,38,38,0
2025-01-10,24,DPD30-59,124,124,0
2025-01-10,24,DPD60-89,0,0,0
2025-01-10,24,DPD90+,0,0,0
2025-01-10,26,Current,0,0,0
2025-01-10,26,DPD15-29,5,5,0
2025-01-10,26,DPD3-14,2,2,0
2025-01-10,26,DPD30-59,14,14,0
2025-01-10,26,DPD60-89,0,0,0
2025-01-10,26,DPD90+,0,0,0
2025-01-10,32,Current,4,4,0
2025-01-10,32,DPD15-29,75,75,0
2025-01-10,32,DPD3-14,28,28,0
2025-01-10,32,DPD30-59,104,104,0
2025-01-10,32,DPD60-89,0,0,0
2025-01-10,32,DPD90+,0,0,0
2025-01-10,34,Current,0,0,0
2025-01-10,34,DPD15-29,23,23,0
2025-01-10,34,DPD3-14,17,17,0
2025-01-10,34,DPD30-59,31,31,0
2025-01-10,34,DPD60-89,0,0,0
2025-01-10,34,DPD90+,0,0,0
2025-01-10,36,Current,0,0,0
2025-01-10,36,DPD15-29,9,9,0
2025-01-10,36,DPD3-14,6,6,0
2025-01-10,36,DPD30-59,33,33,0
2025-01-10,36,DPD60-89,0,0,0
2025-01-10,36,DPD90+,0,0,0
2025-01-10,38,Current,1,1,0
2025-01-10,38,DPD15-29,15,15,0
2025-01-10,38,DPD3-14,9,9,0
2025-01-10,38,DPD30-59,24,24,0
2025-01-10,38,DPD60-89,0,0,0
2025-01-10,38,DPD90+,0,0,0
2025-01-10,40,Current,0,0,0
2025-01-10,40,DPD15-29,14,14,0
2025-01-10,40,DPD3-14,8,8,0
2025-01-10,40,DPD30-59,14,14,0
2025-01-10,40,DPD60-89,0,0,0
2025-01-10,40,DPD90+,0,0,0
2025-01-10,42,Current,0,0,0
2025-01-10,42,DPD15-29,3,3,0
2025-01-10,42,DPD3-14,3,3,0
2025-01-10,42,DPD30-59,13,13,0
2025-01-10,42,DPD60-89,0,0,0
2025-01-10,42,DPD90+,0,0,0
2025-01-10,44,Current,0,0,0
2025-01-10,44,DPD15-29,15,15,0
2025-01-10,44,DPD3-14,8,8,0
2025-01-10,44,DPD30-59,26,26,0
2025-01-10,44,DPD60-89,0,0,0
2025-01-10,44,DPD90+,0,0,0
2025-01-10,46,Current,0,0,0
2025-01-10,46,DPD3-14,0,0,0
2025-01-10,48,Current,1,1,0
2025-01-10,48,DPD15-29,12,12,0
2025-01-10,48,DPD3-14,4,4,0
2025-01-10,48,DPD30-59,21,21,0
2025-01-10,48,DPD60-89,0,0,0
2025-01-10,48,DPD90+,0,0,0
2025-01-10,6,Current,0,0,0
2025-01-09,100,Current,0,0,0
2025-01-09,100,DPD3-14,1,1,0
2025-01-09,102,Current,0,0,0
2025-01-09,102,DPD3-14,0,0,0
2025-01-09,102,DPD90+,0,0,0
2025-01-09,104,Current,0,0,0
2025-01-09,20,Current,14,14,0
2025-01-09,20,DPD15-29,95,95,0
2025-01-09,20,DPD3-14,89,89,0
2025-01-09,20,DPD30-59,34,34,0
2025-01-09,20,DPD60-89,1,1,0
2025-01-09,20,DPD90+,0,0,0
2025-01-09,22,Current,0,0,0
2025-01-09,22,DPD60-89,0,0,0
2025-01-09,22,DPD90+,0,0,0
2025-01-09,24,Current,7,7,0
2025-01-09,24,DPD15-29,46,46,0
2025-01-09,24,DPD3-14,48,48,0
2025-01-09,24,DPD30-59,11,11,0
2025-01-09,24,DPD60-89,0,0,0
2025-01-09,24,DPD90+,0,0,0
2025-01-09,26,Current,0,0,0
2025-01-09,26,DPD15-29,8,8,0
2025-01-09,26,DPD3-14,11,11,0
2025-01-09,26,DPD30-59,1,1,0
2025-01-09,26,DPD60-89,0,0,0
2025-01-09,26,DPD90+,0,0,0
2025-01-09,32,Current,4,4,0
2025-01-09,32,DPD15-29,61,61,0
2025-01-09,32,DPD3-14,62,62,0
2025-01-09,32,DPD30-59,18,18,0
2025-01-09,32,DPD60-89,0,0,0
2025-01-09,32,DPD90+,0,0,0
2025-01-09,34,Current,0,0,0
2025-01-09,34,DPD15-29,23,23,0
2025-01-09,34,DPD3-14,24,24,0
2025-01-09,34,DPD30-59,6,6,0
2025-01-09,34,DPD60-89,0,0,0
2025-01-09,34,DPD90+,0,0,0
2025-01-09,36,Current,0,0,0
2025-01-09,36,DPD15-29,11,11,0
2025-01-09,36,DPD3-14,14,14,0
2025-01-09,36,DPD30-59,0,0,0
2025-01-09,36,DPD60-89,0,0,0
2025-01-09,36,DPD90+,3,3,0
2025-01-09,38,Current,2,2,0
2025-01-09,38,DPD15-29,11,11,0
2025-01-09,38,DPD3-14,23,23,0
2025-01-09,38,DPD30-59,7,7,0
2025-01-09,38,DPD60-89,0,0,0
2025-01-09,38,DPD90+,0,0,0
2025-01-09,40,Current,3,3,0
2025-01-09,40,DPD15-29,8,8,0
2025-01-09,40,DPD3-14,4,4,0
2025-01-09,40,DPD30-59,1,1,0
2025-01-09,40,DPD60-89,0,0,0
2025-01-09,40,DPD90+,0,0,0
2025-01-09,42,Current,4,4,0
2025-01-09,42,DPD15-29,8,8,0
2025-01-09,42,DPD3-14,3,3,0
2025-01-09,42,DPD30-59,1,1,0
2025-01-09,42,DPD60-89,0,0,0
2025-01-09,42,DPD90+,0,0,0
2025-01-09,44,Current,0,0,0
2025-01-09,44,DPD15-29,19,19,0
2025-01-09,44,DPD3-14,11,11,0
2025-01-09,44,DPD30-59,5,5,0
2025-01-09,44,DPD60-89,0,0,0
2025-01-09,44,DPD90+,0,0,0
2025-01-09,46,Current,0,0,0
2025-01-09,48,Current,3,3,0
2025-01-09,48,DPD15-29,7,7,0
2025-01-09,48,DPD3-14,9,9,0
2025-01-09,48,DPD30-59,3,3,0
2025-01-09,48,DPD60-89,0,0,0
2025-01-09,48,DPD90+,0,0,0
2025-01-09,6,Current,0,0,0
2025-01-08,100,Current,0,0,0
2025-01-08,100,DPD3-14,0,0,0
2025-01-08,102,Current,0,0,0
2025-01-08,102,DPD90+,0,0,0
2025-01-08,104,Current,0,0,0
2025-01-08,20,Current,7,7,0
2025-01-08,20,DPD15-29,115,115,0
2025-01-08,20,DPD3-14,74,74,0
2025-01-08,20,DPD30-59,117,117,0
2025-01-08,20,DPD60-89,4,4,0
2025-01-08,20,DPD90+,4,4,0
2025-01-08,22,Current,0,0,0
2025-01-08,22,DPD60-89,0,0,0
2025-01-08,22,DPD90+,0,0,0
2025-01-08,24,Current,5,5,0
2025-01-08,24,DPD15-29,52,52,0
2025-01-08,24,DPD3-14,33,33,0
2025-01-08,24,DPD30-59,54,54,0
2025-01-08,24,DPD60-89,0,0,0
2025-01-08,24,DPD90+,0,0,0
2025-01-08,26,Current,4,4,0
2025-01-08,26,DPD15-29,8,8,0
2025-01-08,26,DPD3-14,0,0,0
2025-01-08,26,DPD30-59,7,7,0
2025-01-08,26,DPD60-89,1,1,0
2025-01-08,26,DPD90+,1,1,0
2025-01-08,32,Current,5,5,0
2025-01-08,32,DPD15-29,79,79,0
2025-01-08,32,DPD3-14,34,34,0
2025-01-08,32,DPD30-59,60,60,0
2025-01-08,32,DPD60-89,4,4,0
2025-01-08,32,DPD90+,4,4,0
2025-01-08,34,Current,0,0,0
2025-01-08,34,DPD15-29,23,23,0
2025-01-08,34,DPD3-14,19,19,0
2025-01-08,34,DPD30-59,20,20,0
2025-01-08,34,DPD60-89,1,1,0
2025-01-08,34,DPD90+,1,1,0
2025-01-08,36,Current,1,1,0
2025-01-08,36,DPD15-29,12,12,0
2025-01-08,36,DPD3-14,6,6,0
2025-01-08,36,DPD30-59,18,18,0
2025-01-08,36,DPD60-89,2,2,0
2025-01-08,36,DPD90+,0,0,0
2025-01-08,38,Current,0,0,0
2025-01-08,38,DPD15-29,15,15,0
2025-01-08,38,DPD3-14,12,12,0
2025-01-08,38,DPD30-59,10,10,0
2025-01-08,38,DPD60-89,1,1,0
2025-01-08,38,DPD90+,1,1,0
2025-01-08,40,Current,0,0,0
2025-01-08,40,DPD15-29,13,13,0
2025-01-08,40,DPD3-14,7,7,0
2025-01-08,40,DPD30-59,5,5,0
2025-01-08,40,DPD60-89,0,0,0
2025-01-08,40,DPD90+,0,0,0
2025-01-08,42,Current,0,0,0
2025-01-08,42,DPD15-29,2,2,0
2025-01-08,42,DPD3-14,4,4,0
2025-01-08,42,DPD30-59,8,8,0
2025-01-08,42,DPD60-89,0,0,0
2025-01-08,42,DPD90+,0,0,0
2025-01-08,44,Current,0,0,0
2025-01-08,44,DPD15-29,16,16,0
2025-01-08,44,DPD3-14,7,7,0
2025-01-08,44,DPD30-59,12,12,0
2025-01-08,44,DPD60-89,1,1,0
2025-01-08,44,DPD90+,1,1,0
2025-01-08,46,Current,0,0,0
2025-01-08,48,Current,2,2,0
2025-01-08,48,DPD15-29,14,14,0
2025-01-08,48,DPD3-14,4,4,0
2025-01-08,48,DPD30-59,15,15,0
2025-01-08,48,DPD60-89,1,1,0
2025-01-08,48,DPD90+,0,0,0
2025-01-08,6,Current,0,0,0
2025-01-07,100,Current,0,0,0
2025-01-07,100,DPD3-14,0,0,0
2025-01-07,102,Current,0,0,0
2025-01-07,102,DPD90+,0,0,0
2025-01-07,104,Current,0,0,0
2025-01-07,20,Current,3,3,0
2025-01-07,20,DPD15-29,96,96,0
2025-01-07,20,DPD3-14,97,97,0
2025-01-07,20,DPD30-59,42,42,0
2025-01-07,20,DPD60-89,0,0,0
2025-01-07,20,DPD90+,0,0,0
2025-01-07,22,Current,0,0,0
2025-01-07,22,DPD60-89,0,0,0
2025-01-07,22,DPD90+,0,0,0
2025-01-07,24,Current,9,9,0
2025-01-07,24,DPD15-29,55,55,0
2025-01-07,24,DPD3-14,48,48,0
2025-01-07,24,DPD30-59,20,20,0
2025-01-07,24,DPD60-89,0,0,0
2025-01-07,24,DPD90+,0,0,0
2025-01-07,26,Current,0,0,0
2025-01-07,26,DPD15-29,5,5,0
2025-01-07,26,DPD3-14,12,12,0
2025-01-07,26,DPD30-59,3,3,0
2025-01-07,26,DPD60-89,0,0,0
2025-01-07,26,DPD90+,0,0,0
2025-01-07,32,Current,0,0,0
2025-01-07,32,DPD15-29,62,62,0
2025-01-07,32,DPD3-14,67,67,0
2025-01-07,32,DPD30-59,16,16,0
2025-01-07,32,DPD60-89,0,0,0
2025-01-07,32,DPD90+,0,0,0
2025-01-07,34,Current,0,0,0
2025-01-07,34,DPD15-29,23,23,0
2025-01-07,34,DPD3-14,27,27,0
2025-01-07,34,DPD30-59,3,3,0
2025-01-07,34,DPD60-89,0,0,0
2025-01-07,34,DPD90+,0,0,0
2025-01-07,36,Current,0,0,0
2025-01-07,36,DPD15-29,12,12,0
2025-01-07,36,DPD3-14,13,13,0
2025-01-07,36,DPD30-59,5,5,0
2025-01-07,36,DPD60-89,0,0,0
2025-01-07,36,DPD90+,0,0,0
2025-01-07,38,Current,0,0,0
2025-01-07,38,DPD15-29,13,13,0
2025-01-07,38,DPD3-14,20,20,0
2025-01-07,38,DPD30-59,1,1,0
2025-01-07,38,DPD60-89,0,0,0
2025-01-07,38,DPD90+,0,0,0
2025-01-07,40,Current,0,0,0
2025-01-07,40,DPD15-29,5,5,0
2025-01-07,40,DPD3-14,5,5,0
2025-01-07,40,DPD30-59,3,3,0
2025-01-07,40,DPD60-89,0,0,0
2025-01-07,40,DPD90+,0,0,0
2025-01-07,42,Current,0,0,0
2025-01-07,42,DPD15-29,8,8,0
2025-01-07,42,DPD3-14,5,5,0
2025-01-07,42,DPD30-59,3,3,0
2025-01-07,42,DPD60-89,0,0,0
2025-01-07,42,DPD90+,0,0,0
2025-01-07,44,Current,0,0,0
2025-01-07,44,DPD15-29,18,18,0
2025-01-07,44,DPD3-14,13,13,0
2025-01-07,44,DPD30-59,4,4,0
2025-01-07,44,DPD60-89,0,0,0
2025-01-07,44,DPD90+,0,0,0
2025-01-07,46,Current,0,0,0
2025-01-07,48,Current,1,1,0
2025-01-07,48,DPD15-29,9,9,0
2025-01-07,48,DPD3-14,6,6,0
2025-01-07,48,DPD30-59,3,3,0
2025-01-07,48,DPD60-89,0,0,0
2025-01-07,48,DPD90+,0,0,0
2025-01-07,6,Current,0,0,0
2025-01-06,100,Current,0,0,0
2025-01-06,100,DPD3-14,0,0,0
2025-01-06,102,Current,0,0,0
2025-01-06,102,DPD90+,0,0,0
2025-01-06,104,Current,0,0,0
2025-01-06,20,Current,4,4,0
2025-01-06,20,DPD15-29,126,126,0
2025-01-06,20,DPD3-14,69,69,0
2025-01-06,20,DPD30-59,203,203,0
2025-01-06,20,DPD60-89,0,0,0
2025-01-06,20,DPD90+,0,0,0
2025-01-06,22,Current,0,0,0
2025-01-06,22,DPD60-89,0,0,0
2025-01-06,22,DPD90+,0,0,0
2025-01-06,24,Current,8,8,0
2025-01-06,24,DPD15-29,57,57,0
2025-01-06,24,DPD3-14,30,30,0
2025-01-06,24,DPD30-59,111,111,0
2025-01-06,24,DPD60-89,0,0,0
2025-01-06,24,DPD90+,0,0,0
2025-01-06,26,Current,1,1,0
2025-01-06,26,DPD15-29,6,6,0
2025-01-06,26,DPD3-14,1,1,0
2025-01-06,26,DPD30-59,15,15,0
2025-01-06,26,DPD60-89,0,0,0
2025-01-06,26,DPD90+,0,0,0
2025-01-06,32,Current,0,0,0
2025-01-06,32,DPD15-29,77,77,0
2025-01-06,32,DPD3-14,41,41,0
2025-01-06,32,DPD30-59,100,100,0
2025-01-06,32,DPD60-89,0,0,0
2025-01-06,32,DPD90+,0,0,0
2025-01-06,34,Current,0,0,0
2025-01-06,34,DPD15-29,22,22,0
2025-01-06,34,DPD3-14,15,15,0
2025-01-06,34,DPD30-59,36,36,0
2025-01-06,34,DPD60-89,0,0,0
2025-01-06,34,DPD90+,0,0,0
2025-01-06,36,Current,0,0,0
2025-01-06,36,DPD15-29,13,13,0
2025-01-06,36,DPD3-14,7,7,0
2025-01-06,36,DPD30-59,32,32,0
2025-01-06,36,DPD60-89,0,0,0
2025-01-06,36,DPD90+,0,0,0
2025-01-06,38,Current,4,4,0
2025-01-06,38,DPD15-29,14,14,0
2025-01-06,38,DPD3-14,9,9,0
2025-01-06,38,DPD30-59,27,27,0
2025-01-06,38,DPD60-89,0,0,0
2025-01-06,38,DPD90+,0,0,0
2025-01-06,40,Current,0,0,0
2025-01-06,40,DPD15-29,13,13,0
2025-01-06,40,DPD3-14,6,6,0
2025-01-06,40,DPD30-59,21,21,0
2025-01-06,40,DPD60-89,0,0,0
2025-01-06,40,DPD90+,0,0,0
2025-01-06,42,Current,0,0,0
2025-01-06,42,DPD15-29,2,2,0
2025-01-06,42,DPD3-14,3,3,0
2025-01-06,42,DPD30-59,13,13,0
2025-01-06,42,DPD60-89,0,0,0
2025-01-06,42,DPD90+,0,0,0
2025-01-06,44,Current,0,0,0
2025-01-06,44,DPD15-29,18,18,0
2025-01-06,44,DPD3-14,10,10,0
2025-01-06,44,DPD30-59,26,26,0
2025-01-06,44,DPD60-89,0,0,0
2025-01-06,44,DPD90+,0,0,0
2025-01-06,46,Current,0,0,0
2025-01-06,46,DPD15-29,1,1,0
2025-01-06,46,DPD30-59,0,0,0
2025-01-06,48,Current,0,0,0
2025-01-06,48,DPD15-29,18,18,0
2025-01-06,48,DPD3-14,4,4,0
2025-01-06,48,DPD30-59,19,19,0
2025-01-06,48,DPD60-89,0,0,0
2025-01-06,48,DPD90+,0,0,0
2025-01-06,6,Current,0,0,0
2025-01-05,100,Current,0,0,0
2025-01-05,102,Current,0,0,0
2025-01-05,102,DPD90+,0,0,0
2025-01-05,104,Current,0,0,0
2025-01-05,20,Current,1,1,0
2025-01-05,20,DPD15-29,105,105,0
2025-01-05,20,DPD3-14,100,100,0
2025-01-05,20,DPD30-59,27,27,0
2025-01-05,20,DPD60-89,0,0,0
2025-01-05,20,DPD90+,0,0,0
2025-01-05,22,Current,0,0,0
2025-01-05,22,DPD30-59,0,0,0
2025-01-05,22,DPD60-89,0,0,0
2025-01-05,22,DPD90+,0,0,0
2025-01-05,24,Current,319,319,0
2025-01-05,24,DPD15-29,63,63,0
2025-01-05,24,DPD3-14,47,47,0
2025-01-05,24,DPD30-59,7,7,0
2025-01-05,24,DPD60-89,0,0,0
2025-01-05,24,DPD90+,0,0,0
2025-01-05,26,Current,0,0,0
2025-01-05,26,DPD15-29,6,6,0
2025-01-05,26,DPD3-14,11,11,0
2025-01-05,26,DPD30-59,3,3,0
2025-01-05,26,DPD60-89,0,0,0
2025-01-05,26,DPD90+,0,0,0
2025-01-05,32,Current,0,0,0
2025-01-05,32,DPD15-29,72,72,0
2025-01-05,32,DPD3-14,66,66,0
2025-01-05,32,DPD30-59,13,13,0
2025-01-05,32,DPD60-89,0,0,0
2025-01-05,32,DPD90+,0,0,0
2025-01-05,34,Current,0,0,0
2025-01-05,34,DPD15-29,29,29,0
2025-01-05,34,DPD3-14,25,25,0
2025-01-05,34,DPD30-59,4,4,0
2025-01-05,34,DPD60-89,0,0,0
2025-01-05,34,DPD90+,0,0,0
2025-01-05,36,Current,0,0,0
2025-01-05,36,DPD15-29,16,16,0
2025-01-05,36,DPD3-14,13,13,0
2025-01-05,36,DPD30-59,5,5,0
2025-01-05,36,DPD60-89,0,0,0
2025-01-05,36,DPD90+,0,0,0
2025-01-05,38,Current,83,83,0
2025-01-05,38,DPD15-29,14,14,0
2025-01-05,38,DPD3-14,18,18,0
2025-01-05,38,DPD30-59,5,5,0
2025-01-05,38,DPD60-89,0,0,0
2025-01-05,38,DPD90+,0,0,0
2025-01-05,40,Current,0,0,0
2025-01-05,40,DPD15-29,8,8,0
2025-01-05,40,DPD3-14,5,5,0
2025-01-05,40,DPD30-59,1,1,0
2025-01-05,40,DPD60-89,0,0,0
2025-01-05,40,DPD90+,0,0,0
2025-01-05,42,Current,0,0,0
2025-01-05,42,DPD15-29,9,9,0
2025-01-05,42,DPD3-14,7,7,0
2025-01-05,42,DPD30-59,0,0,0
2025-01-05,42,DPD60-89,0,0,0
2025-01-05,42,DPD90+,0,0,0
2025-01-05,44,Current,0,0,0
2025-01-05,44,DPD15-29,20,20,0
2025-01-05,44,DPD3-14,14,14,0
2025-01-05,44,DPD30-59,3,3,0
2025-01-05,44,DPD60-89,0,0,0
2025-01-05,44,DPD90+,0,0,0
2025-01-05,46,Current,0,0,0
2025-01-05,46,DPD15-29,0,0,0
2025-01-05,46,DPD3-14,0,0,0
2025-01-05,48,Current,185,185,0
2025-01-05,48,DPD15-29,11,11,0
2025-01-05,48,DPD3-14,5,5,0
2025-01-05,48,DPD30-59,3,3,0
2025-01-05,48,DPD60-89,0,0,0
2025-01-05,48,DPD90+,0,0,0
2025-01-05,6,Current,0,0,0
2025-01-04,100,Current,0,0,0
2025-01-04,102,Current,0,0,0
2025-01-04,102,DPD90+,0,0,0
2025-01-04,104,Current,0,0,0
2025-01-04,20,Current,3,3,0
2025-01-04,20,DPD15-29,133,133,0
2025-01-04,20,DPD3-14,54,54,0
2025-01-04,20,DPD30-59,97,97,0
2025-01-04,20,DPD60-89,0,0,0
2025-01-04,20,DPD90+,0,0,0
2025-01-04,22,Current,0,0,0
2025-01-04,22,DPD30-59,0,0,0
2025-01-04,22,DPD60-89,0,0,0
2025-01-04,22,DPD90+,0,0,0
2025-01-04,24,Current,11,11,0
2025-01-04,24,DPD15-29,59,59,0
2025-01-04,24,DPD3-14,25,25,0
2025-01-04,24,DPD30-59,55,55,0
2025-01-04,24,DPD60-89,0,0,0
2025-01-04,24,DPD90+,0,0,0
2025-01-04,26,Current,0,0,0
2025-01-04,26,DPD15-29,8,8,0
2025-01-04,26,DPD3-14,2,2,0
2025-01-04,26,DPD30-59,4,4,0
2025-01-04,26,DPD60-89,0,0,0
2025-01-04,26,DPD90+,0,0,0
2025-01-04,32,Current,0,0,0
2025-01-04,32,DPD15-29,76,76,0
2025-01-04,32,DPD3-14,38,38,0
2025-01-04,32,DPD30-59,48,48,0
2025-01-04,32,DPD60-89,0,0,0
2025-01-04,32,DPD90+,0,0,0
2025-01-04,34,Current,0,0,0
2025-01-04,34,DPD15-29,23,23,0
2025-01-04,34,DPD3-14,16,16,0
2025-01-04,34,DPD30-59,19,19,0
2025-01-04,34,DPD60-89,0,0,0
2025-01-04,34,DPD90+,0,0,0
2025-01-04,36,Current,0,0,0
2025-01-04,36,DPD15-29,17,17,0
2025-01-04,36,DPD3-14,3,3,0
2025-01-04,36,DPD30-59,16,16,0
2025-01-04,36,DPD60-89,0,0,0
2025-01-04,36,DPD90+,0,0,0
2025-01-04,38,Current,1,1,0
2025-01-04,38,DPD15-29,16,16,0
2025-01-04,38,DPD3-14,5,5,0
2025-01-04,38,DPD30-59,14,14,0
2025-01-04,38,DPD60-89,0,0,0
2025-01-04,38,DPD90+,0,0,0
2025-01-04,40,Current,0,0,0
2025-01-04,40,DPD15-29,14,14,0
2025-01-04,40,DPD3-14,5,5,0
2025-01-04,40,DPD30-59,5,5,0
2025-01-04,40,DPD60-89,0,0,0
2025-01-04,40,DPD90+,0,0,0
2025-01-04,42,Current,0,0,0
2025-01-04,42,DPD15-29,2,2,0
2025-01-04,42,DPD3-14,2,2,0
2025-01-04,42,DPD30-59,8,8,0
2025-01-04,42,DPD60-89,0,0,0
2025-01-04,42,DPD90+,0,0,0
2025-01-04,44,Current,0,0,0
2025-01-04,44,DPD15-29,19,19,0
2025-01-04,44,DPD3-14,6,6,0
2025-01-04,44,DPD30-59,10,10,0
2025-01-04,44,DPD60-89,0,0,0
2025-01-04,44,DPD90+,0,0,0
2025-01-04,46,Current,0,0,0
2025-01-04,46,DPD15-29,1,1,0
2025-01-04,46,DPD3-14,0,0,0
2025-01-04,48,Current,4,4,0
2025-01-04,48,DPD15-29,17,17,0
2025-01-04,48,DPD3-14,5,5,0
2025-01-04,48,DPD30-59,11,11,0
2025-01-04,48,DPD60-89,0,0,0
2025-01-04,48,DPD90+,0,0,0
2025-01-04,6,Current,0,0,0
2025-01-03,100,Current,0,0,0
2025-01-03,102,Current,0,0,0
2025-01-03,102,DPD90+,0,0,0
2025-01-03,104,Current,0,0,0
2025-01-03,20,Current,5,5,0
2025-01-03,20,DPD15-29,94,94,0
2025-01-03,20,DPD3-14,96,96,0
2025-01-03,20,DPD30-59,29,29,0
2025-01-03,20,DPD60-89,0,0,0
2025-01-03,20,DPD90+,0,0,0
2025-01-03,22,Current,0,0,0
2025-01-03,22,DPD30-59,0,0,0
2025-01-03,22,DPD60-89,0,0,0
2025-01-03,22,DPD90+,0,0,0
2025-01-03,24,Current,4,4,0
2025-01-03,24,DPD15-29,69,69,0
2025-01-03,24,DPD3-14,41,41,0
2025-01-03,24,DPD30-59,13,13,0
2025-01-03,24,DPD60-89,0,0,0
2025-01-03,24,DPD90+,0,0,0
2025-01-03,26,Current,0,0,0
2025-01-03,26,DPD15-29,8,8,0
2025-01-03,26,DPD3-14,10,10,0
2025-01-03,26,DPD30-59,1,1,0
2025-01-03,26,DPD60-89,0,0,0
2025-01-03,26,DPD90+,0,0,0
2025-01-03,32,Current,0,0,0
2025-01-03,32,DPD15-29,71,71,0
2025-01-03,32,DPD3-14,54,54,0
2025-01-03,32,DPD30-59,12,12,0
2025-01-03,32,DPD60-89,0,0,0
2025-01-03,32,DPD90+,0,0,0
2025-01-03,34,Current,0,0,0
2025-01-03,34,DPD15-29,34,34,0
2025-01-03,34,DPD3-14,25,25,0
2025-01-03,34,DPD30-59,3,3,0
2025-01-03,34,DPD60-89,0,0,0
2025-01-03,34,DPD90+,0,0,0
2025-01-03,36,Current,0,0,0
2025-01-03,36,DPD15-29,12,12,0
2025-01-03,36,DPD3-14,13,13,0
2025-01-03,36,DPD30-59,1,1,0
2025-01-03,36,DPD60-89,0,0,0
2025-01-03,36,DPD90+,0,0,0
2025-01-03,38,Current,4,4,0
2025-01-03,38,DPD15-29,16,16,0
2025-01-03,38,DPD3-14,14,14,0
2025-01-03,38,DPD30-59,2,2,0
2025-01-03,38,DPD60-89,0,0,0
2025-01-03,38,DPD90+,0,0,0
2025-01-03,40,Current,0,0,0
2025-01-03,40,DPD15-29,7,7,0
2025-01-03,40,DPD3-14,6,6,0
2025-01-03,40,DPD30-59,2,2,0
2025-01-03,40,DPD60-89,0,0,0
2025-01-03,40,DPD90+,0,0,0
2025-01-03,42,Current,0,0,0
2025-01-03,42,DPD15-29,10,10,0
2025-01-03,42,DPD3-14,5,5,0
2025-01-03,42,DPD30-59,1,1,0
2025-01-03,42,DPD60-89,0,0,0
2025-01-03,42,DPD90+,0,0,0
2025-01-03,44,Current,0,0,0
2025-01-03,44,DPD15-29,19,19,0
2025-01-03,44,DPD3-14,13,13,0
2025-01-03,44,DPD30-59,4,4,0
2025-01-03,44,DPD60-89,0,0,0
2025-01-03,44,DPD90+,0,0,0
2025-01-03,46,Current,0,0,0
2025-01-03,46,DPD15-29,0,0,0
2025-01-03,46,DPD3-14,0,0,0
2025-01-03,48,Current,1,1,0
2025-01-03,48,DPD15-29,10,10,0
2025-01-03,48,DPD3-14,6,6,0
2025-01-03,48,DPD30-59,3,3,0
2025-01-03,48,DPD60-89,0,0,0
2025-01-03,48,DPD90+,0,0,0
2025-01-03,6,Current,0,0,0
2025-01-02,100,Current,0,0,0
2025-01-02,102,Current,0,0,0
2025-01-02,102,DPD15-29,0,0,0
2025-01-02,102,DPD90+,0,0,0
2025-01-02,104,Current,0,0,0
2025-01-02,20,Current,3,3,0
2025-01-02,20,DPD15-29,158,158,0
2025-01-02,20,DPD3-14,57,57,0
2025-01-02,20,DPD30-59,234,234,0
2025-01-02,20,DPD60-89,0,0,0
2025-01-02,20,DPD90+,0,0,0
2025-01-02,22,Current,0,0,0
2025-01-02,22,DPD30-59,1,1,0
2025-01-02,22,DPD90+,0,0,0
2025-01-02,24,Current,119,119,0
2025-01-02,24,DPD15-29,78,78,0
2025-01-02,24,DPD3-14,29,29,0
2025-01-02,24,DPD30-59,130,130,0
2025-01-02,24,DPD60-89,1,1,0
2025-01-02,24,DPD90+,0,0,0
2025-01-02,26,Current,0,0,0
2025-01-02,26,DPD15-29,9,9,0
2025-01-02,26,DPD3-14,3,3,0
2025-01-02,26,DPD30-59,12,12,0
2025-01-02,26,DPD60-89,0,0,0
2025-01-02,26,DPD90+,0,0,0
2025-01-02,32,Current,0,0,0
2025-01-02,32,DPD15-29,77,77,0
2025-01-02,32,DPD3-14,35,35,0
2025-01-02,32,DPD30-59,112,112,0
2025-01-02,32,DPD60-89,0,0,0
2025-01-02,32,DPD90+,0,0,0
2025-01-02,34,Current,0,0,0
2025-01-02,34,DPD15-29,26,26,0
2025-01-02,34,DPD3-14,17,17,0
2025-01-02,34,DPD30-59,36,36,0
2025-01-02,34,DPD60-89,0,0,0
2025-01-02,34,DPD90+,0,0,0
2025-01-02,36,Current,0,0,0
2025-01-02,36,DPD15-29,21,21,0
2025-01-02,36,DPD3-14,4,4,0
2025-01-02,36,DPD30-59,39,39,0
2025-01-02,36,DPD60-89,0,0,0
2025-01-02,36,DPD90+,0,0,0
2025-01-02,38,Current,20,20,0
2025-01-02,38,DPD15-29,22,22,0
2025-01-02,38,DPD3-14,6,6,0
2025-01-02,38,DPD30-59,32,32,0
2025-01-02,38,DPD60-89,0,0,0
2025-01-02,38,DPD90+,0,0,0
2025-01-02,40,Current,0,0,0
2025-01-02,40,DPD15-29,13,13,0
2025-01-02,40,DPD3-14,6,6,0
2025-01-02,40,DPD30-59,22,22,0
2025-01-02,40,DPD60-89,0,0,0
2025-01-02,40,DPD90+,0,0,0
2025-01-02,42,Current,0,0,0
2025-01-02,42,DPD15-29,3,3,0
2025-01-02,42,DPD3-14,2,2,0
2025-01-02,42,DPD30-59,12,12,0
2025-01-02,42,DPD60-89,0,0,0
2025-01-02,42,DPD90+,0,0,0
2025-01-02,44,Current,0,0,0
2025-01-02,44,DPD15-29,20,20,0
2025-01-02,44,DPD3-14,10,10,0
2025-01-02,44,DPD30-59,29,29,0
2025-01-02,44,DPD60-89,0,0,0
2025-01-02,44,DPD90+,0,0,0
2025-01-02,46,Current,0,0,0
2025-01-02,46,DPD15-29,1,1,0
2025-01-02,46,DPD3-14,0,0,0
2025-01-02,46,DPD30-59,0,0,0
2025-01-02,48,Current,44,44,0
2025-01-02,48,DPD15-29,20,20,0
2025-01-02,48,DPD3-14,5,5,0
2025-01-02,48,DPD30-59,24,24,0
2025-01-02,48,DPD60-89,0,0,0
2025-01-02,48,DPD90+,0,0,0
2025-01-02,6,DPD3-14,0,0,0
2025-01-01,100,Current,0,0,0
2025-01-01,102,Current,0,0,0
2025-01-01,102,DPD15-29,0,0,0
2025-01-01,102,DPD90+,0,0,0
2025-01-01,104,Current,0,0,0
2025-01-01,20,Current,3621,3621,0
2025-01-01,20,DPD15-29,189,189,0
2025-01-01,20,DPD3-14,177,177,0
2025-01-01,20,DPD30-59,94,94,0
2025-01-01,20,DPD60-89,53,53,0
2025-01-01,20,DPD90+,38,38,0
2025-01-01,22,Current,0,0,0
2025-01-01,22,DPD30-59,0,0,0
2025-01-01,22,DPD90+,0,0,0
2025-01-01,24,Current,4820,4820,0
2025-01-01,24,DPD15-29,133,133,0
2025-01-01,24,DPD3-14,147,147,0
2025-01-01,24,DPD30-59,41,41,0
2025-01-01,24,DPD60-89,29,29,0
2025-01-01,24,DPD90+,12,12,0
2025-01-01,26,Current,0,0,0
2025-01-01,26,DPD15-29,8,8,0
2025-01-01,26,DPD3-14,10,10,0
2025-01-01,26,DPD30-59,2,2,0
2025-01-01,26,DPD60-89,0,0,0
2025-01-01,26,DPD90+,0,0,0
2025-01-01,32,Current,180,180,0
2025-01-01,32,DPD15-29,84,84,0
2025-01-01,32,DPD3-14,67,67,0
2025-01-01,32,DPD30-59,14,14,0
2025-01-01,32,DPD60-89,4,4,0
2025-01-01,32,DPD90+,2,2,0
2025-01-01,34,Current,0,0,0
2025-01-01,34,DPD15-29,42,42,0
2025-01-01,34,DPD3-14,25,25,0
2025-01-01,34,DPD30-59,0,0,0
2025-01-01,34,DPD60-89,0,0,0
2025-01-01,34,DPD90+,0,0,0
2025-01-01,36,Current,194,194,0
2025-01-01,36,DPD15-29,13,13,0
2025-01-01,36,DPD3-14,17,17,0
2025-01-01,36,DPD30-59,3,3,0
2025-01-01,36,DPD60-89,3,3,0
2025-01-01,36,DPD90+,0,0,0
2025-01-01,38,Current,308,308,0
2025-01-01,38,DPD15-29,18,18,0
2025-01-01,38,DPD3-14,21,21,0
2025-01-01,38,DPD30-59,4,4,0
2025-01-01,38,DPD60-89,0,0,0
2025-01-01,38,DPD90+,0,0,0
2025-01-01,40,Current,217,217,0
2025-01-01,40,DPD15-29,9,9,0
2025-01-01,40,DPD3-14,10,10,0
2025-01-01,40,DPD30-59,3,3,0
2025-01-01,40,DPD60-89,0,0,0
2025-01-01,40,DPD90+,2,2,0
2025-01-01,42,Current,0,0,0
2025-01-01,42,DPD15-29,9,9,0
2025-01-01,42,DPD3-14,5,5,0
2025-01-01,42,DPD30-59,2,2,0
2025-01-01,42,DPD60-89,0,0,0
2025-01-01,42,DPD90+,0,0,0
2025-01-01,44,Current,146,146,0
2025-01-01,44,DPD15-29,24,24,0
2025-01-01,44,DPD3-14,14,14,0
2025-01-01,44,DPD30-59,3,3,0
2025-01-01,44,DPD60-89,0,0,0
2025-01-01,44,DPD90+,0,0,0
2025-01-01,46,Current,4,4,0
2025-01-01,46,DPD15-29,0,0,0
2025-01-01,46,DPD3-14,0,0,0
2025-01-01,46,DPD30-59,1,1,0
2025-01-01,48,Current,4471,4471,0
2025-01-01,48,DPD15-29,74,74,0
2025-01-01,48,DPD3-14,95,95,0
2025-01-01,48,DPD30-59,36,36,0
2025-01-01,48,DPD60-89,23,23,0
2025-01-01,48,DPD90+,19,19,0
2025-01-01,6,DPD3-14,0,0,0
2024-12-31,100,Current,0,0,0
2024-12-31,102,Current,0,0,0
2024-12-31,102,DPD15-29,0,0,0
2024-12-31,102,DPD90+,0,0,0
2024-12-31,104,Current,0,0,0
2024-12-31,20,Current,0,0,0
2024-12-31,20,DPD15-29,176,176,0
2024-12-31,20,DPD3-14,72,72,0
2024-12-31,20,DPD30-59,102,102,0
2024-12-31,20,DPD60-89,0,0,0
2024-12-31,20,DPD90+,0,0,0
2024-12-31,22,Current,0,0,0
2024-12-31,22,DPD30-59,0,0,0
2024-12-31,22,DPD90+,0,0,0
2024-12-31,24,Current,1,1,0
2024-12-31,24,DPD15-29,95,95,0
2024-12-31,24,DPD3-14,32,32,0
2024-12-31,24,DPD30-59,60,60,0
2024-12-31,24,DPD60-89,0,0,0
2024-12-31,24,DPD90+,0,0,0
2024-12-31,26,Current,0,0,0
2024-12-31,26,DPD15-29,12,12,0
2024-12-31,26,DPD3-14,2,2,0
2024-12-31,26,DPD30-59,4,4,0
2024-12-31,26,DPD60-89,0,0,0
2024-12-31,26,DPD90+,0,0,0
2024-12-31,32,Current,0,0,0
2024-12-31,32,DPD15-29,84,84,0
2024-12-31,32,DPD3-14,44,44,0
2024-12-31,32,DPD30-59,59,59,0
2024-12-31,32,DPD60-89,0,0,0
2024-12-31,32,DPD90+,0,0,0
2024-12-31,34,Current,0,0,0
2024-12-31,34,DPD15-29,30,30,0
2024-12-31,34,DPD3-14,17,17,0
2024-12-31,34,DPD30-59,20,20,0
2024-12-31,34,DPD60-89,0,0,0
2024-12-31,34,DPD90+,0,0,0
2024-12-31,36,Current,0,0,0
2024-12-31,36,DPD15-29,24,24,0
2024-12-31,36,DPD3-14,7,7,0
2024-12-31,36,DPD30-59,16,16,0
2024-12-31,36,DPD60-89,0,0,0
2024-12-31,36,DPD90+,0,0,0
2024-12-31,38,Current,0,0,0
2024-12-31,38,DPD15-29,28,28,0
2024-12-31,38,DPD3-14,7,7,0
2024-12-31,38,DPD30-59,14,14,0
2024-12-31,38,DPD60-89,0,0,0
2024-12-31,38,DPD90+,0,0,0
2024-12-31,40,Current,0,0,0
2024-12-31,40,DPD15-29,20,20,0
2024-12-31,40,DPD3-14,7,7,0
2024-12-31,40,DPD30-59,10,10,0
2024-12-31,40,DPD60-89,0,0,0
2024-12-31,40,DPD90+,0,0,0
2024-12-31,42,Current,0,0,0
2024-12-31,42,DPD15-29,6,6,0
2024-12-31,42,DPD3-14,3,3,0
2024-12-31,42,DPD30-59,10,10,0
2024-12-31,42,DPD60-89,0,0,0
2024-12-31,42,DPD90+,0,0,0
2024-12-31,44,Current,0,0,0
2024-12-31,44,DPD15-29,25,25,0
2024-12-31,44,DPD3-14,11,11,0
2024-12-31,44,DPD30-59,7,7,0
2024-12-31,44,DPD60-89,0,0,0
2024-12-31,44,DPD90+,0,0,0
2024-12-31,46,Current,0,0,0
2024-12-31,46,DPD15-29,1,1,0
2024-12-31,46,DPD3-14,0,0,0
2024-12-31,46,DPD30-59,0,0,0
2024-12-31,48,Current,1,1,0
2024-12-31,48,DPD15-29,20,20,0
2024-12-31,48,DPD3-14,6,6,0
2024-12-31,48,DPD30-59,10,10,0
2024-12-31,48,DPD60-89,0,0,0
2024-12-31,48,DPD90+,0,0,0
2024-12-31,6,DPD3-14,0,0,0
2024-12-30,100,Current,0,0,0
2024-12-30,102,Current,0,0,0
2024-12-30,102,DPD15-29,0,0,0
2024-12-30,102,DPD90+,0,0,0
2024-12-30,104,Current,0,0,0
2024-12-30,20,Current,0,0,0
2024-12-30,20,DPD15-29,115,115,0
2024-12-30,20,DPD3-14,75,75,0
2024-12-30,20,DPD30-59,154,154,0
2024-12-30,20,DPD60-89,0,0,0
2024-12-30,20,DPD90+,0,0,0
2024-12-30,22,Current,0,0,0
2024-12-30,22,DPD30-59,0,0,0
2024-12-30,22,DPD90+,0,0,0
2024-12-30,24,Current,6,6,0
2024-12-30,24,DPD15-29,78,78,0
2024-12-30,24,DPD3-14,32,32,0
2024-12-30,24,DPD30-59,90,90,0
2024-12-30,24,DPD60-89,0,0,0
2024-12-30,24,DPD90+,0,0,0
2024-12-30,26,Current,0,0,0
2024-12-30,26,DPD15-29,10,10,0
2024-12-30,26,DPD3-14,4,4,0
2024-12-30,26,DPD30-59,12,12,0
2024-12-30,26,DPD60-89,0,0,0
2024-12-30,26,DPD90+,0,0,0
2024-12-30,32,Current,0,0,0
2024-12-30,32,DPD15-29,64,64,0
2024-12-30,32,DPD3-14,66,66,0
2024-12-30,32,DPD30-59,83,83,0
2024-12-30,32,DPD60-89,3,3,0
2024-12-30,32,DPD90+,1,1,0
2024-12-30,34,Current,0,0,0
2024-12-30,34,DPD15-29,36,36,0
2024-12-30,34,DPD3-14,25,25,0
2024-12-30,34,DPD30-59,25,25,0
2024-12-30,34,DPD60-89,0,0,0
2024-12-30,34,DPD90+,2,2,0
2024-12-30,36,Current,0,0,0
2024-12-30,36,DPD15-29,8,8,0
2024-12-30,36,DPD3-14,10,10,0
2024-12-30,36,DPD30-59,16,16,0
2024-12-30,36,DPD60-89,0,0,0
2024-12-30,36,DPD90+,0,0,0
2024-12-30,38,Current,2,2,0
2024-12-30,38,DPD15-29,15,15,0
2024-12-30,38,DPD3-14,8,8,0
2024-12-30,38,DPD30-59,26,26,0
2024-12-30,38,DPD60-89,0,0,0
2024-12-30,38,DPD90+,0,0,0
2024-12-30,40,Current,0,0,0
2024-12-30,40,DPD15-29,10,10,0
2024-12-30,40,DPD3-14,4,4,0
2024-12-30,40,DPD30-59,10,10,0
2024-12-30,40,DPD60-89,0,0,0
2024-12-30,40,DPD90+,0,0,0
2024-12-30,42,Current,0,0,0
2024-12-30,42,DPD15-29,8,8,0
2024-12-30,42,DPD3-14,4,4,0
2024-12-30,42,DPD30-59,6,6,0
2024-12-30,42,DPD60-89,0,0,0
2024-12-30,42,DPD90+,0,0,0
2024-12-30,44,Current,0,0,0
2024-12-30,44,DPD15-29,16,16,0
2024-12-30,44,DPD3-14,15,15,0
2024-12-30,44,DPD30-59,17,17,0
2024-12-30,44,DPD60-89,0,0,0
2024-12-30,44,DPD90+,0,0,0
2024-12-30,46,Current,0,0,0
2024-12-30,46,DPD15-29,1,1,0
2024-12-30,46,DPD3-14,0,0,0
2024-12-30,48,Current,2,2,0
2024-12-30,48,DPD15-29,15,15,0
2024-12-30,48,DPD3-14,5,5,0
2024-12-30,48,DPD30-59,17,17,0
2024-12-30,48,DPD60-89,0,0,0
2024-12-30,48,DPD90+,0,0,0
2024-12-30,6,DPD3-14,0,0,0
2024-12-29,100,Current,0,0,0
2024-12-29,102,Current,0,0,0
2024-12-29,102,DPD15-29,0,0,0
2024-12-29,102,DPD90+,0,0,0
2024-12-29,104,Current,0,0,0
2024-12-29,198,Current,0,0,0
2024-12-29,198,DPD90+,0,0,0
2024-12-29,20,Current,0,0,0
2024-12-29,20,DPD15-29,121,121,0
2024-12-29,20,DPD3-14,102,102,0
2024-12-29,20,DPD30-59,88,88,0
2024-12-29,20,DPD60-89,0,0,0
2024-12-29,20,DPD90+,0,0,0
2024-12-29,22,Current,0,0,0
2024-12-29,22,DPD30-59,1,1,0
2024-12-29,22,DPD90+,0,0,0
2024-12-29,24,Current,4,4,0
2024-12-29,24,DPD15-29,66,66,0
2024-12-29,24,DPD3-14,52,52,0
2024-12-29,24,DPD30-59,46,46,0
2024-12-29,24,DPD60-89,0,0,0
2024-12-29,24,DPD90+,0,0,0
2024-12-29,26,Current,0,0,0
2024-12-29,26,DPD15-29,8,8,0
2024-12-29,26,DPD3-14,7,7,0
2024-12-29,26,DPD30-59,3,3,0
2024-12-29,26,DPD60-89,0,0,0
2024-12-29,26,DPD90+,0,0,0
2024-12-29,28,DPD90+,0,0,0
2024-12-29,30,DPD90+,0,0,0
2024-12-29,32,Current,0,0,0
2024-12-29,32,DPD15-29,54,54,0
2024-12-29,32,DPD3-14,66,66,0
2024-12-29,32,DPD30-59,37,37,0
2024-12-29,32,DPD60-89,0,0,0
2024-12-29,32,DPD90+,0,0,0
2024-12-29,34,Current,0,0,0
2024-12-29,34,DPD15-29,22,22,0
2024-12-29,34,DPD3-14,25,25,0
2024-12-29,34,DPD30-59,19,19,0
2024-12-29,34,DPD60-89,0,0,0
2024-12-29,34,DPD90+,0,0,0
2024-12-29,36,Current,0,0,0
2024-12-29,36,DPD15-29,17,17,0
2024-12-29,36,DPD3-14,12,12,0
2024-12-29,36,DPD30-59,17,17,0
2024-12-29,36,DPD60-89,0,0,0
2024-12-29,36,DPD90+,0,0,0
2024-12-29,38,Current,0,0,0
2024-12-29,38,DPD15-29,15,15,0
2024-12-29,38,DPD3-14,19,19,0
2024-12-29,38,DPD30-59,7,7,0
2024-12-29,38,DPD60-89,0,0,0
2024-12-29,38,DPD90+,0,0,0
2024-12-29,4,DPD90+,0,0,0
2024-12-29,40,Current,0,0,0
2024-12-29,40,DPD15-29,10,10,0
2024-12-29,40,DPD3-14,15,15,0
2024-12-29,40,DPD30-59,7,7,0
2024-12-29,40,DPD60-89,0,0,0
2024-12-29,40,DPD90+,0,0,0
2024-12-29,42,Current,0,0,0
2024-12-29,42,DPD15-29,5,5,0
2024-12-29,42,DPD3-14,3,3,0
2024-12-29,42,DPD30-59,4,4,0
2024-12-29,42,DPD60-89,0,0,0
2024-12-29,42,DPD90+,0,0,0
2024-12-29,44,Current,0,0,0
2024-12-29,44,DPD15-29,13,13,0
2024-12-29,44,DPD3-14,18,18,0
2024-12-29,44,DPD30-59,13,13,0
2024-12-29,44,DPD60-89,0,0,0
2024-12-29,44,DPD90+,0,0,0
2024-12-29,46,Current,0,0,0
2024-12-29,46,DPD15-29,1,1,0
2024-12-29,46,DPD3-14,0,0,0
2024-12-29,46,DPD90+,0,0,0
2024-12-29,48,Current,3,3,0
2024-12-29,48,DPD15-29,13,13,0
2024-12-29,48,DPD3-14,12,12,0
2024-12-29,48,DPD30-59,8,8,0
2024-12-29,48,DPD60-89,0,0,0
2024-12-29,48,DPD90+,0,0,0
2024-12-29,6,Current,0,0,0
2024-12-29,6,DPD90+,0,0,0
2024-12-28,100,Current,0,0,0
2024-12-28,102,Current,0,0,0
2024-12-28,102,DPD15-29,0,0,0
2024-12-28,102,DPD90+,0,0,0
2024-12-28,104,Current,0,0,0
2024-12-28,198,Current,0,0,0
2024-12-28,198,DPD60-89,0,0,0
2024-12-28,198,DPD90+,0,0,0
2024-12-28,20,Current,0,0,0
2024-12-28,20,DPD15-29,120,120,0
2024-12-28,20,DPD3-14,75,75,0
2024-12-28,20,DPD30-59,56,56,0
2024-12-28,20,DPD60-89,0,0,0
2024-12-28,20,DPD90+,0,0,0
2024-12-28,22,Current,0,0,0
2024-12-28,22,DPD30-59,0,0,0
2024-12-28,22,DPD90+,0,0,0
2024-12-28,24,Current,14,14,0
2024-12-28,24,DPD15-29,83,83,0
2024-12-28,24,DPD3-14,39,39,0
2024-12-28,24,DPD30-59,27,27,0
2024-12-28,24,DPD60-89,0,0,0
2024-12-28,24,DPD90+,0,0,0
2024-12-28,26,Current,0,0,0
2024-12-28,26,DPD15-29,12,12,0
2024-12-28,26,DPD3-14,5,5,0
2024-12-28,26,DPD30-59,2,2,0
2024-12-28,26,DPD60-89,0,0,0
2024-12-28,26,DPD90+,0,0,0
2024-12-28,28,DPD90+,0,0,0
2024-12-28,30,DPD90+,0,0,0
2024-12-28,32,Current,0,0,0
2024-12-28,32,DPD15-29,63,63,0
2024-12-28,32,DPD3-14,59,59,0
2024-12-28,32,DPD30-59,31,31,0
2024-12-28,32,DPD60-89,0,0,0
2024-12-28,32,DPD90+,0,0,0
2024-12-28,34,Current,0,0,0
2024-12-28,34,DPD15-29,35,35,0
2024-12-28,34,DPD3-14,28,28,0
2024-12-28,34,DPD30-59,14,14,0
2024-12-28,34,DPD60-89,0,0,0
2024-12-28,34,DPD90+,0,0,0
2024-12-28,36,Current,0,0,0
2024-12-28,36,DPD15-29,12,12,0
2024-12-28,36,DPD3-14,9,9,0
2024-12-28,36,DPD30-59,11,11,0
2024-12-28,36,DPD60-89,0,0,0
2024-12-28,36,DPD90+,0,0,0
2024-12-28,38,Current,1,1,0
2024-12-28,38,DPD15-29,18,18,0
2024-12-28,38,DPD3-14,8,8,0
2024-12-28,38,DPD30-59,9,9,0
2024-12-28,38,DPD60-89,0,0,0
2024-12-28,38,DPD90+,0,0,0
2024-12-28,4,DPD90+,0,0,0
2024-12-28,40,Current,0,0,0
2024-12-28,40,DPD15-29,10,10,0
2024-12-28,40,DPD3-14,5,5,0
2024-12-28,40,DPD30-59,5,5,0
2024-12-28,40,DPD60-89,0,0,0
2024-12-28,40,DPD90+,0,0,0
2024-12-28,42,Current,0,0,0
2024-12-28,42,DPD15-29,8,8,0
2024-12-28,42,DPD3-14,4,4,0
2024-12-28,42,DPD30-59,7,7,0
2024-12-28,42,DPD60-89,0,0,0
2024-12-28,42,DPD90+,0,0,0
2024-12-28,44,Current,0,0,0
2024-12-28,44,DPD15-29,18,18,0
2024-12-28,44,DPD3-14,17,17,0
2024-12-28,44,DPD30-59,7,7,0
2024-12-28,44,DPD60-89,0,0,0
2024-12-28,44,DPD90+,0,0,0
2024-12-28,46,Current,0,0,0
2024-12-28,46,DPD15-29,1,1,0
2024-12-28,46,DPD3-14,0,0,0
2024-12-28,46,DPD90+,0,0,0
2024-12-28,48,Current,8,8,0
2024-12-28,48,DPD15-29,14,14,0
2024-12-28,48,DPD3-14,6,6,0
2024-12-28,48,DPD30-59,6,6,0
2024-12-28,48,DPD60-89,0,0,0
2024-12-28,48,DPD90+,0,0,0
2024-12-28,6,Current,0,0,0
2024-12-28,6,DPD90+,0,0,0
2024-12-27,100,Current,0,0,0
2024-12-27,102,Current,0,0,0
2024-12-27,102,DPD15-29,0,0,0
2024-12-27,102,DPD90+,0,0,0
2024-12-27,104,Current,0,0,0
2024-12-27,198,Current,0,0,0
2024-12-27,198,DPD60-89,0,0,0
2024-12-27,198,DPD90+,0,0,0
2024-12-27,20,Current,1,1,0
2024-12-27,20,DPD15-29,161,161,0
2024-12-27,20,DPD3-14,114,114,0
2024-12-27,20,DPD30-59,52,52,0
2024-12-27,20,DPD60-89,0,0,0
2024-12-27,20,DPD90+,0,0,0
2024-12-27,22,Current,0,0,0
2024-12-27,22,DPD30-59,0,0,0
2024-12-27,22,DPD90+,0,0,0
2024-12-27,24,Current,6,6,0
2024-12-27,24,DPD15-29,84,84,0
2024-12-27,24,DPD3-14,69,69,0
2024-12-27,24,DPD30-59,31,31,0
2024-12-27,24,DPD60-89,0,0,0
2024-12-27,24,DPD90+,0,0,0
2024-12-27,26,Current,0,0,0
2024-12-27,26,DPD15-29,10,10,0
2024-12-27,26,DPD3-14,9,9,0
2024-12-27,26,DPD30-59,1,1,0
2024-12-27,26,DPD60-89,0,0,0
2024-12-27,26,DPD90+,0,0,0
2024-12-27,28,DPD90+,0,0,0
2024-12-27,30,DPD90+,0,0,0
2024-12-27,32,Current,0,0,0
2024-12-27,32,DPD15-29,75,75,0
2024-12-27,32,DPD3-14,71,71,0
2024-12-27,32,DPD30-59,26,26,0
2024-12-27,32,DPD60-89,0,0,0
2024-12-27,32,DPD90+,0,0,0
2024-12-27,34,Current,0,0,0
2024-12-27,34,DPD15-29,34,34,0
2024-12-27,34,DPD3-14,23,23,0
2024-12-27,34,DPD30-59,6,6,0
2024-12-27,34,DPD60-89,0,0,0
2024-12-27,34,DPD90+,0,0,0
2024-12-27,36,Current,0,0,0
2024-12-27,36,DPD15-29,22,22,0
2024-12-27,36,DPD3-14,14,14,0
2024-12-27,36,DPD30-59,4,4,0
2024-12-27,36,DPD60-89,0,0,0
2024-12-27,36,DPD90+,0,0,0
2024-12-27,38,Current,0,0,0
2024-12-27,38,DPD15-29,20,20,0
2024-12-27,38,DPD3-14,19,19,0
2024-12-27,38,DPD30-59,7,7,0
2024-12-27,38,DPD60-89,0,0,0
2024-12-27,38,DPD90+,0,0,0
2024-12-27,4,DPD90+,0,0,0
2024-12-27,40,Current,0,0,0
2024-12-27,40,DPD15-29,12,12,0
2024-12-27,40,DPD3-14,19,19,0
2024-12-27,40,DPD30-59,5,5,0
2024-12-27,40,DPD60-89,0,0,0
2024-12-27,40,DPD90+,0,0,0
2024-12-27,42,Current,0,0,0
2024-12-27,42,DPD15-29,5,5,0
2024-12-27,42,DPD3-14,4,4,0
2024-12-27,42,DPD30-59,4,4,0
2024-12-27,42,DPD60-89,0,0,0
2024-12-27,42,DPD90+,0,0,0
2024-12-27,44,Current,0,0,0
2024-12-27,44,DPD15-29,20,20,0
2024-12-27,44,DPD3-14,17,17,0
2024-12-27,44,DPD30-59,0,0,0
2024-12-27,44,DPD60-89,0,0,0
2024-12-27,44,DPD90+,0,0,0
2024-12-27,46,Current,0,0,0
2024-12-27,46,DPD15-29,1,1,0
2024-12-27,46,DPD3-14,0,0,0
2024-12-27,46,DPD90+,0,0,0
2024-12-27,48,Current,1,1,0
2024-12-27,48,DPD15-29,13,13,0
2024-12-27,48,DPD3-14,15,15,0
2024-12-27,48,DPD30-59,3,3,0
2024-12-27,48,DPD60-89,0,0,0
2024-12-27,48,DPD90+,0,0,0
2024-12-27,6,Current,0,0,0
2024-12-27,6,DPD90+,0,0,0
2024-12-26,100,Current,0,0,0
2024-12-26,100,DPD15-29,0,0,0
2024-12-26,102,Current,0,0,0
2024-12-26,102,DPD15-29,0,0,0
2024-12-26,102,DPD90+,0,0,0
2024-12-26,104,Current,0,0,0
2024-12-26,198,Current,0,0,0
2024-12-26,198,DPD60-89,0,0,0
2024-12-26,198,DPD90+,0,0,0
2024-12-26,20,Current,0,0,0
2024-12-26,20,DPD15-29,157,157,0
2024-12-26,20,DPD3-14,91,91,0
2024-12-26,20,DPD30-59,163,163,0
2024-12-26,20,DPD60-89,0,0,0
2024-12-26,20,DPD90+,0,0,0
2024-12-26,22,Current,0,0,0
2024-12-26,22,DPD30-59,0,0,0
2024-12-26,22,DPD60-89,0,0,0
2024-12-26,22,DPD90+,0,0,0
2024-12-26,24,Current,154,154,0
2024-12-26,24,DPD15-29,92,92,0
2024-12-26,24,DPD3-14,46,46,0
2024-12-26,24,DPD30-59,98,98,0
2024-12-26,24,DPD60-89,1,1,0
2024-12-26,24,DPD90+,0,0,0
2024-12-26,26,Current,0,0,0
2024-12-26,26,DPD15-29,12,12,0
2024-12-26,26,DPD3-14,7,7,0
2024-12-26,26,DPD30-59,13,13,0
2024-12-26,26,DPD60-89,0,0,0
2024-12-26,26,DPD90+,0,0,0
2024-12-26,28,DPD90+,1,1,0
2024-12-26,30,DPD90+,0,0,0
2024-12-26,32,Current,0,0,0
2024-12-26,32,DPD15-29,83,83,0
2024-12-26,32,DPD3-14,59,59,0
2024-12-26,32,DPD30-59,84,84,0
2024-12-26,32,DPD60-89,0,0,0
2024-12-26,32,DPD90+,0,0,0
2024-12-26,34,Current,0,0,0
2024-12-26,34,DPD15-29,36,36,0
2024-12-26,34,DPD3-14,28,28,0
2024-12-26,34,DPD30-59,19,19,0
2024-12-26,34,DPD60-89,0,0,0
2024-12-26,34,DPD90+,0,0,0
2024-12-26,36,Current,0,0,0
2024-12-26,36,DPD15-29,16,16,0
2024-12-26,36,DPD3-14,10,10,0
2024-12-26,36,DPD30-59,13,13,0
2024-12-26,36,DPD60-89,0,0,0
2024-12-26,36,DPD90+,0,0,0
2024-12-26,38,Current,25,25,0
2024-12-26,38,DPD15-29,19,19,0
2024-12-26,38,DPD3-14,11,11,0
2024-12-26,38,DPD30-59,22,22,0
2024-12-26,38,DPD60-89,0,0,0
2024-12-26,38,DPD90+,0,0,0
2024-12-26,4,DPD90+,0,0,0
2024-12-26,40,Current,0,0,0
2024-12-26,40,DPD15-29,9,9,0
2024-12-26,40,DPD3-14,8,8,0
2024-12-26,40,DPD30-59,18,18,0
2024-12-26,40,DPD60-89,0,0,0
2024-12-26,40,DPD90+,0,0,0
2024-12-26,42,Current,0,0,0
2024-12-26,42,DPD15-29,7,7,0
2024-12-26,42,DPD3-14,5,5,0
2024-12-26,42,DPD30-59,8,8,0
2024-12-26,42,DPD60-89,0,0,0
2024-12-26,42,DPD90+,0,0,0
2024-12-26,44,Current,0,0,0
2024-12-26,44,DPD15-29,22,22,0
2024-12-26,44,DPD3-14,16,16,0
2024-12-26,44,DPD30-59,13,13,0
2024-12-26,44,DPD60-89,0,0,0
2024-12-26,44,DPD90+,0,0,0
2024-12-26,46,Current,0,0,0
2024-12-26,46,DPD15-29,1,1,0
2024-12-26,46,DPD3-14,0,0,0
2024-12-26,46,DPD90+,0,0,0
2024-12-26,48,Current,59,59,0
2024-12-26,48,DPD15-29,10,10,0
2024-12-26,48,DPD3-14,14,14,0
2024-12-26,48,DPD30-59,19,19,0
2024-12-26,48,DPD60-89,0,0,0
2024-12-26,48,DPD90+,0,0,0
2024-12-26,6,Current,0,0,0
2024-12-26,6,DPD90+,0,0,0
2024-12-25,100,Current,0,0,0
2024-12-25,100,DPD15-29,0,0,0
2024-12-25,102,Current,0,0,0
2024-12-25,102,DPD15-29,0,0,0
2024-12-25,102,DPD90+,0,0,0
2024-12-25,104,Current,0,0,0
2024-12-25,198,DPD60-89,0,0,0
2024-12-25,198,DPD90+,0,0,0
2024-12-25,20,Current,0,0,0
2024-12-25,20,DPD15-29,162,162,0
2024-12-25,20,DPD3-14,133,133,0
2024-12-25,20,DPD30-59,81,81,0
2024-12-25,20,DPD60-89,0,0,0
2024-12-25,20,DPD90+,1,1,0
2024-12-25,22,Current,0,0,0
2024-12-25,22,DPD30-59,1,1,0
2024-12-25,22,DPD60-89,0,0,0
2024-12-25,22,DPD90+,0,0,0
2024-12-25,24,Current,11,11,0
2024-12-25,24,DPD15-29,88,88,0
2024-12-25,24,DPD3-14,74,74,0
2024-12-25,24,DPD30-59,46,46,0
2024-12-25,24,DPD60-89,0,0,0
2024-12-25,24,DPD90+,0,0,0
2024-12-25,26,Current,0,0,0
2024-12-25,26,DPD15-29,11,11,0
2024-12-25,26,DPD3-14,9,9,0
2024-12-25,26,DPD30-59,2,2,0
2024-12-25,26,DPD60-89,0,0,0
2024-12-25,26,DPD90+,0,0,0
2024-12-25,28,DPD90+,0,0,0
2024-12-25,30,DPD90+,0,0,0
2024-12-25,32,Current,0,0,0
2024-12-25,32,DPD15-29,82,82,0
2024-12-25,32,DPD3-14,74,74,0
2024-12-25,32,DPD30-59,38,38,0
2024-12-25,32,DPD60-89,0,0,0
2024-12-25,32,DPD90+,0,0,0
2024-12-25,34,Current,0,0,0
2024-12-25,34,DPD15-29,37,37,0
2024-12-25,34,DPD3-14,24,24,0
2024-12-25,34,DPD30-59,16,16,0
2024-12-25,34,DPD60-89,0,0,0
2024-12-25,34,DPD90+,0,0,0
2024-12-25,36,Current,0,0,0
2024-12-25,36,DPD15-29,22,22,0
2024-12-25,36,DPD3-14,16,16,0
2024-12-25,36,DPD30-59,14,14,0
2024-12-25,36,DPD60-89,0,0,0
2024-12-25,36,DPD90+,0,0,0
2024-12-25,38,Current,3,3,0
2024-12-25,38,DPD15-29,20,20,0
2024-12-25,38,DPD3-14,23,23,0
2024-12-25,38,DPD30-59,6,6,0
2024-12-25,38,DPD60-89,0,0,0
2024-12-25,38,DPD90+,0,0,0
2024-12-25,4,DPD90+,0,0,0
2024-12-25,40,Current,0,0,0
2024-12-25,40,DPD15-29,13,13,0
2024-12-25,40,DPD3-14,16,16,0
2024-12-25,40,DPD30-59,5,5,0
2024-12-25,40,DPD60-89,0,0,0
2024-12-25,40,DPD90+,0,0,0
2024-12-25,42,Current,0,0,0
2024-12-25,42,DPD15-29,9,9,0
2024-12-25,42,DPD3-14,4,4,0
2024-12-25,42,DPD30-59,4,4,0
2024-12-25,42,DPD60-89,0,0,0
2024-12-25,42,DPD90+,0,0,0
2024-12-25,44,Current,0,0,0
2024-12-25,44,DPD15-29,17,17,0
2024-12-25,44,DPD3-14,17,17,0
2024-12-25,44,DPD30-59,13,13,0
2024-12-25,44,DPD60-89,0,0,0
2024-12-25,44,DPD90+,0,0,0
2024-12-25,46,Current,0,0,0
2024-12-25,46,DPD15-29,1,1,0
2024-12-25,46,DPD3-14,0,0,0
2024-12-25,46,DPD90+,0,0,0
2024-12-25,48,Current,4,4,0
2024-12-25,48,DPD15-29,13,13,0
2024-12-25,48,DPD3-14,18,18,0
2024-12-25,48,DPD30-59,9,9,0
2024-12-25,48,DPD60-89,0,0,0
2024-12-25,48,DPD90+,0,0,0
2024-12-25,6,Current,0,0,0
2024-12-25,6,DPD90+,0,0,0
2024-12-24,100,Current,0,0,0
2024-12-24,100,DPD15-29,0,0,0
2024-12-24,102,Current,0,0,0
2024-12-24,102,DPD15-29,0,0,0
2024-12-24,102,DPD90+,0,0,0
2024-12-24,104,Current,0,0,0
2024-12-24,20,Current,0,0,0
2024-12-24,20,DPD15-29,144,144,0
2024-12-24,20,DPD3-14,114,114,0
2024-12-24,20,DPD30-59,49,49,0
2024-12-24,20,DPD60-89,0,0,0
2024-12-24,20,DPD90+,0,0,0
2024-12-24,22,Current,0,0,0
2024-12-24,22,DPD30-59,0,0,0
2024-12-24,22,DPD60-89,0,0,0
2024-12-24,22,DPD90+,0,0,0
2024-12-24,24,Current,6,6,0
2024-12-24,24,DPD15-29,74,74,0
2024-12-24,24,DPD3-14,63,63,0
2024-12-24,24,DPD30-59,29,29,0
2024-12-24,24,DPD60-89,0,0,0
2024-12-24,24,DPD90+,0,0,0
2024-12-24,26,Current,0,0,0
2024-12-24,26,DPD15-29,12,12,0
2024-12-24,26,DPD3-14,9,9,0
2024-12-24,26,DPD30-59,2,2,0
2024-12-24,26,DPD60-89,0,0,0
2024-12-24,26,DPD90+,0,0,0
2024-12-24,28,DPD90+,0,0,0
2024-12-24,30,DPD90+,0,0,0
2024-12-24,32,Current,0,0,0
2024-12-24,32,DPD15-29,81,81,0
2024-12-24,32,DPD3-14,71,71,0
2024-12-24,32,DPD30-59,26,26,0
2024-12-24,32,DPD60-89,0,0,0
2024-12-24,32,DPD90+,0,0,0
2024-12-24,34,Current,0,0,0
2024-12-24,34,DPD15-29,39,39,0
2024-12-24,34,DPD3-14,28,28,0
2024-12-24,34,DPD30-59,13,13,0
2024-12-24,34,DPD60-89,0,0,0
2024-12-24,34,DPD90+,0,0,0
2024-12-24,36,Current,0,0,0
2024-12-24,36,DPD15-29,18,18,0
2024-12-24,36,DPD3-14,9,9,0
2024-12-24,36,DPD30-59,12,12,0
2024-12-24,36,DPD60-89,0,0,0
2024-12-24,36,DPD90+,0,0,0
2024-12-24,38,Current,0,0,0
2024-12-24,38,DPD15-29,22,22,0
2024-12-24,38,DPD3-14,12,12,0
2024-12-24,38,DPD30-59,7,7,0
2024-12-24,38,DPD60-89,0,0,0
2024-12-24,38,DPD90+,0,0,0
2024-12-24,4,DPD90+,0,0,0
2024-12-24,40,Current,0,0,0
2024-12-24,40,DPD15-29,9,9,0
2024-12-24,40,DPD3-14,10,10,0
2024-12-24,40,DPD30-59,5,5,0
2024-12-24,40,DPD60-89,0,0,0
2024-12-24,40,DPD90+,0,0,0
2024-12-24,42,Current,0,0,0
2024-12-24,42,DPD15-29,5,5,0
2024-12-24,42,DPD3-14,8,8,0
2024-12-24,42,DPD30-59,4,4,0
2024-12-24,42,DPD60-89,0,0,0
2024-12-24,42,DPD90+,0,0,0
2024-12-24,44,Current,0,0,0
2024-12-24,44,DPD15-29,21,21,0
2024-12-24,44,DPD3-14,21,21,0
2024-12-24,44,DPD30-59,7,7,0
2024-12-24,44,DPD60-89,0,0,0
2024-12-24,44,DPD90+,0,0,0
2024-12-24,46,Current,0,0,0
2024-12-24,46,DPD15-29,1,1,0
2024-12-24,46,DPD90+,0,0,0
2024-12-24,48,Current,6,6,0
2024-12-24,48,DPD15-29,12,12,0
2024-12-24,48,DPD3-14,14,14,0
2024-12-24,48,DPD30-59,5,5,0
2024-12-24,48,DPD60-89,0,0,0
2024-12-24,48,DPD90+,0,0,0
2024-12-24,6,Current,0,0,0
2024-12-24,6,DPD90+,0,0,0
2024-12-23,100,Current,0,0,0
2024-12-23,100,DPD15-29,0,0,0
2024-12-23,102,Current,0,0,0
2024-12-23,102,DPD15-29,0,0,0
2024-12-23,102,DPD90+,0,0,0
2024-12-23,104,Current,0,0,0
2024-12-23,20,Current,0,0,0
2024-12-23,20,DPD15-29,152,152,0
2024-12-23,20,DPD3-14,152,152,0
2024-12-23,20,DPD30-59,74,74,0
2024-12-23,20,DPD60-89,0,0,0
2024-12-23,20,DPD90+,0,0,0
2024-12-23,22,Current,0,0,0
2024-12-23,22,DPD30-59,1,1,0
2024-12-23,22,DPD60-89,0,0,0
2024-12-23,24,Current,15,15,0
2024-12-23,24,DPD15-29,83,83,0
2024-12-23,24,DPD3-14,90,90,0
2024-12-23,24,DPD30-59,39,39,0
2024-12-23,24,DPD60-89,0,0,0
2024-12-23,24,DPD90+,0,0,0
2024-12-23,26,Current,0,0,0
2024-12-23,26,DPD15-29,13,13,0
2024-12-23,26,DPD3-14,10,10,0
2024-12-23,26,DPD30-59,2,2,0
2024-12-23,26,DPD60-89,0,0,0
2024-12-23,26,DPD90+,0,0,0
2024-12-23,32,Current,0,0,0
2024-12-23,32,DPD15-29,78,78,0
2024-12-23,32,DPD3-14,82,82,0
2024-12-23,32,DPD30-59,46,46,0
2024-12-23,32,DPD60-89,0,0,0
2024-12-23,32,DPD90+,0,0,0
2024-12-23,34,Current,0,0,0
2024-12-23,34,DPD15-29,31,31,0
2024-12-23,34,DPD3-14,30,30,0
2024-12-23,34,DPD30-59,13,13,0
2024-12-23,34,DPD60-89,0,0,0
2024-12-23,34,DPD90+,0,0,0
2024-12-23,36,Current,0,0,0
2024-12-23,36,DPD15-29,17,17,0
2024-12-23,36,DPD3-14,21,21,0
2024-12-23,36,DPD30-59,9,9,0
2024-12-23,36,DPD60-89,0,0,0
2024-12-23,36,DPD90+,0,0,0
2024-12-23,38,Current,2,2,0
2024-12-23,38,DPD15-29,19,19,0
2024-12-23,38,DPD3-14,29,29,0
2024-12-23,38,DPD30-59,8,8,0
2024-12-23,38,DPD60-89,0,0,0
2024-12-23,38,DPD90+,0,0,0
2024-12-23,40,Current,0,0,0
2024-12-23,40,DPD15-29,12,12,0
2024-12-23,40,DPD3-14,18,18,0
2024-12-23,40,DPD30-59,9,9,0
2024-12-23,40,DPD60-89,0,0,0
2024-12-23,40,DPD90+,0,0,0
2024-12-23,42,Current,0,0,0
2024-12-23,42,DPD15-29,8,8,0
2024-12-23,42,DPD3-14,7,7,0
2024-12-23,42,DPD30-59,3,3,0
2024-12-23,42,DPD60-89,0,0,0
2024-12-23,42,DPD90+,0,0,0
2024-12-23,44,Current,0,0,0
2024-12-23,44,DPD15-29,17,17,0
2024-12-23,44,DPD3-14,20,20,0
2024-12-23,44,DPD30-59,3,3,0
2024-12-23,44,DPD60-89,0,0,0
2024-12-23,44,DPD90+,0,0,0
2024-12-23,46,Current,0,0,0
2024-12-23,46,DPD15-29,1,1,0
2024-12-23,48,Current,4,4,0
2024-12-23,48,DPD15-29,13,13,0
2024-12-23,48,DPD3-14,19,19,0
2024-12-23,48,DPD30-59,4,4,0
2024-12-23,48,DPD60-89,0,0,0
2024-12-23,48,DPD90+,0,0,0
2024-12-23,6,Current,0,0,0
2024-12-22,100,Current,0,0,0
2024-12-22,100,DPD15-29,0,0,0
2024-12-22,102,Current,0,0,0
2024-12-22,102,DPD15-29,0,0,0
2024-12-22,102,DPD90+,0,0,0
2024-12-22,104,Current,0,0,0
2024-12-22,20,Current,0,0,0
2024-12-22,20,DPD15-29,136,136,0
2024-12-22,20,DPD3-14,104,104,0
2024-12-22,20,DPD30-59,155,155,0
2024-12-22,20,DPD60-89,0,0,0
2024-12-22,20,DPD90+,0,0,0
2024-12-22,22,Current,0,0,0
2024-12-22,22,DPD30-59,0,0,0
2024-12-22,22,DPD60-89,0,0,0
2024-12-22,22,DPD90+,0,0,0
2024-12-22,24,Current,20,20,0
2024-12-22,24,DPD15-29,68,68,0
2024-12-22,24,DPD3-14,70,70,0
2024-12-22,24,DPD30-59,88,88,0
2024-12-22,24,DPD60-89,0,0,0
2024-12-22,24,DPD90+,0,0,0
2024-12-22,26,Current,0,0,0
2024-12-22,26,DPD15-29,13,13,0
2024-12-22,26,DPD3-14,9,9,0
2024-12-22,26,DPD30-59,13,13,0
2024-12-22,26,DPD60-89,0,0,0
2024-12-22,26,DPD90+,0,0,0
2024-12-22,32,Current,0,0,0
2024-12-22,32,DPD15-29,72,72,0
2024-12-22,32,DPD3-14,81,81,0
2024-12-22,32,DPD30-59,79,79,0
2024-12-22,32,DPD60-89,0,0,0
2024-12-22,32,DPD90+,0,0,0
2024-12-22,34,Current,0,0,0
2024-12-22,34,DPD15-29,36,36,0
2024-12-22,34,DPD3-14,32,32,0
2024-12-22,34,DPD30-59,15,15,0
2024-12-22,34,DPD60-89,0,0,0
2024-12-22,34,DPD90+,0,0,0
2024-12-22,36,Current,0,0,0
2024-12-22,36,DPD15-29,15,15,0
2024-12-22,36,DPD3-14,7,7,0
2024-12-22,36,DPD30-59,17,17,0
2024-12-22,36,DPD60-89,0,0,0
2024-12-22,36,DPD90+,0,0,0
2024-12-22,38,Current,4,4,0
2024-12-22,38,DPD15-29,20,20,0
2024-12-22,38,DPD3-14,16,16,0
2024-12-22,38,DPD30-59,17,17,0
2024-12-22,38,DPD60-89,0,0,0
2024-12-22,38,DPD90+,0,0,0
2024-12-22,40,Current,0,0,0
2024-12-22,40,DPD15-29,6,6,0
2024-12-22,40,DPD3-14,12,12,0
2024-12-22,40,DPD30-59,18,18,0
2024-12-22,40,DPD60-89,0,0,0
2024-12-22,40,DPD90+,0,0,0
2024-12-22,42,Current,0,0,0
2024-12-22,42,DPD15-29,3,3,0
2024-12-22,42,DPD3-14,8,8,0
2024-12-22,42,DPD30-59,8,8,0
2024-12-22,42,DPD60-89,0,0,0
2024-12-22,42,DPD90+,0,0,0
2024-12-22,44,Current,0,0,0
2024-12-22,44,DPD15-29,20,20,0
2024-12-22,44,DPD3-14,27,27,0
2024-12-22,44,DPD30-59,13,13,0
2024-12-22,44,DPD60-89,0,0,0
2024-12-22,44,DPD90+,0,0,0
2024-12-22,46,Current,0,0,0
2024-12-22,46,DPD15-29,0,0,0
2024-12-22,46,DPD30-59,0,0,0
2024-12-22,48,Current,3,3,0
2024-12-22,48,DPD15-29,12,12,0
2024-12-22,48,DPD3-14,13,13,0
2024-12-22,48,DPD30-59,15,15,0
2024-12-22,48,DPD60-89,0,0,0
2024-12-22,48,DPD90+,0,0,0
2024-12-22,6,Current,0,0,0
2024-12-21,100,Current,0,0,0
2024-12-21,100,DPD15-29,0,0,0
2024-12-21,102,Current,0,0,0
2024-12-21,102,DPD15-29,0,0,0
2024-12-21,102,DPD90+,0,0,0
2024-12-21,104,Current,0,0,0
2024-12-21,20,Current,0,0,0
2024-12-21,20,DPD15-29,157,157,0
2024-12-21,20,DPD3-14,166,166,0
2024-12-21,20,DPD30-59,88,88,0
2024-12-21,20,DPD60-89,0,0,0
2024-12-21,20,DPD90+,0,0,0
2024-12-21,22,Current,0,0,0
2024-12-21,22,DPD30-59,0,0,0
2024-12-21,22,DPD60-89,0,0,0
2024-12-21,22,DPD90+,0,0,0
2024-12-21,24,Current,17,17,0
2024-12-21,24,DPD15-29,85,85,0
2024-12-21,24,DPD3-14,97,97,0
2024-12-21,24,DPD30-59,47,47,0
2024-12-21,24,DPD60-89,0,0,0
2024-12-21,24,DPD90+,0,0,0
2024-12-21,26,Current,0,0,0
2024-12-21,26,DPD15-29,10,10,0
2024-12-21,26,DPD3-14,13,13,0
2024-12-21,26,DPD30-59,1,1,0
2024-12-21,26,DPD60-89,0,0,0
2024-12-21,26,DPD90+,0,0,0
2024-12-21,32,Current,0,0,0
2024-12-21,32,DPD15-29,80,80,0
2024-12-21,32,DPD3-14,92,92,0
2024-12-21,32,DPD30-59,41,41,0
2024-12-21,32,DPD60-89,0,0,0
2024-12-21,32,DPD90+,0,0,0
2024-12-21,34,Current,0,0,0
2024-12-21,34,DPD15-29,29,29,0
2024-12-21,34,DPD3-14,36,36,0
2024-12-21,34,DPD30-59,16,16,0
2024-12-21,34,DPD60-89,0,0,0
2024-12-21,34,DPD90+,0,0,0
2024-12-21,36,Current,0,0,0
2024-12-21,36,DPD15-29,17,17,0
2024-12-21,36,DPD3-14,21,21,0
2024-12-21,36,DPD30-59,12,12,0
2024-12-21,36,DPD60-89,0,0,0
2024-12-21,36,DPD90+,0,0,0
2024-12-21,38,Current,3,3,0
2024-12-21,38,DPD15-29,20,20,0
2024-12-21,38,DPD3-14,29,29,0
2024-12-21,38,DPD30-59,8,8,0
2024-12-21,38,DPD60-89,0,0,0
2024-12-21,38,DPD90+,0,0,0
2024-12-21,40,Current,0,0,0
2024-12-21,40,DPD15-29,9,9,0
2024-12-21,40,DPD3-14,20,20,0
2024-12-21,40,DPD30-59,8,8,0
2024-12-21,40,DPD60-89,0,0,0
2024-12-21,40,DPD90+,0,0,0
2024-12-21,42,Current,0,0,0
2024-12-21,42,DPD15-29,10,10,0
2024-12-21,42,DPD3-14,8,8,0
2024-12-21,42,DPD30-59,3,3,0
2024-12-21,42,DPD60-89,0,0,0
2024-12-21,42,DPD90+,0,0,0
2024-12-21,44,Current,0,0,0
2024-12-21,44,DPD15-29,12,12,0
2024-12-21,44,DPD3-14,21,21,0
2024-12-21,44,DPD30-59,13,13,0
2024-12-21,44,DPD60-89,0,0,0
2024-12-21,44,DPD90+,0,0,0
2024-12-21,46,Current,0,0,0
2024-12-21,46,DPD3-14,1,1,0
2024-12-21,46,DPD30-59,0,0,0
2024-12-21,48,Current,7,7,0
2024-12-21,48,DPD15-29,11,11,0
2024-12-21,48,DPD3-14,23,23,0
2024-12-21,48,DPD30-59,7,7,0
2024-12-21,48,DPD60-89,0,0,0
2024-12-21,48,DPD90+,0,0,0
2024-12-21,6,Current,0,0,0
2024-12-20,100,Current,0,0,0
2024-12-20,100,DPD15-29,0,0,0
2024-12-20,102,Current,0,0,0
2024-12-20,102,DPD3-14,0,0,0
2024-12-20,102,DPD90+,0,0,0
2024-12-20,104,Current,0,0,0
2024-12-20,20,Current,0,0,0
2024-12-20,20,DPD15-29,157,157,0
2024-12-20,20,DPD3-14,131,131,0
2024-12-20,20,DPD30-59,69,69,0
2024-12-20,20,DPD60-89,0,0,0
2024-12-20,20,DPD90+,0,0,0
2024-12-20,22,Current,0,0,0
2024-12-20,22,DPD30-59,0,0,0
2024-12-20,22,DPD60-89,0,0,0
2024-12-20,22,DPD90+,0,0,0
2024-12-20,24,Current,21,21,0
2024-12-20,24,DPD15-29,79,79,0
2024-12-20,24,DPD3-14,87,87,0
2024-12-20,24,DPD30-59,43,43,0
2024-12-20,24,DPD60-89,0,0,0
2024-12-20,24,DPD90+,0,0,0
2024-12-20,26,Current,0,0,0
2024-12-20,26,DPD15-29,16,16,0
2024-12-20,26,DPD3-14,11,11,0
2024-12-20,26,DPD30-59,2,2,0
2024-12-20,26,DPD60-89,0,0,0
2024-12-20,26,DPD90+,0,0,0
2024-12-20,32,Current,0,0,0
2024-12-20,32,DPD15-29,83,83,0
2024-12-20,32,DPD3-14,96,96,0
2024-12-20,32,DPD30-59,39,39,0
2024-12-20,32,DPD60-89,0,0,0
2024-12-20,32,DPD90+,0,0,0
2024-12-20,34,Current,0,0,0
2024-12-20,34,DPD15-29,34,34,0
2024-12-20,34,DPD3-14,42,42,0
2024-12-20,34,DPD30-59,16,16,0
2024-12-20,34,DPD60-89,0,0,0
2024-12-20,34,DPD90+,0,0,0
2024-12-20,36,Current,0,0,0
2024-12-20,36,DPD15-29,20,20,0
2024-12-20,36,DPD3-14,10,10,0
2024-12-20,36,DPD30-59,12,12,0
2024-12-20,36,DPD60-89,0,0,0
2024-12-20,36,DPD90+,0,0,0
2024-12-20,38,Current,0,0,0
2024-12-20,38,DPD15-29,19,19,0
2024-12-20,38,DPD3-14,23,23,0
2024-12-20,38,DPD30-59,5,5,0
2024-12-20,38,DPD60-89,0,0,0
2024-12-20,38,DPD90+,0,0,0
2024-12-20,40,Current,0,0,0
2024-12-20,40,DPD15-29,9,9,0
2024-12-20,40,DPD3-14,15,15,0
2024-12-20,40,DPD30-59,8,8,0
2024-12-20,40,DPD60-89,0,0,0
2024-12-20,40,DPD90+,0,0,0
2024-12-20,42,Current,0,0,0
2024-12-20,42,DPD15-29,2,2,0
2024-12-20,42,DPD3-14,6,6,0
2024-12-20,42,DPD30-59,6,6,0
2024-12-20,42,DPD60-89,0,0,0
2024-12-20,42,DPD90+,0,0,0
2024-12-20,44,Current,0,0,0
2024-12-20,44,DPD15-29,27,27,0
2024-12-20,44,DPD3-14,30,30,0
2024-12-20,44,DPD30-59,6,6,0
2024-12-20,44,DPD60-89,0,0,0
2024-12-20,44,DPD90+,0,0,0
2024-12-20,46,Current,0,0,0
2024-12-20,46,DPD3-14,0,0,0
2024-12-20,46,DPD30-59,1,1,0
2024-12-20,48,Current,8,8,0
2024-12-20,48,DPD15-29,13,13,0
2024-12-20,48,DPD3-14,16,16,0
2024-12-20,48,DPD30-59,5,5,0
2024-12-20,48,DPD60-89,0,0,0
2024-12-20,48,DPD90+,0,0,0
2024-12-20,6,Current,0,0,0
2024-12-19,100,Current,0,0,0
2024-12-19,100,DPD15-29,0,0,0
2024-12-19,102,Current,0,0,0
2024-12-19,102,DPD3-14,1,1,0
2024-12-19,102,DPD90+,0,0,0
2024-12-19,104,Current,0,0,0
2024-12-19,20,Current,0,0,0
2024-12-19,20,DPD15-29,180,180,0
2024-12-19,20,DPD3-14,190,190,0
2024-12-19,20,DPD30-59,73,73,0
2024-12-19,20,DPD60-89,0,0,0
2024-12-19,20,DPD90+,0,0,0
2024-12-19,22,Current,0,0,0
2024-12-19,22,DPD30-59,1,1,0
2024-12-19,22,DPD60-89,0,0,0
2024-12-19,22,DPD90+,0,0,0
2024-12-19,24,Current,344,344,0
2024-12-19,24,DPD15-29,89,89,0
2024-12-19,24,DPD3-14,130,130,0
2024-12-19,24,DPD30-59,42,42,0
2024-12-19,24,DPD60-89,0,0,0
2024-12-19,24,DPD90+,0,0,0
2024-12-19,26,Current,0,0,0
2024-12-19,26,DPD15-29,10,10,0
2024-12-19,26,DPD3-14,19,19,0
2024-12-19,26,DPD30-59,4,4,0
2024-12-19,26,DPD60-89,0,0,0
2024-12-19,26,DPD90+,0,0,0
2024-12-19,32,Current,0,0,0
2024-12-19,32,DPD15-29,99,99,0
2024-12-19,32,DPD3-14,98,98,0
2024-12-19,32,DPD30-59,41,41,0
2024-12-19,32,DPD60-89,0,0,0
2024-12-19,32,DPD90+,0,0,0
2024-12-19,34,Current,0,0,0
2024-12-19,34,DPD15-29,35,35,0
2024-12-19,34,DPD3-14,44,44,0
2024-12-19,34,DPD30-59,12,12,0
2024-12-19,34,DPD60-89,0,0,0
2024-12-19,34,DPD90+,0,0,0
2024-12-19,36,Current,0,0,0
2024-12-19,36,DPD15-29,23,23,0
2024-12-19,36,DPD3-14,26,26,0
2024-12-19,36,DPD30-59,8,8,0
2024-12-19,36,DPD60-89,0,0,0
2024-12-19,36,DPD90+,0,0,0
2024-12-19,38,Current,61,61,0
2024-12-19,38,DPD15-29,24,24,0
2024-12-19,38,DPD3-14,38,38,0
2024-12-19,38,DPD30-59,12,12,0
2024-12-19,38,DPD60-89,0,0,0
2024-12-19,38,DPD90+,0,0,0
2024-12-19,40,Current,0,0,0
2024-12-19,40,DPD15-29,9,9,0
2024-12-19,40,DPD3-14,24,24,0
2024-12-19,40,DPD30-59,7,7,0
2024-12-19,40,DPD60-89,0,0,0
2024-12-19,40,DPD90+,0,0,0
2024-12-19,42,Current,0,0,0
2024-12-19,42,DPD15-29,11,11,0
2024-12-19,42,DPD3-14,15,15,0
2024-12-19,42,DPD30-59,6,6,0
2024-12-19,42,DPD60-89,0,0,0
2024-12-19,42,DPD90+,0,0,0
2024-12-19,44,Current,0,0,0
2024-12-19,44,DPD15-29,18,18,0
2024-12-19,44,DPD3-14,26,26,0
2024-12-19,44,DPD30-59,6,6,0
2024-12-19,44,DPD60-89,0,0,0
2024-12-19,44,DPD90+,0,0,0
2024-12-19,46,Current,0,0,0
2024-12-19,46,DPD3-14,1,1,0
2024-12-19,46,DPD30-59,0,0,0
2024-12-19,48,Current,174,174,0
2024-12-19,48,DPD15-29,14,14,0
2024-12-19,48,DPD3-14,38,38,0
2024-12-19,48,DPD30-59,5,5,0
2024-12-19,48,DPD60-89,0,0,0
2024-12-19,48,DPD90+,1,1,0
2024-12-19,6,Current,0,0,0
2024-12-18,100,Current,0,0,0
2024-12-18,100,DPD15-29,0,0,0
2024-12-18,102,Current,0,0,0
2024-12-18,102,DPD3-14,0,0,0
2024-12-18,104,Current,0,0,0
2024-12-18,20,Current,0,0,0
2024-12-18,20,DPD15-29,185,185,0
2024-12-18,20,DPD3-14,163,163,0
2024-12-18,20,DPD30-59,147,147,0
2024-12-18,20,DPD60-89,0,0,0
2024-12-18,20,DPD90+,0,0,0
2024-12-18,22,Current,0,0,0
2024-12-18,22,DPD30-59,0,0,0
2024-12-18,22,DPD60-89,0,0,0
2024-12-18,22,DPD90+,0,0,0
2024-12-18,24,Current,15,15,0
2024-12-18,24,DPD15-29,94,94,0
2024-12-18,24,DPD3-14,111,111,0
2024-12-18,24,DPD30-59,73,73,0
2024-12-18,24,DPD60-89,0,0,0
2024-12-18,24,DPD90+,0,0,0
2024-12-18,26,Current,0,0,0
2024-12-18,26,DPD15-29,15,15,0
2024-12-18,26,DPD3-14,15,15,0
2024-12-18,26,DPD30-59,12,12,0
2024-12-18,26,DPD60-89,0,0,0
2024-12-18,26,DPD90+,0,0,0
2024-12-18,32,Current,0,0,0
2024-12-18,32,DPD15-29,113,113,0
2024-12-18,32,DPD3-14,74,74,0
2024-12-18,32,DPD30-59,68,68,0
2024-12-18,32,DPD60-89,0,0,0
2024-12-18,32,DPD90+,0,0,0
2024-12-18,34,Current,0,0,0
2024-12-18,34,DPD15-29,34,34,0
2024-12-18,34,DPD3-14,43,43,0
2024-12-18,34,DPD30-59,18,18,0
2024-12-18,34,DPD60-89,0,0,0
2024-12-18,34,DPD90+,0,0,0
2024-12-18,36,Current,0,0,0
2024-12-18,36,DPD15-29,32,32,0
2024-12-18,36,DPD3-14,14,14,0
2024-12-18,36,DPD30-59,16,16,0
2024-12-18,36,DPD60-89,0,0,0
2024-12-18,36,DPD90+,0,0,0
2024-12-18,38,Current,1,1,0
2024-12-18,38,DPD15-29,26,26,0
2024-12-18,38,DPD3-14,30,30,0
2024-12-18,38,DPD30-59,12,12,0
2024-12-18,38,DPD60-89,0,0,0
2024-12-18,38,DPD90+,0,0,0
2024-12-18,40,Current,0,0,0
2024-12-18,40,DPD15-29,12,12,0
2024-12-18,40,DPD3-14,18,18,0
2024-12-18,40,DPD30-59,14,14,0
2024-12-18,40,DPD60-89,0,0,0
2024-12-18,40,DPD90+,0,0,0
2024-12-18,42,Current,0,0,0
2024-12-18,42,DPD15-29,6,6,0
2024-12-18,42,DPD3-14,8,8,0
2024-12-18,42,DPD30-59,8,8,0
2024-12-18,42,DPD60-89,0,0,0
2024-12-18,42,DPD90+,0,0,0
2024-12-18,44,Current,0,0,0
2024-12-18,44,DPD15-29,31,31,0
2024-12-18,44,DPD3-14,30,30,0
2024-12-18,44,DPD30-59,14,14,0
2024-12-18,44,DPD60-89,0,0,0
2024-12-18,44,DPD90+,0,0,0
2024-12-18,46,Current,0,0,0
2024-12-18,46,DPD3-14,0,0,0
2024-12-18,48,Current,4,4,0
2024-12-18,48,DPD15-29,14,14,0
2024-12-18,48,DPD3-14,20,20,0
2024-12-18,48,DPD30-59,15,15,0
2024-12-18,48,DPD60-89,0,0,0
2024-12-18,48,DPD90+,0,0,0
2024-12-18,6,Current,0,0,0
2024-12-17,100,Current,0,0,0
2024-12-17,100,DPD3-14,1,1,0
2024-12-17,102,Current,0,0,0
2024-12-17,102,DPD3-14,0,0,0
2024-12-17,102,DPD60-89,0,0,0
2024-12-17,104,Current,0,0,0
2024-12-17,20,Current,1,1,0
2024-12-17,20,DPD15-29,242,242,0
2024-12-17,20,DPD3-14,164,164,0
2024-12-17,20,DPD30-59,117,117,0
2024-12-17,20,DPD60-89,0,0,0
2024-12-17,20,DPD90+,0,0,0
2024-12-17,22,Current,0,0,0
2024-12-17,22,DPD60-89,0,0,0
2024-12-17,22,DPD90+,0,0,0
2024-12-17,24,Current,30,30,0
2024-12-17,24,DPD15-29,108,108,0
2024-12-17,24,DPD3-14,110,110,0
2024-12-17,24,DPD30-59,59,59,0
2024-12-17,24,DPD60-89,0,0,0
2024-12-17,24,DPD90+,0,0,0
2024-12-17,26,Current,0,0,0
2024-12-17,26,DPD15-29,10,10,0
2024-12-17,26,DPD3-14,18,18,0
2024-12-17,26,DPD30-59,3,3,0
2024-12-17,26,DPD60-89,0,0,0
2024-12-17,26,DPD90+,0,0,0
2024-12-17,32,Current,0,0,0
2024-12-17,32,DPD15-29,135,135,0
2024-12-17,32,DPD3-14,67,67,0
2024-12-17,32,DPD30-59,58,58,0
2024-12-17,32,DPD60-89,0,0,0
2024-12-17,32,DPD90+,0,0,0
2024-12-17,34,Current,0,0,0
2024-12-17,34,DPD15-29,42,42,0
2024-12-17,34,DPD3-14,41,41,0
2024-12-17,34,DPD30-59,18,18,0
2024-12-17,34,DPD60-89,0,0,0
2024-12-17,34,DPD90+,0,0,0
2024-12-17,36,Current,0,0,0
2024-12-17,36,DPD15-29,30,30,0
2024-12-17,36,DPD3-14,15,15,0
2024-12-17,36,DPD30-59,16,16,0
2024-12-17,36,DPD60-89,0,0,0
2024-12-17,36,DPD90+,0,0,0
2024-12-17,38,Current,2,2,0
2024-12-17,38,DPD15-29,30,30,0
2024-12-17,38,DPD3-14,19,19,0
2024-12-17,38,DPD30-59,8,8,0
2024-12-17,38,DPD60-89,0,0,0
2024-12-17,38,DPD90+,0,0,0
2024-12-17,40,Current,0,0,0
2024-12-17,40,DPD15-29,12,12,0
2024-12-17,40,DPD3-14,12,12,0
2024-12-17,40,DPD30-59,8,8,0
2024-12-17,40,DPD60-89,0,0,0
2024-12-17,40,DPD90+,0,0,0
2024-12-17,42,Current,0,0,0
2024-12-17,42,DPD15-29,11,11,0
2024-12-17,42,DPD3-14,10,10,0
2024-12-17,42,DPD30-59,2,2,0
2024-12-17,42,DPD60-89,0,0,0
2024-12-17,42,DPD90+,0,0,0
2024-12-17,44,Current,0,0,0
2024-12-17,44,DPD15-29,31,31,0
2024-12-17,44,DPD3-14,22,22,0
2024-12-17,44,DPD30-59,13,13,0
2024-12-17,44,DPD60-89,0,0,0
2024-12-17,44,DPD90+,0,0,0
2024-12-17,46,Current,0,0,0
2024-12-17,46,DPD15-29,1,1,0
2024-12-17,46,DPD3-14,1,1,0
2024-12-17,48,Current,16,16,0
2024-12-17,48,DPD15-29,20,20,0
2024-12-17,48,DPD3-14,31,31,0
2024-12-17,48,DPD30-59,4,4,0
2024-12-17,48,DPD60-89,0,0,0
2024-12-17,48,DPD90+,0,0,0
2024-12-17,6,Current,0,0,0
2024-12-16,100,Current,0,0,0
2024-12-16,100,DPD3-14,0,0,0
2024-12-16,102,Current,0,0,0
2024-12-16,102,DPD3-14,0,0,0
2024-12-16,102,DPD60-89,0,0,0
2024-12-16,104,Current,0,0,0
2024-12-16,20,Current,3,3,0
2024-12-16,20,DPD15-29,210,210,0
2024-12-16,20,DPD3-14,198,198,0
2024-12-16,20,DPD30-59,72,72,0
2024-12-16,20,DPD60-89,0,0,0
2024-12-16,20,DPD90+,0,0,0
2024-12-16,22,Current,0,0,0
2024-12-16,22,DPD60-89,0,0,0
2024-12-16,22,DPD90+,0,0,0
2024-12-16,24,Current,27,27,0
2024-12-16,24,DPD15-29,104,104,0
2024-12-16,24,DPD3-14,138,138,0
2024-12-16,24,DPD30-59,48,48,0
2024-12-16,24,DPD60-89,0,0,0
2024-12-16,24,DPD90+,0,0,0
2024-12-16,26,Current,0,0,0
2024-12-16,26,DPD15-29,18,18,0
2024-12-16,26,DPD3-14,14,14,0
2024-12-16,26,DPD30-59,2,2,0
2024-12-16,26,DPD60-89,0,0,0
2024-12-16,26,DPD90+,0,0,0
2024-12-16,32,Current,0,0,0
2024-12-16,32,DPD15-29,135,135,0
2024-12-16,32,DPD3-14,78,78,0
2024-12-16,32,DPD30-59,49,49,0
2024-12-16,32,DPD60-89,0,0,0
2024-12-16,32,DPD90+,0,0,0
2024-12-16,34,Current,0,0,0
2024-12-16,34,DPD15-29,38,38,0
2024-12-16,34,DPD3-14,45,45,0
2024-12-16,34,DPD30-59,17,17,0
2024-12-16,34,DPD60-89,0,0,0
2024-12-16,34,DPD90+,0,0,0
2024-12-16,36,Current,0,0,0
2024-12-16,36,DPD15-29,30,30,0
2024-12-16,36,DPD3-14,22,22,0
2024-12-16,36,DPD30-59,10,10,0
2024-12-16,36,DPD60-89,0,0,0
2024-12-16,36,DPD90+,0,0,0
2024-12-16,38,Current,3,3,0
2024-12-16,38,DPD15-29,27,27,0
2024-12-16,38,DPD3-14,30,30,0
2024-12-16,38,DPD30-59,5,5,0
2024-12-16,38,DPD60-89,0,0,0
2024-12-16,38,DPD90+,0,0,0
2024-12-16,40,Current,0,0,0
2024-12-16,40,DPD15-29,15,15,0
2024-12-16,40,DPD3-14,24,24,0
2024-12-16,40,DPD30-59,5,5,0
2024-12-16,40,DPD60-89,0,0,0
2024-12-16,40,DPD90+,0,0,0
2024-12-16,42,Current,0,0,0
2024-12-16,42,DPD15-29,6,6,0
2024-12-16,42,DPD3-14,13,13,0
2024-12-16,42,DPD30-59,5,5,0
2024-12-16,42,DPD60-89,0,0,0
2024-12-16,42,DPD90+,0,0,0
2024-12-16,44,Current,0,0,0
2024-12-16,44,DPD15-29,33,33,0
2024-12-16,44,DPD3-14,33,33,0
2024-12-16,44,DPD30-59,5,5,0
2024-12-16,44,DPD60-89,0,0,0
2024-12-16,44,DPD90+,0,0,0
2024-12-16,46,Current,0,0,0
2024-12-16,46,DPD15-29,0,0,0
2024-12-16,46,DPD3-14,0,0,0
2024-12-16,48,Current,9,9,0
2024-12-16,48,DPD15-29,14,14,0
2024-12-16,48,DPD3-14,28,28,0
2024-12-16,48,DPD30-59,3,3,0
2024-12-16,48,DPD60-89,0,0,0
2024-12-16,48,DPD90+,0,0,0
2024-12-16,6,Current,0,0,0
2024-12-15,100,Current,0,0,0
2024-12-15,100,DPD3-14,1,1,0
2024-12-15,102,Current,0,0,0
2024-12-15,102,DPD3-14,0,0,0
2024-12-15,102,DPD60-89,0,0,0
2024-12-15,104,Current,0,0,0
2024-12-15,20,Current,3715,3715,0
2024-12-15,20,DPD15-29,277,277,0
2024-12-15,20,DPD3-14,283,283,0
2024-12-15,20,DPD30-59,179,179,0
2024-12-15,20,DPD60-89,42,42,0
2024-12-15,20,DPD90+,31,31,0
2024-12-15,22,Current,0,0,0
2024-12-15,22,DPD60-89,0,0,0
2024-12-15,22,DPD90+,0,0,0
2024-12-15,24,Current,4859,4859,0
2024-12-15,24,DPD15-29,162,162,0
2024-12-15,24,DPD3-14,204,204,0
2024-12-15,24,DPD30-59,107,107,0
2024-12-15,24,DPD60-89,21,21,0
2024-12-15,24,DPD90+,13,13,0
2024-12-15,26,Current,0,0,0
2024-12-15,26,DPD15-29,13,13,0
2024-12-15,26,DPD3-14,20,20,0
2024-12-15,26,DPD30-59,5,5,0
2024-12-15,26,DPD60-89,0,0,0
2024-12-15,26,DPD90+,0,0,0
2024-12-15,32,Current,189,189,0
2024-12-15,32,DPD15-29,128,128,0
2024-12-15,32,DPD3-14,100,100,0
2024-12-15,32,DPD30-59,59,59,0
2024-12-15,32,DPD60-89,2,2,0
2024-12-15,32,DPD90+,3,3,0
2024-12-15,34,Current,0,0,0
2024-12-15,34,DPD15-29,47,47,0
2024-12-15,34,DPD3-14,38,38,0
2024-12-15,34,DPD30-59,20,20,0
2024-12-15,34,DPD60-89,0,0,0
2024-12-15,34,DPD90+,0,0,0
2024-12-15,36,Current,206,206,0
2024-12-15,36,DPD15-29,31,31,0
2024-12-15,36,DPD3-14,25,25,0
2024-12-15,36,DPD30-59,10,10,0
2024-12-15,36,DPD60-89,4,4,0
2024-12-15,36,DPD90+,0,0,0
2024-12-15,38,Current,295,295,0
2024-12-15,38,DPD15-29,31,31,0
2024-12-15,38,DPD3-14,28,28,0
2024-12-15,38,DPD30-59,10,10,0
2024-12-15,38,DPD60-89,0,0,0
2024-12-15,38,DPD90+,0,0,0
2024-12-15,40,Current,222,222,0
2024-12-15,40,DPD15-29,9,9,0
2024-12-15,40,DPD3-14,23,23,0
2024-12-15,40,DPD30-59,12,12,0
2024-12-15,40,DPD60-89,0,0,0
2024-12-15,40,DPD90+,3,3,0
2024-12-15,42,Current,0,0,0
2024-12-15,42,DPD15-29,13,13,0
2024-12-15,42,DPD3-14,8,8,0
2024-12-15,42,DPD30-59,5,5,0
2024-12-15,42,DPD60-89,0,0,0
2024-12-15,42,DPD90+,0,0,0
2024-12-15,44,Current,150,150,0
2024-12-15,44,DPD15-29,28,28,0
2024-12-15,44,DPD3-14,35,35,0
2024-12-15,44,DPD30-59,8,8,0
2024-12-15,44,DPD60-89,2,2,0
2024-12-15,44,DPD90+,1,1,0
2024-12-15,46,Current,4,4,0
2024-12-15,46,DPD3-14,2,2,0
2024-12-15,48,Current,4580,4580,0
2024-12-15,48,DPD15-29,51,51,0
2024-12-15,48,DPD3-14,83,83,0
2024-12-15,48,DPD30-59,36,36,0
2024-12-15,48,DPD60-89,26,26,0
2024-12-15,48,DPD90+,16,16,0
2024-12-15,6,Current,0,0,0
2024-12-14,100,Current,0,0,0
2024-12-14,100,DPD3-14,0,0,0
2024-12-14,102,Current,0,0,0
2024-12-14,102,DPD3-14,0,0,0
2024-12-14,102,DPD60-89,0,0,0
2024-12-14,104,Current,0,0,0
2024-12-14,20,Current,0,0,0
2024-12-14,20,DPD15-29,221,221,0
2024-12-14,20,DPD3-14,148,148,0
2024-12-14,20,DPD30-59,85,85,0
2024-12-14,20,DPD60-89,0,0,0
2024-12-14,20,DPD90+,0,0,0
2024-12-14,22,Current,0,0,0
2024-12-14,22,DPD60-89,0,0,0
2024-12-14,22,DPD90+,0,0,0
2024-12-14,24,Current,17,17,0
2024-12-14,24,DPD15-29,110,110,0
2024-12-14,24,DPD3-14,110,110,0
2024-12-14,24,DPD30-59,37,37,0
2024-12-14,24,DPD60-89,0,0,0
2024-12-14,24,DPD90+,0,0,0
2024-12-14,26,Current,0,0,0
2024-12-14,26,DPD15-29,18,18,0
2024-12-14,26,DPD3-14,9,9,0
2024-12-14,26,DPD30-59,10,10,0
2024-12-14,26,DPD60-89,0,0,0
2024-12-14,26,DPD90+,0,0,0
2024-12-14,32,Current,0,0,0
2024-12-14,32,DPD15-29,151,151,0
2024-12-14,32,DPD3-14,60,60,0
2024-12-14,32,DPD30-59,41,41,0
2024-12-14,32,DPD60-89,0,0,0
2024-12-14,32,DPD90+,0,0,0
2024-12-14,34,Current,0,0,0
2024-12-14,34,DPD15-29,45,45,0
2024-12-14,34,DPD3-14,38,38,0
2024-12-14,34,DPD30-59,18,18,0
2024-12-14,34,DPD60-89,0,0,0
2024-12-14,34,DPD90+,0,0,0
2024-12-14,36,Current,0,0,0
2024-12-14,36,DPD15-29,32,32,0
2024-12-14,36,DPD3-14,16,16,0
2024-12-14,36,DPD30-59,12,12,0
2024-12-14,36,DPD60-89,0,0,0
2024-12-14,36,DPD90+,0,0,0
2024-12-14,38,Current,5,5,0
2024-12-14,38,DPD15-29,28,28,0
2024-12-14,38,DPD3-14,19,19,0
2024-12-14,38,DPD30-59,11,11,0
2024-12-14,38,DPD60-89,0,0,0
2024-12-14,38,DPD90+,0,0,0
2024-12-14,40,Current,0,0,0
2024-12-14,40,DPD15-29,16,16,0
2024-12-14,40,DPD3-14,19,19,0
2024-12-14,40,DPD30-59,7,7,0
2024-12-14,40,DPD60-89,0,0,0
2024-12-14,40,DPD90+,0,0,0
2024-12-14,42,Current,0,0,0
2024-12-14,42,DPD15-29,8,8,0
2024-12-14,42,DPD3-14,8,8,0
2024-12-14,42,DPD30-59,4,4,0
2024-12-14,42,DPD60-89,0,0,0
2024-12-14,42,DPD90+,0,0,0
2024-12-14,44,Current,0,0,0
2024-12-14,44,DPD15-29,33,33,0
2024-12-14,44,DPD3-14,30,30,0
2024-12-14,44,DPD30-59,7,7,0
2024-12-14,44,DPD60-89,0,0,0
2024-12-14,44,DPD90+,0,0,0
2024-12-14,46,Current,0,0,0
2024-12-14,46,DPD3-14,0,0,0
2024-12-14,48,Current,4,4,0
2024-12-14,48,DPD15-29,15,15,0
2024-12-14,48,DPD3-14,19,19,0
2024-12-14,48,DPD30-59,8,8,0
2024-12-14,48,DPD60-89,0,0,0
2024-12-14,48,DPD90+,0,0,0
2024-12-14,6,Current,0,0,0
2024-12-13,100,Current,0,0,0
2024-12-13,100,DPD3-14,0,0,0
2024-12-13,102,Current,0,0,0
2024-12-13,102,DPD3-14,0,0,0
2024-12-13,102,DPD60-89,0,0,0
2024-12-13,104,Current,0,0,0
2024-12-13,20,Current,0,0,0
2024-12-13,20,DPD15-29,236,236,0
2024-12-13,20,DPD3-14,216,216,0
2024-12-13,20,DPD30-59,111,111,0
2024-12-13,20,DPD60-89,0,0,0
2024-12-13,20,DPD90+,0,0,0
2024-12-13,22,Current,0,0,0
2024-12-13,22,DPD60-89,0,0,0
2024-12-13,22,DPD90+,0,0,0
2024-12-13,24,Current,6,6,0
2024-12-13,24,DPD15-29,126,126,0
2024-12-13,24,DPD3-14,130,130,0
2024-12-13,24,DPD30-59,55,55,0
2024-12-13,24,DPD60-89,0,0,0
2024-12-13,24,DPD90+,0,0,0
2024-12-13,26,Current,0,0,0
2024-12-13,26,DPD15-29,14,14,0
2024-12-13,26,DPD3-14,22,22,0
2024-12-13,26,DPD30-59,4,4,0
2024-12-13,26,DPD60-89,0,0,0
2024-12-13,26,DPD90+,0,0,0
2024-12-13,32,Current,0,0,0
2024-12-13,32,DPD15-29,125,125,0
2024-12-13,32,DPD3-14,108,108,0
2024-12-13,32,DPD30-59,48,48,0
2024-12-13,32,DPD60-89,0,0,0
2024-12-13,32,DPD90+,0,0,0
2024-12-13,34,Current,0,0,0
2024-12-13,34,DPD15-29,46,46,0
2024-12-13,34,DPD3-14,47,47,0
2024-12-13,34,DPD30-59,20,20,0
2024-12-13,34,DPD60-89,0,0,0
2024-12-13,34,DPD90+,0,0,0
2024-12-13,36,Current,0,0,0
2024-12-13,36,DPD15-29,26,26,0
2024-12-13,36,DPD3-14,32,32,0
2024-12-13,36,DPD30-59,12,12,0
2024-12-13,36,DPD60-89,0,0,0
2024-12-13,36,DPD90+,0,0,0
2024-12-13,38,Current,0,0,0
2024-12-13,38,DPD15-29,29,29,0
2024-12-13,38,DPD3-14,28,28,0
2024-12-13,38,DPD30-59,9,9,0
2024-12-13,38,DPD60-89,0,0,0
2024-12-13,38,DPD90+,0,0,0
2024-12-13,40,Current,0,0,0
2024-12-13,40,DPD15-29,8,8,0
2024-12-13,40,DPD3-14,19,19,0
2024-12-13,40,DPD30-59,8,8,0
2024-12-13,40,DPD60-89,0,0,0
2024-12-13,40,DPD90+,0,0,0
2024-12-13,42,Current,0,0,0
2024-12-13,42,DPD15-29,15,15,0
2024-12-13,42,DPD3-14,15,15,0
2024-12-13,42,DPD30-59,1,1,0
2024-12-13,42,DPD60-89,0,0,0
2024-12-13,42,DPD90+,0,0,0
2024-12-13,44,Current,0,0,0
2024-12-13,44,DPD15-29,27,27,0
2024-12-13,44,DPD3-14,29,29,0
2024-12-13,44,DPD30-59,8,8,0
2024-12-13,44,DPD60-89,0,0,0
2024-12-13,44,DPD90+,0,0,0
2024-12-13,46,Current,0,0,0
2024-12-13,46,DPD3-14,2,2,0
2024-12-13,48,Current,0,0,0
2024-12-13,48,DPD15-29,24,24,0
2024-12-13,48,DPD3-14,25,25,0
2024-12-13,48,DPD30-59,6,6,0
2024-12-13,48,DPD60-89,0,0,0
2024-12-13,48,DPD90+,0,0,0
2024-12-13,6,Current,0,0,0
2024-12-12,100,Current,0,0,0
2024-12-12,100,DPD3-14,0,0,0
2024-12-12,100,DPD30-59,0,0,0
2024-12-12,102,Current,0,0,0
2024-12-12,102,DPD3-14,0,0,0
2024-12-12,102,DPD60-89,0,0,0
2024-12-12,104,Current,0,0,0
2024-12-12,20,Current,0,0,0
2024-12-12,20,DPD15-29,182,182,0
2024-12-12,20,DPD3-14,202,202,0
2024-12-12,20,DPD30-59,68,68,0
2024-12-12,20,DPD60-89,0,0,0
2024-12-12,20,DPD90+,0,0,0
2024-12-12,22,Current,0,0,0
2024-12-12,22,DPD15-29,0,0,0
2024-12-12,22,DPD60-89,0,0,0
2024-12-12,22,DPD90+,0,0,0
2024-12-12,24,Current,8,8,0
2024-12-12,24,DPD15-29,96,96,0
2024-12-12,24,DPD3-14,132,132,0
2024-12-12,24,DPD30-59,49,49,0
2024-12-12,24,DPD60-89,0,0,0
2024-12-12,24,DPD90+,0,0,0
2024-12-12,26,Current,0,0,0
2024-12-12,26,DPD15-29,14,14,0
2024-12-12,26,DPD3-14,15,15,0
2024-12-12,26,DPD30-59,3,3,0
2024-12-12,26,DPD60-89,0,0,0
2024-12-12,26,DPD90+,0,0,0
2024-12-12,32,Current,0,0,0
2024-12-12,32,DPD15-29,127,127,0
2024-12-12,32,DPD3-14,91,91,0
2024-12-12,32,DPD30-59,39,39,0
2024-12-12,32,DPD60-89,0,0,0
2024-12-12,32,DPD90+,0,0,0
2024-12-12,34,Current,0,0,0
2024-12-12,34,DPD15-29,35,35,0
2024-12-12,34,DPD3-14,55,55,0
2024-12-12,34,DPD30-59,10,10,0
2024-12-12,34,DPD60-89,0,0,0
2024-12-12,34,DPD90+,0,0,0
2024-12-12,36,Current,0,0,0
2024-12-12,36,DPD15-29,20,20,0
2024-12-12,36,DPD3-14,38,38,0
2024-12-12,36,DPD30-59,10,10,0
2024-12-12,36,DPD60-89,0,0,0
2024-12-12,36,DPD90+,0,0,0
2024-12-12,38,Current,0,0,0
2024-12-12,38,DPD15-29,24,24,0
2024-12-12,38,DPD3-14,27,27,0
2024-12-12,38,DPD30-59,6,6,0
2024-12-12,38,DPD60-89,0,0,0
2024-12-12,38,DPD90+,0,0,0
2024-12-12,40,Current,0,0,0
2024-12-12,40,DPD15-29,13,13,0
2024-12-12,40,DPD3-14,20,20,0
2024-12-12,40,DPD30-59,4,4,0
2024-12-12,40,DPD60-89,0,0,0
2024-12-12,40,DPD90+,0,0,0
2024-12-12,42,Current,0,0,0
2024-12-12,42,DPD15-29,8,8,0
2024-12-12,42,DPD3-14,7,7,0
2024-12-12,42,DPD30-59,3,3,0
2024-12-12,42,DPD60-89,0,0,0
2024-12-12,42,DPD90+,0,0,0
2024-12-12,44,Current,0,0,0
2024-12-12,44,DPD15-29,24,24,0
2024-12-12,44,DPD3-14,35,35,0
2024-12-12,44,DPD30-59,5,5,0
2024-12-12,44,DPD60-89,0,0,0
2024-12-12,44,DPD90+,0,0,0
2024-12-12,46,Current,0,0,0
2024-12-12,46,DPD3-14,0,0,0
2024-12-12,48,Current,7,7,0
2024-12-12,48,DPD15-29,18,18,0
2024-12-12,48,DPD3-14,17,17,0
2024-12-12,48,DPD30-59,7,7,0
2024-12-12,48,DPD60-89,0,0,0
2024-12-12,48,DPD90+,0,0,0
2024-12-12,6,Current,0,0,0
2024-12-11,100,Current,0,0,0
2024-12-11,100,DPD3-14,0,0,0
2024-12-11,100,DPD30-59,1,1,0
2024-12-11,102,Current,0,0,0
2024-12-11,102,DPD3-14,0,0,0
2024-12-11,102,DPD60-89,0,0,0
2024-12-11,104,Current,0,0,0
2024-12-11,20,Current,0,0,0
2024-12-11,20,DPD15-29,219,219,0
2024-12-11,20,DPD3-14,237,237,0
2024-12-11,20,DPD30-59,105,105,0
2024-12-11,20,DPD60-89,0,0,0
2024-12-11,20,DPD90+,0,0,0
2024-12-11,22,Current,0,0,0
2024-12-11,22,DPD15-29,1,1,0
2024-12-11,22,DPD60-89,0,0,0
2024-12-11,22,DPD90+,0,0,0
2024-12-11,24,Current,17,17,0
2024-12-11,24,DPD15-29,112,112,0
2024-12-11,24,DPD3-14,134,134,0
2024-12-11,24,DPD30-59,72,72,0
2024-12-11,24,DPD60-89,0,0,0
2024-12-11,24,DPD90+,0,0,0
2024-12-11,26,Current,1,1,0
2024-12-11,26,DPD15-29,14,14,0
2024-12-11,26,DPD3-14,23,23,0
2024-12-11,26,DPD30-59,1,1,0
2024-12-11,26,DPD60-89,0,0,0
2024-12-11,26,DPD90+,0,0,0
2024-12-11,32,Current,0,0,0
2024-12-11,32,DPD15-29,113,113,0
2024-12-11,32,DPD3-14,126,126,0
2024-12-11,32,DPD30-59,61,61,0
2024-12-11,32,DPD60-89,0,0,0
2024-12-11,32,DPD90+,0,0,0
2024-12-11,34,Current,0,0,0
2024-12-11,34,DPD15-29,43,43,0
2024-12-11,34,DPD3-14,45,45,0
2024-12-11,34,DPD30-59,20,20,0
2024-12-11,34,DPD60-89,0,0,0
2024-12-11,34,DPD90+,0,0,0
2024-12-11,36,Current,0,0,0
2024-12-11,36,DPD15-29,25,25,0
2024-12-11,36,DPD3-14,32,32,0
2024-12-11,36,DPD30-59,14,14,0
2024-12-11,36,DPD60-89,0,0,0
2024-12-11,36,DPD90+,0,0,0
2024-12-11,38,Current,3,3,0
2024-12-11,38,DPD15-29,27,27,0
2024-12-11,38,DPD3-14,37,37,0
2024-12-11,38,DPD30-59,8,8,0
2024-12-11,38,DPD60-89,0,0,0
2024-12-11,38,DPD90+,0,0,0
2024-12-11,40,Current,0,0,0
2024-12-11,40,DPD15-29,11,11,0
2024-12-11,40,DPD3-14,17,17,0
2024-12-11,40,DPD30-59,12,12,0
2024-12-11,40,DPD60-89,0,0,0
2024-12-11,40,DPD90+,0,0,0
2024-12-11,42,Current,0,0,0
2024-12-11,42,DPD15-29,13,13,0
2024-12-11,42,DPD3-14,17,17,0
2024-12-11,42,DPD30-59,6,6,0
2024-12-11,42,DPD60-89,0,0,0
2024-12-11,42,DPD90+,0,0,0
2024-12-11,44,Current,0,0,0
2024-12-11,44,DPD15-29,28,28,0
2024-12-11,44,DPD3-14,27,27,0
2024-12-11,44,DPD30-59,12,12,0
2024-12-11,44,DPD60-89,0,0,0
2024-12-11,44,DPD90+,0,0,0
2024-12-11,46,Current,0,0,0
2024-12-11,46,DPD3-14,1,1,0
2024-12-11,48,Current,4,4,0
2024-12-11,48,DPD15-29,26,26,0
2024-12-11,48,DPD3-14,24,24,0
2024-12-11,48,DPD30-59,9,9,0
2024-12-11,48,DPD60-89,0,0,0
2024-12-11,48,DPD90+,0,0,0
2024-12-11,6,Current,0,0,0
2024-12-10,100,Current,0,0,0
2024-12-10,100,DPD3-14,0,0,0
2024-12-10,100,DPD30-59,0,0,0
2024-12-10,102,Current,0,0,0
2024-12-10,102,DPD3-14,0,0,0
2024-12-10,102,DPD60-89,0,0,0
2024-12-10,104,Current,0,0,0
2024-12-10,20,Current,0,0,0
2024-12-10,20,DPD15-29,189,189,0
2024-12-10,20,DPD3-14,235,235,0
2024-12-10,20,DPD30-59,85,85,0
2024-12-10,20,DPD60-89,0,0,0
2024-12-10,20,DPD90+,0,0,0
2024-12-10,20,,0,,
2024-12-10,22,Current,0,0,0
2024-12-10,22,DPD15-29,0,0,0
2024-12-10,22,DPD60-89,0,0,0
2024-12-10,22,DPD90+,0,0,0
2024-12-10,24,Current,55,55,0
2024-12-10,24,DPD15-29,107,107,0
2024-12-10,24,DPD3-14,142,142,0
2024-12-10,24,DPD30-59,46,46,0
2024-12-10,24,DPD60-89,0,0,0
2024-12-10,24,DPD90+,0,0,0
2024-12-10,26,Current,0,0,0
2024-12-10,26,DPD15-29,16,16,0
2024-12-10,26,DPD3-14,17,17,0
2024-12-10,26,DPD30-59,11,11,0
2024-12-10,26,DPD60-89,0,0,0
2024-12-10,26,DPD90+,0,0,0
2024-12-10,32,Current,0,0,0
2024-12-10,32,DPD15-29,122,122,0
2024-12-10,32,DPD3-14,100,100,0
2024-12-10,32,DPD30-59,44,44,0
2024-12-10,32,DPD60-89,0,0,0
2024-12-10,32,DPD90+,0,0,0
2024-12-10,34,Current,0,0,0
2024-12-10,34,DPD15-29,37,37,0
2024-12-10,34,DPD3-14,47,47,0
2024-12-10,34,DPD30-59,20,20,0
2024-12-10,34,DPD60-89,0,0,0
2024-12-10,34,DPD90+,0,0,0
2024-12-10,36,Current,0,0,0
2024-12-10,36,DPD15-29,21,21,0
2024-12-10,36,DPD3-14,37,37,0
2024-12-10,36,DPD30-59,13,13,0
2024-12-10,36,DPD60-89,0,0,0
2024-12-10,36,DPD90+,0,0,0
2024-12-10,38,Current,9,9,0
2024-12-10,38,DPD15-29,24,24,0
2024-12-10,38,DPD3-14,27,27,0
2024-12-10,38,DPD30-59,12,12,0
2024-12-10,38,DPD60-89,0,0,0
2024-12-10,38,DPD90+,0,0,0
2024-12-10,40,Current,0,0,0
2024-12-10,40,DPD15-29,19,19,0
2024-12-10,40,DPD3-14,21,21,0
2024-12-10,40,DPD30-59,6,6,0
2024-12-10,40,DPD60-89,0,0,0
2024-12-10,40,DPD90+,0,0,0
2024-12-10,42,Current,0,0,0
2024-12-10,42,DPD15-29,8,8,0
2024-12-10,42,DPD3-14,6,6,0
2024-12-10,42,DPD30-59,3,3,0
2024-12-10,42,DPD60-89,0,0,0
2024-12-10,42,DPD90+,0,0,0
2024-12-10,44,Current,0,0,0
2024-12-10,44,DPD15-29,24,24,0
2024-12-10,44,DPD3-14,35,35,0
2024-12-10,44,DPD30-59,7,7,0
2024-12-10,44,DPD60-89,0,0,0
2024-12-10,44,DPD90+,0,0,0
2024-12-10,46,Current,0,0,0
2024-12-10,46,DPD3-14,0,0,0
2024-12-10,48,Current,12,12,0
2024-12-10,48,DPD15-29,19,19,0
2024-12-10,48,DPD3-14,27,27,0
2024-12-10,48,DPD30-59,6,6,0
2024-12-10,48,DPD60-89,0,0,0
2024-12-10,48,DPD90+,0,0,0
2024-12-10,6,Current,0,0,0
2024-12-09,100,Current,0,0,0
2024-12-09,100,DPD3-14,0,0,0
2024-12-09,100,DPD30-59,0,0,0
2024-12-09,102,Current,0,0,0
2024-12-09,102,DPD3-14,0,0,0
2024-12-09,102,DPD60-89,0,0,0
2024-12-09,104,Current,0,0,0
2024-12-09,20,Current,0,0,0
2024-12-09,20,DPD15-29,240,240,0
2024-12-09,20,DPD3-14,292,292,0
2024-12-09,20,DPD30-59,138,138,0
2024-12-09,20,DPD60-89,0,0,0
2024-12-09,20,DPD90+,0,0,0
2024-12-09,22,Current,0,0,0
2024-12-09,22,DPD15-29,1,1,0
2024-12-09,22,DPD60-89,0,0,0
2024-12-09,22,DPD90+,0,0,0
2024-12-09,24,Current,53,53,0
2024-12-09,24,DPD15-29,130,130,0
2024-12-09,24,DPD3-14,165,165,0
2024-12-09,24,DPD30-59,62,62,0
2024-12-09,24,DPD60-89,0,0,0
2024-12-09,24,DPD90+,0,0,0
2024-12-09,26,Current,1,1,0
2024-12-09,26,DPD15-29,14,14,0
2024-12-09,26,DPD3-14,22,22,0
2024-12-09,26,DPD30-59,5,5,0
2024-12-09,26,DPD60-89,0,0,0
2024-12-09,26,DPD90+,0,0,0
2024-12-09,32,Current,0,0,0
2024-12-09,32,DPD15-29,111,111,0
2024-12-09,32,DPD3-14,156,156,0
2024-12-09,32,DPD30-59,65,65,0
2024-12-09,32,DPD60-89,0,0,0
2024-12-09,32,DPD90+,0,0,0
2024-12-09,34,Current,0,0,0
2024-12-09,34,DPD15-29,44,44,0
2024-12-09,34,DPD3-14,45,45,0
2024-12-09,34,DPD30-59,23,23,0
2024-12-09,34,DPD60-89,0,0,0
2024-12-09,34,DPD90+,0,0,0
2024-12-09,36,Current,0,0,0
2024-12-09,36,DPD15-29,37,37,0
2024-12-09,36,DPD3-14,42,42,0
2024-12-09,36,DPD30-59,13,13,0
2024-12-09,36,DPD60-89,0,0,0
2024-12-09,36,DPD90+,0,0,0
2024-12-09,38,Current,9,9,0
2024-12-09,38,DPD15-29,35,35,0
2024-12-09,38,DPD3-14,44,44,0
2024-12-09,38,DPD30-59,10,10,0
2024-12-09,38,DPD60-89,0,0,0
2024-12-09,38,DPD90+,0,0,0
2024-12-09,40,Current,0,0,0
2024-12-09,40,DPD15-29,15,15,0
2024-12-09,40,DPD3-14,21,21,0
2024-12-09,40,DPD30-59,11,11,0
2024-12-09,40,DPD60-89,0,0,0
2024-12-09,40,DPD90+,0,0,0
2024-12-09,42,Current,0,0,0
2024-12-09,42,DPD15-29,12,12,0
2024-12-09,42,DPD3-14,19,19,0
2024-12-09,42,DPD30-59,4,4,0
2024-12-09,42,DPD60-89,0,0,0
2024-12-09,42,DPD90+,0,0,0
2024-12-09,44,Current,0,0,0
2024-12-09,44,DPD15-29,30,30,0
2024-12-09,44,DPD3-14,32,32,0
2024-12-09,44,DPD30-59,10,10,0
2024-12-09,44,DPD60-89,0,0,0
2024-12-09,44,DPD90+,0,0,0
2024-12-09,46,Current,0,0,0
2024-12-09,46,DPD3-14,1,1,0
2024-12-09,46,DPD30-59,2,2,0
2024-12-09,48,Current,33,33,0
2024-12-09,48,DPD15-29,25,25,0
2024-12-09,48,DPD3-14,31,31,0
2024-12-09,48,DPD30-59,9,9,0
2024-12-09,48,DPD60-89,0,0,0
2024-12-09,48,DPD90+,0,0,0
2024-12-09,6,Current,0,0,0
2024-12-08,100,Current,0,0,0
2024-12-08,100,DPD3-14,0,0,0
2024-12-08,100,DPD30-59,0,0,0
2024-12-08,102,Current,0,0,0
2024-12-08,102,DPD60-89,0,0,0
2024-12-08,104,Current,0,0,0
2024-12-08,20,Current,0,0,0
2024-12-08,20,DPD15-29,171,171,0
2024-12-08,20,DPD3-14,234,234,0
2024-12-08,20,DPD30-59,59,59,0
2024-12-08,20,DPD60-89,0,0,0
2024-12-08,20,DPD90+,0,0,0
2024-12-08,22,Current,0,0,0
2024-12-08,22,DPD15-29,0,0,0
2024-12-08,22,DPD30-59,0,0,0
2024-12-08,22,DPD60-89,0,0,0
2024-12-08,22,DPD90+,0,0,0
2024-12-08,24,Current,14,14,0
2024-12-08,24,DPD15-29,108,108,0
2024-12-08,24,DPD3-14,132,132,0
2024-12-08,24,DPD30-59,40,40,0
2024-12-08,24,DPD60-89,0,0,0
2024-12-08,24,DPD90+,0,0,0
2024-12-08,26,Current,0,0,0
2024-12-08,26,DPD15-29,14,14,0
2024-12-08,26,DPD3-14,18,18,0
2024-12-08,26,DPD30-59,3,3,0
2024-12-08,26,DPD60-89,0,0,0
2024-12-08,26,DPD90+,0,0,0
2024-12-08,32,Current,0,0,0
2024-12-08,32,DPD15-29,111,111,0
2024-12-08,32,DPD3-14,119,119,0
2024-12-08,32,DPD30-59,34,34,0
2024-12-08,32,DPD60-89,0,0,0
2024-12-08,32,DPD90+,0,0,0
2024-12-08,34,Current,0,0,0
2024-12-08,34,DPD15-29,33,33,0
2024-12-08,34,DPD3-14,47,47,0
2024-12-08,34,DPD30-59,11,11,0
2024-12-08,34,DPD60-89,0,0,0
2024-12-08,34,DPD90+,0,0,0
2024-12-08,36,Current,0,0,0
2024-12-08,36,DPD15-29,22,22,0
2024-12-08,36,DPD3-14,37,37,0
2024-12-08,36,DPD30-59,11,11,0
2024-12-08,36,DPD60-89,0,0,0
2024-12-08,36,DPD90+,0,0,0
2024-12-08,38,Current,2,2,0
2024-12-08,38,DPD15-29,24,24,0
2024-12-08,38,DPD3-14,32,32,0
2024-12-08,38,DPD30-59,5,5,0
2024-12-08,38,DPD60-89,0,0,0
2024-12-08,38,DPD90+,0,0,0
2024-12-08,40,Current,0,0,0
2024-12-08,40,DPD15-29,14,14,0
2024-12-08,40,DPD3-14,21,21,0
2024-12-08,40,DPD30-59,3,3,0
2024-12-08,40,DPD60-89,0,0,0
2024-12-08,40,DPD90+,0,0,0
2024-12-08,42,Current,0,0,0
2024-12-08,42,DPD15-29,7,7,0
2024-12-08,42,DPD3-14,10,10,0
2024-12-08,42,DPD30-59,3,3,0
2024-12-08,42,DPD60-89,0,0,0
2024-12-08,42,DPD90+,0,0,0
2024-12-08,44,Current,0,0,0
2024-12-08,44,DPD15-29,23,23,0
2024-12-08,44,DPD3-14,35,35,0
2024-12-08,44,DPD30-59,5,5,0
2024-12-08,44,DPD60-89,0,0,0
2024-12-08,44,DPD90+,0,0,0
2024-12-08,46,Current,0,0,0
2024-12-08,46,DPD3-14,0,0,0
2024-12-08,46,DPD30-59,0,0,0
2024-12-08,48,Current,9,9,0
2024-12-08,48,DPD15-29,13,13,0
2024-12-08,48,DPD3-14,30,30,0
2024-12-08,48,DPD30-59,7,7,0
2024-12-08,48,DPD60-89,0,0,0
2024-12-08,48,DPD90+,0,0,0
2024-12-08,6,Current,0,0,0
2024-12-07,100,Current,0,0,0
2024-12-07,100,DPD3-14,0,0,0
2024-12-07,100,DPD30-59,1,1,0
2024-12-07,102,Current,0,0,0
2024-12-07,102,DPD60-89,0,0,0
2024-12-07,104,Current,0,0,0
2024-12-07,20,Current,0,0,0
2024-12-07,20,DPD15-29,235,235,0
2024-12-07,20,DPD3-14,263,263,0
2024-12-07,20,DPD30-59,102,102,0
2024-12-07,20,DPD60-89,0,0,0
2024-12-07,20,DPD90+,0,0,0
2024-12-07,22,Current,0,0,0
2024-12-07,22,DPD15-29,1,1,0
2024-12-07,22,DPD30-59,0,0,0
2024-12-07,22,DPD60-89,0,0,0
2024-12-07,22,DPD90+,0,0,0
2024-12-07,24,Current,23,23,0
2024-12-07,24,DPD15-29,130,130,0
2024-12-07,24,DPD3-14,148,148,0
2024-12-07,24,DPD30-59,76,76,0
2024-12-07,24,DPD60-89,0,0,0
2024-12-07,24,DPD90+,0,0,0
2024-12-07,26,Current,0,0,0
2024-12-07,26,DPD15-29,11,11,0
2024-12-07,26,DPD3-14,20,20,0
2024-12-07,26,DPD30-59,1,1,0
2024-12-07,26,DPD60-89,0,0,0
2024-12-07,26,DPD90+,0,0,0
2024-12-07,32,Current,0,0,0
2024-12-07,32,DPD15-29,110,110,0
2024-12-07,32,DPD3-14,156,156,0
2024-12-07,32,DPD30-59,60,60,0
2024-12-07,32,DPD60-89,0,0,0
2024-12-07,32,DPD90+,0,0,0
2024-12-07,34,Current,0,0,0
2024-12-07,34,DPD15-29,39,39,0
2024-12-07,34,DPD3-14,49,49,0
2024-12-07,34,DPD30-59,21,21,0
2024-12-07,34,DPD60-89,0,0,0
2024-12-07,34,DPD90+,0,0,0
2024-12-07,36,Current,0,0,0
2024-12-07,36,DPD15-29,35,35,0
2024-12-07,36,DPD3-14,38,38,0
2024-12-07,36,DPD30-59,12,12,0
2024-12-07,36,DPD60-89,0,0,0
2024-12-07,36,DPD90+,0,0,0
2024-12-07,38,Current,9,9,0
2024-12-07,38,DPD15-29,27,27,0
2024-12-07,38,DPD3-14,45,45,0
2024-12-07,38,DPD30-59,8,8,0
2024-12-07,38,DPD60-89,0,0,0
2024-12-07,38,DPD90+,0,0,0
2024-12-07,40,Current,0,0,0
2024-12-07,40,DPD15-29,19,19,0
2024-12-07,40,DPD3-14,20,20,0
2024-12-07,40,DPD30-59,11,11,0
2024-12-07,40,DPD60-89,0,0,0
2024-12-07,40,DPD90+,0,0,0
2024-12-07,42,Current,0,0,0
2024-12-07,42,DPD15-29,13,13,0
2024-12-07,42,DPD3-14,17,17,0
2024-12-07,42,DPD30-59,7,7,0
2024-12-07,42,DPD60-89,0,0,0
2024-12-07,42,DPD90+,0,0,0
2024-12-07,44,Current,0,0,0
2024-12-07,44,DPD15-29,29,29,0
2024-12-07,44,DPD3-14,33,33,0
2024-12-07,44,DPD30-59,15,15,0
2024-12-07,44,DPD60-89,0,0,0
2024-12-07,44,DPD90+,0,0,0
2024-12-07,46,Current,0,0,0
2024-12-07,46,DPD3-14,1,1,0
2024-12-07,46,DPD30-59,0,0,0
2024-12-07,48,Current,14,14,0
2024-12-07,48,DPD15-29,25,25,0
2024-12-07,48,DPD3-14,27,27,0
2024-12-07,48,DPD30-59,9,9,0
2024-12-07,48,DPD60-89,0,0,0
2024-12-07,48,DPD90+,0,0,0
2024-12-07,6,Current,0,0,0
2024-12-06,100,Current,0,0,0
2024-12-06,100,DPD3-14,0,0,0
2024-12-06,100,DPD30-59,0,0,0
2024-12-06,102,Current,0,0,0
2024-12-06,102,DPD60-89,0,0,0
2024-12-06,104,Current,0,0,0
2024-12-06,20,Current,0,0,0
2024-12-06,20,DPD15-29,179,179,0
2024-12-06,20,DPD3-14,251,251,0
2024-12-06,20,DPD30-59,76,76,0
2024-12-06,20,DPD60-89,0,0,0
2024-12-06,20,DPD90+,0,0,0
2024-12-06,22,Current,0,0,0
2024-12-06,22,DPD15-29,0,0,0
2024-12-06,22,DPD30-59,1,1,0
2024-12-06,22,DPD60-89,0,0,0
2024-12-06,22,DPD90+,0,0,0
2024-12-06,24,Current,26,26,0
2024-12-06,24,DPD15-29,109,109,0
2024-12-06,24,DPD3-14,143,143,0
2024-12-06,24,DPD30-59,41,41,0
2024-12-06,24,DPD60-89,0,0,0
2024-12-06,24,DPD90+,0,0,0
2024-12-06,26,Current,0,0,0
2024-12-06,26,DPD15-29,12,12,0
2024-12-06,26,DPD3-14,20,20,0
2024-12-06,26,DPD30-59,10,10,0
2024-12-06,26,DPD60-89,0,0,0
2024-12-06,26,DPD90+,0,0,0
2024-12-06,32,Current,0,0,0
2024-12-06,32,DPD15-29,106,106,0
2024-12-06,32,DPD3-14,131,131,0
2024-12-06,32,DPD30-59,44,44,0
2024-12-06,32,DPD60-89,0,0,0
2024-12-06,32,DPD90+,0,0,0
2024-12-06,34,Current,0,0,0
2024-12-06,34,DPD15-29,33,33,0
2024-12-06,34,DPD3-14,44,44,0
2024-12-06,34,DPD30-59,20,20,0
2024-12-06,34,DPD60-89,0,0,0
2024-12-06,34,DPD90+,0,0,0
2024-12-06,36,Current,0,0,0
2024-12-06,36,DPD15-29,27,27,0
2024-12-06,36,DPD3-14,34,34,0
2024-12-06,36,DPD30-59,12,12,0
2024-12-06,36,DPD60-89,0,0,0
2024-12-06,36,DPD90+,0,0,0
2024-12-06,38,Current,4,4,0
2024-12-06,38,DPD15-29,24,24,0
2024-12-06,38,DPD3-14,39,39,0
2024-12-06,38,DPD30-59,11,11,0
2024-12-06,38,DPD60-89,0,0,0
2024-12-06,38,DPD90+,0,0,0
2024-12-06,40,Current,0,0,0
2024-12-06,40,DPD15-29,15,15,0
2024-12-06,40,DPD3-14,26,26,0
2024-12-06,40,DPD30-59,6,6,0
2024-12-06,40,DPD60-89,0,0,0
2024-12-06,40,DPD90+,0,0,0
2024-12-06,42,Current,0,0,0
2024-12-06,42,DPD15-29,6,6,0
2024-12-06,42,DPD3-14,11,11,0
2024-12-06,42,DPD30-59,3,3,0
2024-12-06,42,DPD60-89,0,0,0
2024-12-06,42,DPD90+,0,0,0
2024-12-06,44,Current,0,0,0
2024-12-06,44,DPD15-29,22,22,0
2024-12-06,44,DPD3-14,41,41,0
2024-12-06,44,DPD30-59,9,9,0
2024-12-06,44,DPD60-89,0,0,0
2024-12-06,44,DPD90+,0,0,0
2024-12-06,46,Current,0,0,0
2024-12-06,46,DPD15-29,0,0,0
2024-12-06,46,DPD3-14,0,0,0
2024-12-06,48,Current,10,10,0
2024-12-06,48,DPD15-29,16,16,0
2024-12-06,48,DPD3-14,30,30,0
2024-12-06,48,DPD30-59,8,8,0
2024-12-06,48,DPD60-89,0,0,0
2024-12-06,48,DPD90+,0,0,0
2024-12-06,6,Current,0,0,0
2024-12-05,100,Current,0,0,0
2024-12-05,100,DPD30-59,0,0,0
2024-12-05,102,Current,0,0,0
2024-12-05,102,DPD60-89,0,0,0
2024-12-05,104,Current,0,0,0
2024-12-05,20,Current,0,0,0
2024-12-05,20,DPD15-29,250,250,0
2024-12-05,20,DPD3-14,319,319,0
2024-12-05,20,DPD30-59,137,137,0
2024-12-05,20,DPD60-89,0,0,0
2024-12-05,20,DPD90+,0,0,0
2024-12-05,22,Current,0,0,0
2024-12-05,22,DPD15-29,1,1,0
2024-12-05,22,DPD30-59,0,0,0
2024-12-05,22,DPD60-89,0,0,0
2024-12-05,22,DPD90+,0,0,0
2024-12-05,24,Current,31,31,0
2024-12-05,24,DPD15-29,138,138,0
2024-12-05,24,DPD3-14,154,154,0
2024-12-05,24,DPD30-59,66,66,0
2024-12-05,24,DPD60-89,0,0,0
2024-12-05,24,DPD90+,0,0,0
2024-12-05,26,Current,0,0,0
2024-12-05,26,DPD15-29,16,16,0
2024-12-05,26,DPD3-14,19,19,0
2024-12-05,26,DPD30-59,6,6,0
2024-12-05,26,DPD60-89,0,0,0
2024-12-05,26,DPD90+,0,0,0
2024-12-05,32,Current,0,0,0
2024-12-05,32,DPD15-29,112,112,0
2024-12-05,32,DPD3-14,172,172,0
2024-12-05,32,DPD30-59,67,67,0
2024-12-05,32,DPD60-89,0,0,0
2024-12-05,32,DPD90+,0,0,0
2024-12-05,34,Current,0,0,0
2024-12-05,34,DPD15-29,40,40,0
2024-12-05,34,DPD3-14,61,61,0
2024-12-05,34,DPD30-59,22,22,0
2024-12-05,34,DPD60-89,0,0,0
2024-12-05,34,DPD90+,0,0,0
2024-12-05,36,Current,0,0,0
2024-12-05,36,DPD15-29,31,31,0
2024-12-05,36,DPD3-14,52,52,0
2024-12-05,36,DPD30-59,14,14,0
2024-12-05,36,DPD60-89,0,0,0
2024-12-05,36,DPD90+,0,0,0
2024-12-05,38,Current,6,6,0
2024-12-05,38,DPD15-29,33,33,0
2024-12-05,38,DPD3-14,56,56,0
2024-12-05,38,DPD30-59,13,13,0
2024-12-05,38,DPD60-89,0,0,0
2024-12-05,38,DPD90+,0,0,0
2024-12-05,40,Current,0,0,0
2024-12-05,40,DPD15-29,21,21,0
2024-12-05,40,DPD3-14,23,23,0
2024-12-05,40,DPD30-59,9,9,0
2024-12-05,40,DPD60-89,0,0,0
2024-12-05,40,DPD90+,0,0,0
2024-12-05,42,Current,0,0,0
2024-12-05,42,DPD15-29,13,13,0
2024-12-05,42,DPD3-14,22,22,0
2024-12-05,42,DPD30-59,6,6,0
2024-12-05,42,DPD60-89,0,0,0
2024-12-05,42,DPD90+,0,0,0
2024-12-05,44,Current,0,0,0
2024-12-05,44,DPD15-29,34,34,0
2024-12-05,44,DPD3-14,37,37,0
2024-12-05,44,DPD30-59,8,8,0
2024-12-05,44,DPD60-89,0,0,0
2024-12-05,44,DPD90+,0,0,0
2024-12-05,46,Current,0,0,0
2024-12-05,46,DPD15-29,2,2,0
2024-12-05,46,DPD3-14,1,1,0
2024-12-05,48,Current,8,8,0
2024-12-05,48,DPD15-29,30,30,0
2024-12-05,48,DPD3-14,39,39,0
2024-12-05,48,DPD30-59,8,8,0
2024-12-05,48,DPD60-89,0,0,0
2024-12-05,48,DPD90+,0,0,0
2024-12-05,6,Current,0,0,0
2024-12-04,100,Current,0,0,0
2024-12-04,100,DPD15-29,0,0,0
2024-12-04,102,Current,0,0,0
2024-12-04,102,DPD60-89,0,0,0
2024-12-04,104,Current,0,0,0
2024-12-04,20,Current,0,0,0
2024-12-04,20,DPD15-29,147,147,0
2024-12-04,20,DPD3-14,288,288,0
2024-12-04,20,DPD30-59,69,69,0
2024-12-04,20,DPD60-89,0,0,0
2024-12-04,20,DPD90+,0,0,0
2024-12-04,22,Current,0,0,0
2024-12-04,22,DPD15-29,0,0,0
2024-12-04,22,DPD60-89,0,0,0
2024-12-04,22,DPD90+,0,0,0
2024-12-04,24,Current,22,22,0
2024-12-04,24,DPD15-29,101,101,0
2024-12-04,24,DPD3-14,162,162,0
2024-12-04,24,DPD30-59,37,37,0
2024-12-04,24,DPD60-89,0,0,0
2024-12-04,24,DPD90+,0,0,0
2024-12-04,26,Current,0,0,0
2024-12-04,26,DPD15-29,10,10,0
2024-12-04,26,DPD3-14,27,27,0
2024-12-04,26,DPD30-59,3,3,0
2024-12-04,26,DPD60-89,0,0,0
2024-12-04,26,DPD90+,0,0,0
2024-12-04,32,Current,0,0,0
2024-12-04,32,DPD15-29,85,85,0
2024-12-04,32,DPD3-14,149,149,0
2024-12-04,32,DPD30-59,36,36,0
2024-12-04,32,DPD60-89,0,0,0
2024-12-04,32,DPD90+,0,0,0
2024-12-04,34,Current,0,0,0
2024-12-04,34,DPD15-29,32,32,0
2024-12-04,34,DPD3-14,56,56,0
2024-12-04,34,DPD30-59,11,11,0
2024-12-04,34,DPD60-89,0,0,0
2024-12-04,34,DPD90+,0,0,0
2024-12-04,36,Current,0,0,0
2024-12-04,36,DPD15-29,21,21,0
2024-12-04,36,DPD3-14,43,43,0
2024-12-04,36,DPD30-59,9,9,0
2024-12-04,36,DPD60-89,0,0,0
2024-12-04,36,DPD90+,0,0,0
2024-12-04,38,Current,3,3,0
2024-12-04,38,DPD15-29,21,21,0
2024-12-04,38,DPD3-14,46,46,0
2024-12-04,38,DPD30-59,5,5,0
2024-12-04,38,DPD60-89,0,0,0
2024-12-04,38,DPD90+,0,0,0
2024-12-04,40,Current,0,0,0
2024-12-04,40,DPD15-29,13,13,0
2024-12-04,40,DPD3-14,32,32,0
2024-12-04,40,DPD30-59,4,4,0
2024-12-04,40,DPD60-89,0,0,0
2024-12-04,40,DPD90+,0,0,0
2024-12-04,42,Current,0,0,0
2024-12-04,42,DPD15-29,5,5,0
2024-12-04,42,DPD3-14,11,11,0
2024-12-04,42,DPD30-59,3,3,0
2024-12-04,42,DPD60-89,0,0,0
2024-12-04,42,DPD90+,0,0,0
2024-12-04,44,Current,0,0,0
2024-12-04,44,DPD15-29,19,19,0
2024-12-04,44,DPD3-14,36,36,0
2024-12-04,44,DPD30-59,5,5,0
2024-12-04,44,DPD60-89,0,0,0
2024-12-04,44,DPD90+,0,0,0
2024-12-04,46,Current,0,0,0
2024-12-04,46,DPD15-29,0,0,0
2024-12-04,46,DPD3-14,0,0,0
2024-12-04,48,Current,9,9,0
2024-12-04,48,DPD15-29,14,14,0
2024-12-04,48,DPD3-14,31,31,0
2024-12-04,48,DPD30-59,8,8,0
2024-12-04,48,DPD60-89,0,0,0
2024-12-04,48,DPD90+,0,0,0
2024-12-04,6,DPD3-14,0,0,0
2024-12-03,100,Current,0,0,0
2024-12-03,100,DPD15-29,0,0,0
2024-12-03,102,Current,0,0,0
2024-12-03,102,DPD60-89,0,0,0
2024-12-03,104,Current,0,0,0
2024-12-03,20,Current,0,0,0
2024-12-03,20,DPD15-29,217,217,0
2024-12-03,20,DPD3-14,252,252,0
2024-12-03,20,DPD30-59,125,125,0
2024-12-03,20,DPD60-89,0,0,0
2024-12-03,20,DPD90+,0,0,0
2024-12-03,22,Current,0,0,0
2024-12-03,22,DPD3-14,1,1,0
2024-12-03,22,DPD60-89,0,0,0
2024-12-03,22,DPD90+,0,0,0
2024-12-03,24,Current,76,76,0
2024-12-03,24,DPD15-29,114,114,0
2024-12-03,24,DPD3-14,142,142,0
2024-12-03,24,DPD30-59,83,83,0
2024-12-03,24,DPD60-89,0,0,0
2024-12-03,24,DPD90+,0,0,0
2024-12-03,26,Current,0,0,0
2024-12-03,26,DPD15-29,15,15,0
2024-12-03,26,DPD3-14,16,16,0
2024-12-03,26,DPD30-59,2,2,0
2024-12-03,26,DPD60-89,0,0,0
2024-12-03,26,DPD90+,0,0,0
2024-12-03,32,Current,0,0,0
2024-12-03,32,DPD15-29,104,104,0
2024-12-03,32,DPD3-14,135,135,0
2024-12-03,32,DPD30-59,67,67,0
2024-12-03,32,DPD60-89,0,0,0
2024-12-03,32,DPD90+,0,0,0
2024-12-03,34,Current,0,0,0
2024-12-03,34,DPD15-29,38,38,0
2024-12-03,34,DPD3-14,48,48,0
2024-12-03,34,DPD30-59,19,19,0
2024-12-03,34,DPD60-89,0,0,0
2024-12-03,34,DPD90+,0,0,0
2024-12-03,36,Current,0,0,0
2024-12-03,36,DPD15-29,26,26,0
2024-12-03,36,DPD3-14,40,40,0
2024-12-03,36,DPD30-59,19,19,0
2024-12-03,36,DPD60-89,0,0,0
2024-12-03,36,DPD90+,0,0,0
2024-12-03,38,Current,17,17,0
2024-12-03,38,DPD15-29,28,28,0
2024-12-03,38,DPD3-14,46,46,0
2024-12-03,38,DPD30-59,10,10,0
2024-12-03,38,DPD60-89,0,0,0
2024-12-03,38,DPD90+,0,0,0
2024-12-03,40,Current,0,0,0
2024-12-03,40,DPD15-29,17,17,0
2024-12-03,40,DPD3-14,15,15,0
2024-12-03,40,DPD30-59,12,12,0
2024-12-03,40,DPD60-89,0,0,0
2024-12-03,40,DPD90+,0,0,0
2024-12-03,42,Current,0,0,0
2024-12-03,42,DPD15-29,11,11,0
2024-12-03,42,DPD3-14,17,17,0
2024-12-03,42,DPD30-59,6,6,0
2024-12-03,42,DPD60-89,0,0,0
2024-12-03,42,DPD90+,0,0,0
2024-12-03,44,Current,0,0,0
2024-12-03,44,DPD15-29,23,23,0
2024-12-03,44,DPD3-14,32,32,0
2024-12-03,44,DPD30-59,16,16,0
2024-12-03,44,DPD60-89,0,0,0
2024-12-03,44,DPD90+,0,0,0
2024-12-03,46,Current,0,0,0
2024-12-03,46,DPD15-29,2,2,0
2024-12-03,48,Current,49,49,0
2024-12-03,48,DPD15-29,25,25,0
2024-12-03,48,DPD3-14,35,35,0
2024-12-03,48,DPD30-59,12,12,0
2024-12-03,48,DPD60-89,0,0,0
2024-12-03,48,DPD90+,0,0,0
2024-12-03,6,DPD3-14,1,1,0
2024-12-02,100,Current,0,0,0
2024-12-02,100,DPD15-29,0,0,0
2024-12-02,102,Current,0,0,0
2024-12-02,102,DPD60-89,0,0,0
2024-12-02,104,Current,0,0,0
2024-12-02,20,Current,0,0,0
2024-12-02,20,DPD15-29,167,167,0
2024-12-02,20,DPD3-14,397,397,0
2024-12-02,20,DPD30-59,82,82,0
2024-12-02,20,DPD60-89,0,0,0
2024-12-02,20,DPD90+,0,0,0
2024-12-02,22,Current,0,0,0
2024-12-02,22,DPD3-14,1,1,0
2024-12-02,22,DPD60-89,0,0,0
2024-12-02,22,DPD90+,0,0,0
2024-12-02,24,Current,41,41,0
2024-12-02,24,DPD15-29,103,103,0
2024-12-02,24,DPD3-14,223,223,0
2024-12-02,24,DPD30-59,46,46,0
2024-12-02,24,DPD60-89,0,0,0
2024-12-02,24,DPD90+,0,0,0
2024-12-02,26,Current,0,0,0
2024-12-02,26,DPD15-29,10,10,0
2024-12-02,26,DPD3-14,39,39,0
2024-12-02,26,DPD30-59,10,10,0
2024-12-02,26,DPD60-89,0,0,0
2024-12-02,26,DPD90+,0,0,0
2024-12-02,32,Current,0,0,0
2024-12-02,32,DPD15-29,73,73,0
2024-12-02,32,DPD3-14,206,206,0
2024-12-02,32,DPD30-59,51,51,0
2024-12-02,32,DPD60-89,0,0,0
2024-12-02,32,DPD90+,0,0,0
2024-12-02,34,Current,0,0,0
2024-12-02,34,DPD15-29,36,36,0
2024-12-02,34,DPD3-14,73,73,0
2024-12-02,34,DPD30-59,21,21,0
2024-12-02,34,DPD60-89,0,0,0
2024-12-02,34,DPD90+,0,0,0
2024-12-02,36,Current,0,0,0
2024-12-02,36,DPD15-29,16,16,0
2024-12-02,36,DPD3-14,58,58,0
2024-12-02,36,DPD30-59,16,16,0
2024-12-02,36,DPD60-89,0,0,0
2024-12-02,36,DPD90+,0,0,0
2024-12-02,38,Current,9,9,0
2024-12-02,38,DPD15-29,21,21,0
2024-12-02,38,DPD3-14,61,61,0
2024-12-02,38,DPD30-59,11,11,0
2024-12-02,38,DPD60-89,0,0,0
2024-12-02,38,DPD90+,0,0,0
2024-12-02,40,Current,0,0,0
2024-12-02,40,DPD15-29,14,14,0
2024-12-02,40,DPD3-14,49,49,0
2024-12-02,40,DPD30-59,4,4,0
2024-12-02,40,DPD60-89,0,0,0
2024-12-02,40,DPD90+,0,0,0
2024-12-02,42,Current,0,0,0
2024-12-02,42,DPD15-29,5,5,0
2024-12-02,42,DPD3-14,20,20,0
2024-12-02,42,DPD30-59,5,5,0
2024-12-02,42,DPD60-89,0,0,0
2024-12-02,42,DPD90+,0,0,0
2024-12-02,44,Current,0,0,0
2024-12-02,44,DPD15-29,22,22,0
2024-12-02,44,DPD3-14,58,58,0
2024-12-02,44,DPD30-59,9,9,0
2024-12-02,44,DPD60-89,0,0,0
2024-12-02,44,DPD90+,0,0,0
2024-12-02,46,Current,0,0,0
2024-12-02,46,DPD15-29,0,0,0
2024-12-02,46,DPD3-14,1,1,0
2024-12-02,48,Current,21,21,0
2024-12-02,48,DPD15-29,20,20,0
2024-12-02,48,DPD3-14,47,47,0
2024-12-02,48,DPD30-59,8,8,0
2024-12-02,48,DPD60-89,0,0,0
2024-12-02,48,DPD90+,0,0,0
2024-12-02,6,DPD3-14,0,0,0
2024-12-01,100,Current,0,0,0
2024-12-01,100,DPD15-29,0,0,0
2024-12-01,100,DPD3-14,0,0,0
2024-12-01,102,Current,0,0,0
2024-12-01,102,DPD60-89,0,0,0
2024-12-01,104,Current,0,0,0
2024-12-01,20,Current,3775,3775,0
2024-12-01,20,DPD15-29,292,292,0
2024-12-01,20,DPD3-14,380,380,0
2024-12-01,20,DPD30-59,140,140,0
2024-12-01,20,DPD60-89,53,53,0
2024-12-01,20,DPD90+,24,24,0
2024-12-01,22,Current,0,0,0
2024-12-01,22,DPD3-14,1,1,0
2024-12-01,22,DPD60-89,0,0,0
2024-12-01,22,DPD90+,0,0,0
2024-12-01,24,Current,4754,4754,0
2024-12-01,24,DPD15-29,163,163,0
2024-12-01,24,DPD3-14,246,246,0
2024-12-01,24,DPD30-59,85,85,0
2024-12-01,24,DPD60-89,18,18,0
2024-12-01,24,DPD90+,20,20,0
2024-12-01,26,Current,0,0,0
2024-12-01,26,DPD15-29,14,14,0
2024-12-01,26,DPD3-14,19,19,0
2024-12-01,26,DPD30-59,4,4,0
2024-12-01,26,DPD60-89,0,0,0
2024-12-01,26,DPD90+,0,0,0
2024-12-01,32,Current,186,186,0
2024-12-01,32,DPD15-29,113,113,0
2024-12-01,32,DPD3-14,161,161,0
2024-12-01,32,DPD30-59,44,44,0
2024-12-01,32,DPD60-89,3,3,0
2024-12-01,32,DPD90+,1,1,0
2024-12-01,34,Current,0,0,0
2024-12-01,34,DPD15-29,38,38,0
2024-12-01,34,DPD3-14,52,52,0
2024-12-01,34,DPD30-59,11,11,0
2024-12-01,34,DPD60-89,0,0,0
2024-12-01,34,DPD90+,0,0,0
2024-12-01,36,Current,206,206,0
2024-12-01,36,DPD15-29,32,32,0
2024-12-01,36,DPD3-14,43,43,0
2024-12-01,36,DPD30-59,12,12,0
2024-12-01,36,DPD60-89,2,2,0
2024-12-01,36,DPD90+,0,0,0
2024-12-01,38,Current,264,264,0
2024-12-01,38,DPD15-29,30,30,0
2024-12-01,38,DPD3-14,50,50,0
2024-12-01,38,DPD30-59,12,12,0
2024-12-01,38,DPD60-89,0,0,0
2024-12-01,38,DPD90+,0,0,0
2024-12-01,40,Current,230,230,0
2024-12-01,40,DPD15-29,22,22,0
2024-12-01,40,DPD3-14,27,27,0
2024-12-01,40,DPD30-59,7,7,0
2024-12-01,40,DPD60-89,1,1,0
2024-12-01,40,DPD90+,2,2,0
2024-12-01,42,Current,0,0,0
2024-12-01,42,DPD15-29,13,13,0
2024-12-01,42,DPD3-14,17,17,0
2024-12-01,42,DPD30-59,4,4,0
2024-12-01,42,DPD60-89,0,0,0
2024-12-01,42,DPD90+,0,0,0
2024-12-01,44,Current,153,153,0
2024-12-01,44,DPD15-29,28,28,0
2024-12-01,44,DPD3-14,41,41,0
2024-12-01,44,DPD30-59,10,10,0
2024-12-01,44,DPD60-89,1,1,0
2024-12-01,44,DPD90+,0,0,0
2024-12-01,46,Current,4,4,0
2024-12-01,46,DPD15-29,2,2,0
2024-12-01,46,DPD3-14,0,0,0
2024-12-01,48,Current,4556,4556,0
2024-12-01,48,DPD15-29,58,58,0
2024-12-01,48,DPD3-14,101,101,0
2024-12-01,48,DPD30-59,29,29,0
2024-12-01,48,DPD60-89,33,33,0
2024-12-01,48,DPD90+,12,12,0
2024-12-01,6,DPD3-14,1,1,0
2024-11-30,100,Current,0,0,0
2024-11-30,100,DPD15-29,0,0,0
2024-11-30,100,DPD3-14,1,1,0
2024-11-30,102,Current,0,0,0
2024-11-30,102,DPD60-89,0,0,0
2024-11-30,104,Current,0,0,0
2024-11-30,20,Current,0,0,0
2024-11-30,20,DPD15-29,137,137,0
2024-11-30,20,DPD3-14,298,298,0
2024-11-30,20,DPD30-59,73,73,0
2024-11-30,20,DPD60-89,0,0,0
2024-11-30,20,DPD90+,0,0,0
2024-11-30,22,Current,0,0,0
2024-11-30,22,DPD3-14,0,0,0
2024-11-30,22,DPD60-89,0,0,0
2024-11-30,22,DPD90+,0,0,0
2024-11-30,24,Current,47,47,0
2024-11-30,24,DPD15-29,81,81,0
2024-11-30,24,DPD3-14,177,177,0
2024-11-30,24,DPD30-59,34,34,0
2024-11-30,24,DPD60-89,0,0,0
2024-11-30,24,DPD90+,0,0,0
2024-11-30,26,Current,0,0,0
2024-11-30,26,DPD15-29,6,6,0
2024-11-30,26,DPD3-14,26,26,0
2024-11-30,26,DPD30-59,3,3,0
2024-11-30,26,DPD60-89,0,0,0
2024-11-30,26,DPD90+,0,0,0
2024-11-30,32,Current,0,0,0
2024-11-30,32,DPD15-29,50,50,0
2024-11-30,32,DPD3-14,158,158,0
2024-11-30,32,DPD30-59,36,36,0
2024-11-30,32,DPD60-89,0,0,0
2024-11-30,32,DPD90+,0,0,0
2024-11-30,34,Current,0,0,0
2024-11-30,34,DPD15-29,24,24,0
2024-11-30,34,DPD3-14,51,51,0
2024-11-30,34,DPD30-59,13,13,0
2024-11-30,34,DPD60-89,0,0,0
2024-11-30,34,DPD90+,0,0,0
2024-11-30,36,Current,0,0,0
2024-11-30,36,DPD15-29,13,13,0
2024-11-30,36,DPD3-14,32,32,0
2024-11-30,36,DPD30-59,7,7,0
2024-11-30,36,DPD60-89,0,0,0
2024-11-30,36,DPD90+,0,0,0
2024-11-30,38,Current,9,9,0
2024-11-30,38,DPD15-29,15,15,0
2024-11-30,38,DPD3-14,47,47,0
2024-11-30,38,DPD30-59,5,5,0
2024-11-30,38,DPD60-89,0,0,0
2024-11-30,38,DPD90+,0,0,0
2024-11-30,40,Current,0,0,0
2024-11-30,40,DPD15-29,10,10,0
2024-11-30,40,DPD3-14,38,38,0
2024-11-30,40,DPD30-59,5,5,0
2024-11-30,40,DPD60-89,0,0,0
2024-11-30,40,DPD90+,0,0,0
2024-11-30,42,Current,0,0,0
2024-11-30,42,DPD15-29,6,6,0
2024-11-30,42,DPD3-14,15,15,0
2024-11-30,42,DPD30-59,3,3,0
2024-11-30,42,DPD60-89,0,0,0
2024-11-30,42,DPD90+,0,0,0
2024-11-30,44,Current,0,0,0
2024-11-30,44,DPD15-29,18,18,0
2024-11-30,44,DPD3-14,44,44,0
2024-11-30,44,DPD30-59,3,3,0
2024-11-30,44,DPD60-89,0,0,0
2024-11-30,44,DPD90+,0,0,0
2024-11-30,46,Current,0,0,0
2024-11-30,46,DPD15-29,0,0,0
2024-11-30,46,DPD3-14,1,1,0
2024-11-30,48,Current,20,20,0
2024-11-30,48,DPD15-29,16,16,0
2024-11-30,48,DPD3-14,35,35,0
2024-11-30,48,DPD30-59,9,9,0
2024-11-30,48,DPD60-89,0,0,0
2024-11-30,48,DPD90+,0,0,0
2024-11-30,6,DPD3-14,0,0,0
2024-11-29,100,Current,0,0,0
2024-11-29,100,DPD15-29,0,0,0
2024-11-29,100,DPD3-14,0,0,0
2024-11-29,102,Current,0,0,0
2024-11-29,102,DPD60-89,0,0,0
2024-11-29,104,Current,0,0,0
2024-11-29,20,Current,0,0,0
2024-11-29,20,DPD15-29,182,182,0
2024-11-29,20,DPD3-14,306,306,0
2024-11-29,20,DPD30-59,135,135,0
2024-11-29,20,DPD60-89,0,0,0
2024-11-29,20,DPD90+,0,0,0
2024-11-29,22,Current,0,0,0
2024-11-29,22,DPD3-14,1,1,0
2024-11-29,22,DPD60-89,0,0,0
2024-11-29,22,DPD90+,0,0,0
2024-11-29,24,Current,57,57,0
2024-11-29,24,DPD15-29,89,89,0
2024-11-29,24,DPD3-14,184,184,0
2024-11-29,24,DPD30-59,77,77,0
2024-11-29,24,DPD60-89,0,0,0
2024-11-29,24,DPD90+,0,0,0
2024-11-29,26,Current,0,0,0
2024-11-29,26,DPD15-29,9,9,0
2024-11-29,26,DPD3-14,23,23,0
2024-11-29,26,DPD30-59,4,4,0
2024-11-29,26,DPD60-89,0,0,0
2024-11-29,26,DPD90+,0,0,0
2024-11-29,32,Current,0,0,0
2024-11-29,32,DPD15-29,85,85,0
2024-11-29,32,DPD3-14,157,157,0
2024-11-29,32,DPD30-59,70,70,0
2024-11-29,32,DPD60-89,0,0,0
2024-11-29,32,DPD90+,0,0,0
2024-11-29,34,Current,0,0,0
2024-11-29,34,DPD15-29,28,28,0
2024-11-29,34,DPD3-14,60,60,0
2024-11-29,34,DPD30-59,22,22,0
2024-11-29,34,DPD60-89,0,0,0
2024-11-29,34,DPD90+,0,0,0
2024-11-29,36,Current,0,0,0
2024-11-29,36,DPD15-29,22,22,0
2024-11-29,36,DPD3-14,46,46,0
2024-11-29,36,DPD30-59,15,15,0
2024-11-29,36,DPD60-89,0,0,0
2024-11-29,36,DPD90+,0,0,0
2024-11-29,38,Current,9,9,0
2024-11-29,38,DPD15-29,17,17,0
2024-11-29,38,DPD3-14,63,63,0
2024-11-29,38,DPD30-59,16,16,0
2024-11-29,38,DPD60-89,0,0,0
2024-11-29,38,DPD90+,0,0,0
2024-11-29,40,Current,0,0,0
2024-11-29,40,DPD15-29,15,15,0
2024-11-29,40,DPD3-14,29,29,0
2024-11-29,40,DPD30-59,10,10,0
2024-11-29,40,DPD60-89,0,0,0
2024-11-29,40,DPD90+,0,0,0
2024-11-29,42,Current,0,0,0
2024-11-29,42,DPD15-29,10,10,0
2024-11-29,42,DPD3-14,14,14,0
2024-11-29,42,DPD30-59,5,5,0
2024-11-29,42,DPD60-89,0,0,0
2024-11-29,42,DPD90+,0,0,0
2024-11-29,44,Current,0,0,0
2024-11-29,44,DPD15-29,20,20,0
2024-11-29,44,DPD3-14,42,42,0
2024-11-29,44,DPD30-59,17,17,0
2024-11-29,44,DPD60-89,0,0,0
2024-11-29,44,DPD90+,0,0,0
2024-11-29,46,Current,0,0,0
2024-11-29,46,DPD15-29,2,2,0
2024-11-29,46,DPD3-14,0,0,0
2024-11-29,48,Current,27,27,0
2024-11-29,48,DPD15-29,18,18,0
2024-11-29,48,DPD3-14,38,38,0
2024-11-29,48,DPD30-59,13,13,0
2024-11-29,48,DPD60-89,0,0,0
2024-11-29,48,DPD90+,0,0,0
2024-11-29,6,Current,0,0,0
2024-11-28,100,Current,0,0,0
2024-11-28,100,DPD15-29,0,0,0
2024-11-28,102,Current,0,0,0
2024-11-28,102,DPD60-89,0,0,0
2024-11-28,104,Current,0,0,0
2024-11-28,20,Current,0,0,0
2024-11-28,20,DPD15-29,126,126,0
2024-11-28,20,DPD3-14,277,277,0
2024-11-28,20,DPD30-59,71,71,0
2024-11-28,20,DPD60-89,0,0,0
2024-11-28,20,DPD90+,0,0,0
2024-11-28,22,Current,0,0,0
2024-11-28,22,DPD3-14,1,1,0
2024-11-28,22,DPD60-89,0,0,0
2024-11-28,22,DPD90+,0,0,0
2024-11-28,24,Current,67,67,0
2024-11-28,24,DPD15-29,71,71,0
2024-11-28,24,DPD3-14,173,173,0
2024-11-28,24,DPD30-59,39,39,0
2024-11-28,24,DPD60-89,0,0,0
2024-11-28,24,DPD90+,0,0,0
2024-11-28,26,Current,0,0,0
2024-11-28,26,DPD15-29,5,5,0
2024-11-28,26,DPD3-14,25,25,0
2024-11-28,26,DPD30-59,7,7,0
2024-11-28,26,DPD60-89,0,0,0
2024-11-28,26,DPD90+,0,0,0
2024-11-28,32,Current,0,0,0
2024-11-28,32,DPD15-29,38,38,0
2024-11-28,32,DPD3-14,145,145,0
2024-11-28,32,DPD30-59,47,47,0
2024-11-28,32,DPD60-89,0,0,0
2024-11-28,32,DPD90+,0,0,0
2024-11-28,34,Current,0,0,0
2024-11-28,34,DPD15-29,22,22,0
2024-11-28,34,DPD3-14,52,52,0
2024-11-28,34,DPD30-59,20,20,0
2024-11-28,34,DPD60-89,0,0,0
2024-11-28,34,DPD90+,0,0,0
2024-11-28,36,Current,0,0,0
2024-11-28,36,DPD15-29,11,11,0
2024-11-28,36,DPD3-14,33,33,0
2024-11-28,36,DPD30-59,18,18,0
2024-11-28,36,DPD60-89,0,0,0
2024-11-28,36,DPD90+,0,0,0
2024-11-28,38,Current,15,15,0
2024-11-28,38,DPD15-29,12,12,0
2024-11-28,38,DPD3-14,39,39,0
2024-11-28,38,DPD30-59,12,12,0
2024-11-28,38,DPD60-89,0,0,0
2024-11-28,38,DPD90+,0,0,0
2024-11-28,40,Current,0,0,0
2024-11-28,40,DPD15-29,10,10,0
2024-11-28,40,DPD3-14,36,36,0
2024-11-28,40,DPD30-59,4,4,0
2024-11-28,40,DPD60-89,0,0,0
2024-11-28,40,DPD90+,0,0,0
2024-11-28,42,Current,0,0,0
2024-11-28,42,DPD15-29,5,5,0
2024-11-28,42,DPD3-14,13,13,0
2024-11-28,42,DPD30-59,3,3,0
2024-11-28,42,DPD60-89,0,0,0
2024-11-28,42,DPD90+,0,0,0
2024-11-28,44,Current,0,0,0
2024-11-28,44,DPD15-29,16,16,0
2024-11-28,44,DPD3-14,39,39,0
2024-11-28,44,DPD30-59,9,9,0
2024-11-28,44,DPD60-89,0,0,0
2024-11-28,44,DPD90+,0,0,0
2024-11-28,46,Current,0,0,0
2024-11-28,46,DPD15-29,0,0,0
2024-11-28,46,DPD3-14,1,1,0
2024-11-28,48,Current,32,32,0
2024-11-28,48,DPD15-29,12,12,0
2024-11-28,48,DPD3-14,36,36,0
2024-11-28,48,DPD30-59,7,7,0
2024-11-28,48,DPD60-89,0,0,0
2024-11-28,48,DPD90+,0,0,0
2024-11-28,6,Current,0,0,0
2024-11-27,100,Current,0,0,0
2024-11-27,100,DPD15-29,0,0,0
2024-11-27,102,Current,0,0,0
2024-11-27,102,DPD60-89,0,0,0
2024-11-27,104,Current,0,0,0
2024-11-27,20,Current,0,0,0
2024-11-27,20,DPD15-29,207,207,0
2024-11-27,20,DPD3-14,286,286,0
2024-11-27,20,DPD30-59,94,94,0
2024-11-27,20,DPD60-89,0,0,0
2024-11-27,20,DPD90+,0,0,0
2024-11-27,22,Current,0,0,0
2024-11-27,22,DPD3-14,1,1,0
2024-11-27,22,DPD60-89,0,0,0
2024-11-27,22,DPD90+,0,0,0
2024-11-27,24,Current,20,20,0
2024-11-27,24,DPD15-29,106,106,0
2024-11-27,24,DPD3-14,159,159,0
2024-11-27,24,DPD30-59,65,65,0
2024-11-27,24,DPD60-89,0,0,0
2024-11-27,24,DPD90+,0,0,0
2024-11-27,26,Current,0,0,0
2024-11-27,26,DPD15-29,10,10,0
2024-11-27,26,DPD3-14,24,24,0
2024-11-27,26,DPD30-59,6,6,0
2024-11-27,26,DPD60-89,0,0,0
2024-11-27,26,DPD90+,0,0,0
2024-11-27,32,Current,0,0,0
2024-11-27,32,DPD15-29,100,100,0
2024-11-27,32,DPD3-14,133,133,0
2024-11-27,32,DPD30-59,55,55,0
2024-11-27,32,DPD60-89,0,0,0
2024-11-27,32,DPD90+,0,0,0
2024-11-27,34,Current,0,0,0
2024-11-27,34,DPD15-29,33,33,0
2024-11-27,34,DPD3-14,59,59,0
2024-11-27,34,DPD30-59,16,16,0
2024-11-27,34,DPD60-89,0,0,0
2024-11-27,34,DPD90+,0,0,0
2024-11-27,36,Current,0,0,0
2024-11-27,36,DPD15-29,23,23,0
2024-11-27,36,DPD3-14,45,45,0
2024-11-27,36,DPD30-59,13,13,0
2024-11-27,36,DPD60-89,0,0,0
2024-11-27,36,DPD90+,0,0,0
2024-11-27,38,Current,3,3,0
2024-11-27,38,DPD15-29,22,22,0
2024-11-27,38,DPD3-14,63,63,0
2024-11-27,38,DPD30-59,16,16,0
2024-11-27,38,DPD60-89,0,0,0
2024-11-27,38,DPD90+,0,0,0
2024-11-27,40,Current,0,0,0
2024-11-27,40,DPD15-29,18,18,0
2024-11-27,40,DPD3-14,24,24,0
2024-11-27,40,DPD30-59,7,7,0
2024-11-27,40,DPD60-89,0,0,0
2024-11-27,40,DPD90+,0,0,0
2024-11-27,42,Current,0,0,0
2024-11-27,42,DPD15-29,6,6,0
2024-11-27,42,DPD3-14,20,20,0
2024-11-27,42,DPD30-59,5,5,0
2024-11-27,42,DPD60-89,0,0,0
2024-11-27,42,DPD90+,0,0,0
2024-11-27,44,Current,0,0,0
2024-11-27,44,DPD15-29,21,21,0
2024-11-27,44,DPD3-14,31,31,0
2024-11-27,44,DPD30-59,11,11,0
2024-11-27,44,DPD60-89,0,0,0
2024-11-27,44,DPD90+,0,0,0
2024-11-27,46,Current,0,0,0
2024-11-27,46,DPD15-29,2,2,0
2024-11-27,46,DPD3-14,0,0,0
2024-11-27,48,Current,14,14,0
2024-11-27,48,DPD15-29,17,17,0
2024-11-27,48,DPD3-14,41,41,0
2024-11-27,48,DPD30-59,11,11,0
2024-11-27,48,DPD60-89,0,0,0
2024-11-27,48,DPD90+,0,0,0
2024-11-27,6,Current,0,0,0
2024-11-26,100,Current,0,0,0
2024-11-26,100,DPD15-29,0,0,0
2024-11-26,102,Current,0,0,0
2024-11-26,102,DPD60-89,0,0,0
2024-11-26,104,Current,0,0,0
2024-11-26,20,Current,2,2,0
2024-11-26,20,DPD15-29,140,140,0
2024-11-26,20,DPD3-14,301,301,0
2024-11-26,20,DPD30-59,70,70,0
2024-11-26,20,DPD60-89,0,0,0
2024-11-26,20,DPD90+,0,0,0
2024-11-26,22,Current,0,0,0
2024-11-26,22,DPD3-14,1,1,0
2024-11-26,22,DPD30-59,0,0,0
2024-11-26,22,DPD60-89,0,0,0
2024-11-26,22,DPD90+,0,0,0
2024-11-26,24,Current,131,131,0
2024-11-26,24,DPD15-29,75,75,0
2024-11-26,24,DPD3-14,200,200,0
2024-11-26,24,DPD30-59,34,34,0
2024-11-26,24,DPD60-89,0,0,0
2024-11-26,24,DPD90+,0,0,0
2024-11-26,26,Current,0,0,0
2024-11-26,26,DPD15-29,9,9,0
2024-11-26,26,DPD3-14,25,25,0
2024-11-26,26,DPD30-59,2,2,0
2024-11-26,26,DPD60-89,0,0,0
2024-11-26,26,DPD90+,0,0,0
2024-11-26,32,Current,0,0,0
2024-11-26,32,DPD15-29,49,49,0
2024-11-26,32,DPD3-14,149,149,0
2024-11-26,32,DPD30-59,42,42,0
2024-11-26,32,DPD60-89,0,0,0
2024-11-26,32,DPD90+,0,0,0
2024-11-26,34,Current,0,0,0
2024-11-26,34,DPD15-29,29,29,0
2024-11-26,34,DPD3-14,46,46,0
2024-11-26,34,DPD30-59,15,15,0
2024-11-26,34,DPD60-89,0,0,0
2024-11-26,34,DPD90+,0,0,0
2024-11-26,36,Current,0,0,0
2024-11-26,36,DPD15-29,16,16,0
2024-11-26,36,DPD3-14,38,38,0
2024-11-26,36,DPD30-59,12,12,0
2024-11-26,36,DPD60-89,0,0,0
2024-11-26,36,DPD90+,0,0,0
2024-11-26,38,Current,34,34,0
2024-11-26,38,DPD15-29,10,10,0
2024-11-26,38,DPD3-14,34,34,0
2024-11-26,38,DPD30-59,6,6,0
2024-11-26,38,DPD60-89,0,0,0
2024-11-26,38,DPD90+,0,0,0
2024-11-26,40,Current,0,0,0
2024-11-26,40,DPD15-29,9,9,0
2024-11-26,40,DPD3-14,39,39,0
2024-11-26,40,DPD30-59,7,7,0
2024-11-26,40,DPD60-89,0,0,0
2024-11-26,40,DPD90+,0,0,0
2024-11-26,42,Current,0,0,0
2024-11-26,42,DPD15-29,7,7,0
2024-11-26,42,DPD3-14,12,12,0
2024-11-26,42,DPD30-59,2,2,0
2024-11-26,42,DPD60-89,0,0,0
2024-11-26,42,DPD90+,0,0,0
2024-11-26,44,Current,0,0,0
2024-11-26,44,DPD15-29,16,16,0
2024-11-26,44,DPD3-14,42,42,0
2024-11-26,44,DPD30-59,4,4,0
2024-11-26,44,DPD60-89,0,0,0
2024-11-26,44,DPD90+,0,0,0
2024-11-26,46,Current,0,0,0
2024-11-26,46,DPD15-29,0,0,0
2024-11-26,46,DPD3-14,1,1,0
2024-11-26,48,Current,63,63,0
2024-11-26,48,DPD15-29,9,9,0
2024-11-26,48,DPD3-14,42,42,0
2024-11-26,48,DPD30-59,10,10,0
2024-11-26,48,DPD60-89,0,0,0
2024-11-26,48,DPD90+,0,0,0
2024-11-26,6,Current,0,0,0
2024-11-25,100,Current,0,0,0
2024-11-25,100,DPD15-29,0,0,0
2024-11-25,102,Current,0,0,0
2024-11-25,102,DPD60-89,0,0,0
2024-11-25,104,Current,0,0,0
2024-11-25,20,Current,6,6,0
2024-11-25,20,DPD15-29,219,219,0
2024-11-25,20,DPD3-14,344,344,0
2024-11-25,20,DPD30-59,95,95,0
2024-11-25,20,DPD60-89,0,0,0
2024-11-25,20,DPD90+,0,0,0
2024-11-25,22,Current,0,0,0
2024-11-25,22,DPD3-14,1,1,0
2024-11-25,22,DPD30-59,0,0,0
2024-11-25,22,DPD60-89,0,0,0
2024-11-25,22,DPD90+,0,0,0
2024-11-25,24,Current,25,25,0
2024-11-25,24,DPD15-29,116,116,0
2024-11-25,24,DPD3-14,194,194,0
2024-11-25,24,DPD30-59,60,60,0
2024-11-25,24,DPD60-89,0,0,0
2024-11-25,24,DPD90+,0,0,0
2024-11-25,26,Current,0,0,0
2024-11-25,26,DPD15-29,8,8,0
2024-11-25,26,DPD3-14,34,34,0
2024-11-25,26,DPD30-59,3,3,0
2024-11-25,26,DPD60-89,0,0,0
2024-11-25,26,DPD90+,0,0,0
2024-11-25,32,Current,0,0,0
2024-11-25,32,DPD15-29,111,111,0
2024-11-25,32,DPD3-14,146,146,0
2024-11-25,32,DPD30-59,52,52,0
2024-11-25,32,DPD60-89,0,0,0
2024-11-25,32,DPD90+,0,0,0
2024-11-25,34,Current,0,0,0
2024-11-25,34,DPD15-29,36,36,0
2024-11-25,34,DPD3-14,61,61,0
2024-11-25,34,DPD30-59,16,16,0
2024-11-25,34,DPD60-89,0,0,0
2024-11-25,34,DPD90+,0,0,0
2024-11-25,36,Current,0,0,0
2024-11-25,36,DPD15-29,30,30,0
2024-11-25,36,DPD3-14,46,46,0
2024-11-25,36,DPD30-59,15,15,0
2024-11-25,36,DPD60-89,0,0,0
2024-11-25,36,DPD90+,0,0,0
2024-11-25,38,Current,4,4,0
2024-11-25,38,DPD15-29,25,25,0
2024-11-25,38,DPD3-14,64,64,0
2024-11-25,38,DPD30-59,13,13,0
2024-11-25,38,DPD60-89,0,0,0
2024-11-25,38,DPD90+,0,0,0
2024-11-25,40,Current,0,0,0
2024-11-25,40,DPD15-29,13,13,0
2024-11-25,40,DPD3-14,35,35,0
2024-11-25,40,DPD30-59,6,6,0
2024-11-25,40,DPD60-89,0,0,0
2024-11-25,40,DPD90+,0,0,0
2024-11-25,42,Current,0,0,0
2024-11-25,42,DPD15-29,9,9,0
2024-11-25,42,DPD3-14,22,22,0
2024-11-25,42,DPD30-59,6,6,0
2024-11-25,42,DPD60-89,0,0,0
2024-11-25,42,DPD90+,0,0,0
2024-11-25,44,Current,0,0,0
2024-11-25,44,DPD15-29,23,23,0
2024-11-25,44,DPD3-14,46,46,0
2024-11-25,44,DPD30-59,16,16,0
2024-11-25,44,DPD60-89,0,0,0
2024-11-25,44,DPD90+,0,0,0
2024-11-25,46,Current,0,0,0
2024-11-25,46,DPD15-29,2,2,0
2024-11-25,46,DPD3-14,0,0,0
2024-11-25,48,Current,14,14,0
2024-11-25,48,DPD15-29,17,17,0
2024-11-25,48,DPD3-14,53,53,0
2024-11-25,48,DPD30-59,10,10,0
2024-11-25,48,DPD60-89,0,0,0
2024-11-25,48,DPD90+,0,0,0
2024-11-25,6,Current,0,0,0
2024-11-24,100,Current,0,0,0
2024-11-24,100,DPD15-29,0,0,0
2024-11-24,102,Current,0,0,0
2024-11-24,102,DPD60-89,0,0,0
2024-11-24,104,Current,0,0,0
2024-11-24,20,Current,0,0,0
2024-11-24,20,DPD15-29,144,144,0
2024-11-24,20,DPD3-14,304,304,0
2024-11-24,20,DPD30-59,90,90,0
2024-11-24,20,DPD60-89,0,0,0
2024-11-24,20,DPD90+,0,0,0
2024-11-24,22,Current,0,0,0
2024-11-24,22,DPD3-14,0,0,0
2024-11-24,22,DPD30-59,0,0,0
2024-11-24,22,DPD90+,0,0,0
2024-11-24,24,Current,29,29,0
2024-11-24,24,DPD15-29,71,71,0
2024-11-24,24,DPD3-14,191,191,0
2024-11-24,24,DPD30-59,44,44,0
2024-11-24,24,DPD60-89,0,0,0
2024-11-24,24,DPD90+,0,0,0
2024-11-24,26,Current,0,0,0
2024-11-24,26,DPD15-29,8,8,0
2024-11-24,26,DPD3-14,22,22,0
2024-11-24,26,DPD30-59,6,6,0
2024-11-24,26,DPD60-89,0,0,0
2024-11-24,26,DPD90+,0,0,0
2024-11-24,32,Current,0,0,0
2024-11-24,32,DPD15-29,59,59,0
2024-11-24,32,DPD3-14,131,131,0
2024-11-24,32,DPD30-59,45,45,0
2024-11-24,32,DPD60-89,0,0,0
2024-11-24,32,DPD90+,0,0,0
2024-11-24,34,Current,0,0,0
2024-11-24,34,DPD15-29,26,26,0
2024-11-24,34,DPD3-14,51,51,0
2024-11-24,34,DPD30-59,15,15,0
2024-11-24,34,DPD60-89,0,0,0
2024-11-24,34,DPD90+,0,0,0
2024-11-24,36,Current,0,0,0
2024-11-24,36,DPD15-29,20,20,0
2024-11-24,36,DPD3-14,40,40,0
2024-11-24,36,DPD30-59,15,15,0
2024-11-24,36,DPD60-89,0,0,0
2024-11-24,36,DPD90+,0,0,0
2024-11-24,38,Current,7,7,0
2024-11-24,38,DPD15-29,7,7,0
2024-11-24,38,DPD3-14,36,36,0
2024-11-24,38,DPD30-59,13,13,0
2024-11-24,38,DPD60-89,0,0,0
2024-11-24,38,DPD90+,0,0,0
2024-11-24,40,Current,0,0,0
2024-11-24,40,DPD15-29,9,9,0
2024-11-24,40,DPD3-14,39,39,0
2024-11-24,40,DPD30-59,8,8,0
2024-11-24,40,DPD60-89,0,0,0
2024-11-24,40,DPD90+,0,0,0
2024-11-24,42,Current,0,0,0
2024-11-24,42,DPD15-29,6,6,0
2024-11-24,42,DPD3-14,12,12,0
2024-11-24,42,DPD30-59,3,3,0
2024-11-24,42,DPD60-89,0,0,0
2024-11-24,42,DPD90+,0,0,0
2024-11-24,44,Current,0,0,0
2024-11-24,44,DPD15-29,17,17,0
2024-11-24,44,DPD3-14,40,40,0
2024-11-24,44,DPD30-59,9,9,0
2024-11-24,44,DPD60-89,0,0,0
2024-11-24,44,DPD90+,0,0,0
2024-11-24,46,Current,0,0,0
2024-11-24,46,DPD15-29,0,0,0
2024-11-24,48,Current,56,56,0
2024-11-24,48,DPD15-29,9,9,0
2024-11-24,48,DPD3-14,42,42,0
2024-11-24,48,DPD30-59,7,7,0
2024-11-24,48,DPD60-89,0,0,0
2024-11-24,48,DPD90+,0,0,0
2024-11-24,6,Current,0,0,0
2024-11-23,100,Current,0,0,0
2024-11-23,100,DPD15-29,0,0,0
2024-11-23,102,Current,0,0,0
2024-11-23,102,DPD60-89,0,0,0
2024-11-23,104,Current,0,0,0
2024-11-23,20,Current,0,0,0
2024-11-23,20,DPD15-29,201,201,0
2024-11-23,20,DPD3-14,327,327,0
2024-11-23,20,DPD30-59,90,90,0
2024-11-23,20,DPD60-89,0,0,0
2024-11-23,20,DPD90+,0,0,0
2024-11-23,22,Current,0,0,0
2024-11-23,22,DPD3-14,1,1,0
2024-11-23,22,DPD30-59,1,1,0
2024-11-23,22,DPD90+,0,0,0
2024-11-23,24,Current,56,56,0
2024-11-23,24,DPD15-29,101,101,0
2024-11-23,24,DPD3-14,184,184,0
2024-11-23,24,DPD30-59,67,67,0
2024-11-23,24,DPD60-89,0,0,0
2024-11-23,24,DPD90+,0,0,0
2024-11-23,26,Current,0,0,0
2024-11-23,26,DPD15-29,6,6,0
2024-11-23,26,DPD3-14,33,33,0
2024-11-23,26,DPD30-59,6,6,0
2024-11-23,26,DPD60-89,0,0,0
2024-11-23,26,DPD90+,0,0,0
2024-11-23,32,Current,0,0,0
2024-11-23,32,DPD15-29,102,102,0
2024-11-23,32,DPD3-14,142,142,0
2024-11-23,32,DPD30-59,52,52,0
2024-11-23,32,DPD60-89,0,0,0
2024-11-23,32,DPD90+,0,0,0
2024-11-23,34,Current,0,0,0
2024-11-23,34,DPD15-29,32,32,0
2024-11-23,34,DPD3-14,58,58,0
2024-11-23,34,DPD30-59,16,16,0
2024-11-23,34,DPD60-89,0,0,0
2024-11-23,34,DPD90+,0,0,0
2024-11-23,36,Current,0,0,0
2024-11-23,36,DPD15-29,26,26,0
2024-11-23,36,DPD3-14,40,40,0
2024-11-23,36,DPD30-59,14,14,0
2024-11-23,36,DPD60-89,0,0,0
2024-11-23,36,DPD90+,0,0,0
2024-11-23,38,Current,12,12,0
2024-11-23,38,DPD15-29,23,23,0
2024-11-23,38,DPD3-14,54,54,0
2024-11-23,38,DPD30-59,18,18,0
2024-11-23,38,DPD60-89,0,0,0
2024-11-23,38,DPD90+,0,0,0
2024-11-23,40,Current,0,0,0
2024-11-23,40,DPD15-29,10,10,0
2024-11-23,40,DPD3-14,30,30,0
2024-11-23,40,DPD30-59,8,8,0
2024-11-23,40,DPD60-89,0,0,0
2024-11-23,40,DPD90+,0,0,0
2024-11-23,42,Current,0,0,0
2024-11-23,42,DPD15-29,8,8,0
2024-11-23,42,DPD3-14,24,24,0
2024-11-23,42,DPD30-59,3,3,0
2024-11-23,42,DPD60-89,0,0,0
2024-11-23,42,DPD90+,0,0,0
2024-11-23,44,Current,0,0,0
2024-11-23,44,DPD15-29,20,20,0
2024-11-23,44,DPD3-14,44,44,0
2024-11-23,44,DPD30-59,10,10,0
2024-11-23,44,DPD60-89,0,0,0
2024-11-23,44,DPD90+,0,0,0
2024-11-23,46,Current,0,0,0
2024-11-23,46,DPD15-29,2,2,0
2024-11-23,48,Current,60,60,0
2024-11-23,48,DPD15-29,14,14,0
2024-11-23,48,DPD3-14,53,53,0
2024-11-23,48,DPD30-59,13,13,0
2024-11-23,48,DPD60-89,0,0,0
2024-11-23,48,DPD90+,0,0,0
2024-11-23,6,Current,0,0,0
2024-11-22,100,Current,0,0,0
2024-11-22,100,DPD15-29,0,0,0
2024-11-22,102,Current,0,0,0
2024-11-22,102,DPD60-89,0,0,0
2024-11-22,104,Current,0,0,0
2024-11-22,20,Current,0,0,0
2024-11-22,20,DPD15-29,166,166,0
2024-11-22,20,DPD3-14,217,217,0
2024-11-22,20,DPD30-59,59,59,0
2024-11-22,20,DPD60-89,0,0,0
2024-11-22,20,DPD90+,0,0,0
2024-11-22,22,Current,0,0,0
2024-11-22,22,DPD3-14,0,0,0
2024-11-22,22,DPD30-59,0,0,0
2024-11-22,22,DPD90+,0,0,0
2024-11-22,24,Current,49,49,0
2024-11-22,24,DPD15-29,82,82,0
2024-11-22,24,DPD3-14,146,146,0
2024-11-22,24,DPD30-59,24,24,0
2024-11-22,24,DPD60-89,0,0,0
2024-11-22,24,DPD90+,0,0,0
2024-11-22,26,Current,0,0,0
2024-11-22,26,DPD15-29,10,10,0
2024-11-22,26,DPD3-14,15,15,0
2024-11-22,26,DPD30-59,1,1,0
2024-11-22,26,DPD60-89,0,0,0
2024-11-22,26,DPD90+,0,0,0
2024-11-22,32,Current,0,0,0
2024-11-22,32,DPD15-29,65,65,0
2024-11-22,32,DPD3-14,107,107,0
2024-11-22,32,DPD30-59,31,31,0
2024-11-22,32,DPD60-89,0,0,0
2024-11-22,32,DPD90+,0,0,0
2024-11-22,34,Current,0,0,0
2024-11-22,34,DPD15-29,27,27,0
2024-11-22,34,DPD3-14,49,49,0
2024-11-22,34,DPD30-59,13,13,0
2024-11-22,34,DPD60-89,0,0,0
2024-11-22,34,DPD90+,0,0,0
2024-11-22,36,Current,0,0,0
2024-11-22,36,DPD15-29,22,22,0
2024-11-22,36,DPD3-14,24,24,0
2024-11-22,36,DPD30-59,5,5,0
2024-11-22,36,DPD60-89,0,0,0
2024-11-22,36,DPD90+,0,0,0
2024-11-22,38,Current,9,9,0
2024-11-22,38,DPD15-29,10,10,0
2024-11-22,38,DPD3-14,31,31,0
2024-11-22,38,DPD30-59,6,6,0
2024-11-22,38,DPD60-89,0,0,0
2024-11-22,38,DPD90+,0,0,0
2024-11-22,40,Current,0,0,0
2024-11-22,40,DPD15-29,12,12,0
2024-11-22,40,DPD3-14,24,24,0
2024-11-22,40,DPD30-59,7,7,0
2024-11-22,40,DPD60-89,0,0,0
2024-11-22,40,DPD90+,0,0,0
2024-11-22,42,Current,0,0,0
2024-11-22,42,DPD15-29,9,9,0
2024-11-22,42,DPD3-14,11,11,0
2024-11-22,42,DPD30-59,1,1,0
2024-11-22,42,DPD60-89,0,0,0
2024-11-22,42,DPD90+,0,0,0
2024-11-22,44,Current,0,0,0
2024-11-22,44,DPD15-29,19,19,0
2024-11-22,44,DPD3-14,36,36,0
2024-11-22,44,DPD30-59,2,2,0
2024-11-22,44,DPD60-89,0,0,0
2024-11-22,44,DPD90+,0,0,0
2024-11-22,46,Current,0,0,0
2024-11-22,46,DPD15-29,0,0,0
2024-11-22,48,Current,61,61,0
2024-11-22,48,DPD15-29,10,10,0
2024-11-22,48,DPD3-14,30,30,0
2024-11-22,48,DPD30-59,8,8,0
2024-11-22,48,DPD60-89,0,0,0
2024-11-22,48,DPD90+,0,0,0
2024-11-22,6,Current,0,0,0
2024-11-21,100,Current,0,0,0
2024-11-21,100,DPD15-29,0,0,0
2024-11-21,102,Current,0,0,0
2024-11-21,102,DPD60-89,0,0,0
2024-11-21,104,Current,0,0,0
2024-11-21,20,Current,0,0,0
2024-11-21,20,DPD15-29,218,218,0
2024-11-21,20,DPD3-14,327,327,0
2024-11-21,20,DPD30-59,81,81,0
2024-11-21,20,DPD60-89,0,0,0
2024-11-21,20,DPD90+,0,0,0
2024-11-21,22,Current,0,0,0
2024-11-21,22,DPD30-59,0,0,0
2024-11-21,22,DPD90+,0,0,0
2024-11-21,24,Current,30,30,0
2024-11-21,24,DPD15-29,115,115,0
2024-11-21,24,DPD3-14,201,201,0
2024-11-21,24,DPD30-59,61,61,0
2024-11-21,24,DPD60-89,0,0,0
2024-11-21,24,DPD90+,0,0,0
2024-11-21,26,Current,0,0,0
2024-11-21,26,DPD15-29,11,11,0
2024-11-21,26,DPD3-14,29,29,0
2024-11-21,26,DPD30-59,5,5,0
2024-11-21,26,DPD60-89,0,0,0
2024-11-21,26,DPD90+,0,0,0
2024-11-21,32,Current,0,0,0
2024-11-21,32,DPD15-29,110,110,0
2024-11-21,32,DPD3-14,146,146,0
2024-11-21,32,DPD30-59,48,48,0
2024-11-21,32,DPD60-89,0,0,0
2024-11-21,32,DPD90+,0,0,0
2024-11-21,34,Current,0,0,0
2024-11-21,34,DPD15-29,33,33,0
2024-11-21,34,DPD3-14,65,65,0
2024-11-21,34,DPD30-59,20,20,0
2024-11-21,34,DPD60-89,0,0,0
2024-11-21,34,DPD90+,0,0,0
2024-11-21,36,Current,0,0,0
2024-11-21,36,DPD15-29,27,27,0
2024-11-21,36,DPD3-14,40,40,0
2024-11-21,36,DPD30-59,16,16,0
2024-11-21,36,DPD60-89,0,0,0
2024-11-21,36,DPD90+,0,0,0
2024-11-21,38,Current,8,8,0
2024-11-21,38,DPD15-29,26,26,0
2024-11-21,38,DPD3-14,50,50,0
2024-11-21,38,DPD30-59,12,12,0
2024-11-21,38,DPD60-89,0,0,0
2024-11-21,38,DPD90+,0,0,0
2024-11-21,40,Current,0,0,0
2024-11-21,40,DPD15-29,11,11,0
2024-11-21,40,DPD3-14,32,32,0
2024-11-21,40,DPD30-59,5,5,0
2024-11-21,40,DPD60-89,0,0,0
2024-11-21,40,DPD90+,0,0,0
2024-11-21,42,Current,0,0,0
2024-11-21,42,DPD15-29,9,9,0
2024-11-21,42,DPD3-14,25,25,0
2024-11-21,42,DPD30-59,4,4,0
2024-11-21,42,DPD60-89,0,0,0
2024-11-21,42,DPD90+,0,0,0
2024-11-21,44,Current,0,0,0
2024-11-21,44,DPD15-29,22,22,0
2024-11-21,44,DPD3-14,39,39,0
2024-11-21,44,DPD30-59,12,12,0
2024-11-21,44,DPD60-89,0,0,0
2024-11-21,44,DPD90+,0,0,0
2024-11-21,46,Current,0,0,0
2024-11-21,46,DPD3-14,2,2,0
2024-11-21,48,Current,15,15,0
2024-11-21,48,DPD15-29,17,17,0
2024-11-21,48,DPD3-14,39,39,0
2024-11-21,48,DPD30-59,12,12,0
2024-11-21,48,DPD60-89,0,0,0
2024-11-21,48,DPD90+,0,0,0
2024-11-21,6,Current,0,0,0
2024-11-20,100,Current,0,0,0
2024-11-20,100,DPD15-29,0,0,0
2024-11-20,102,Current,0,0,0
2024-11-20,102,DPD60-89,0,0,0
2024-11-20,104,Current,0,0,0
2024-11-20,20,Current,0,0,0
2024-11-20,20,DPD15-29,173,173,0
2024-11-20,20,DPD3-14,225,225,0
2024-11-20,20,DPD30-59,95,95,0
2024-11-20,20,DPD60-89,0,0,0
2024-11-20,20,DPD90+,0,0,0
2024-11-20,22,Current,0,0,0
2024-11-20,22,DPD30-59,0,0,0
2024-11-20,22,DPD60-89,0,0,0
2024-11-20,22,DPD90+,0,0,0
2024-11-20,24,Current,27,27,0
2024-11-20,24,DPD15-29,80,80,0
2024-11-20,24,DPD3-14,151,151,0
2024-11-20,24,DPD30-59,49,49,0
2024-11-20,24,DPD60-89,0,0,0
2024-11-20,24,DPD90+,0,0,0
2024-11-20,26,Current,0,0,0
2024-11-20,26,DPD15-29,8,8,0
2024-11-20,26,DPD3-14,16,16,0
2024-11-20,26,DPD30-59,4,4,0
2024-11-20,26,DPD60-89,0,0,0
2024-11-20,26,DPD90+,0,0,0
2024-11-20,32,Current,0,0,0
2024-11-20,32,DPD15-29,72,72,0
2024-11-20,32,DPD3-14,102,102,0
2024-11-20,32,DPD30-59,40,40,0
2024-11-20,32,DPD60-89,0,0,0
2024-11-20,32,DPD90+,0,0,0
2024-11-20,34,Current,0,0,0
2024-11-20,34,DPD15-29,28,28,0
2024-11-20,34,DPD3-14,44,44,0
2024-11-20,34,DPD30-59,13,13,0
2024-11-20,34,DPD60-89,0,0,0
2024-11-20,34,DPD90+,0,0,0
2024-11-20,36,Current,0,0,0
2024-11-20,36,DPD15-29,20,20,0
2024-11-20,36,DPD3-14,23,23,0
2024-11-20,36,DPD30-59,14,14,0
2024-11-20,36,DPD60-89,0,0,0
2024-11-20,36,DPD90+,0,0,0
2024-11-20,38,Current,9,9,0
2024-11-20,38,DPD15-29,12,12,0
2024-11-20,38,DPD3-14,30,30,0
2024-11-20,38,DPD30-59,14,14,0
2024-11-20,38,DPD60-89,0,0,0
2024-11-20,38,DPD90+,0,0,0
2024-11-20,40,Current,0,0,0
2024-11-20,40,DPD15-29,15,15,0
2024-11-20,40,DPD3-14,21,21,0
2024-11-20,40,DPD30-59,4,4,0
2024-11-20,40,DPD60-89,0,0,0
2024-11-20,40,DPD90+,0,0,0
2024-11-20,42,Current,0,0,0
2024-11-20,42,DPD15-29,8,8,0
2024-11-20,42,DPD3-14,12,12,0
2024-11-20,42,DPD30-59,2,2,0
2024-11-20,42,DPD60-89,0,0,0
2024-11-20,42,DPD90+,0,0,0
2024-11-20,44,Current,0,0,0
2024-11-20,44,DPD15-29,19,19,0
2024-11-20,44,DPD3-14,32,32,0
2024-11-20,44,DPD30-59,12,12,0
2024-11-20,44,DPD60-89,0,0,0
2024-11-20,44,DPD90+,0,0,0
2024-11-20,46,Current,0,0,0
2024-11-20,46,DPD3-14,0,0,0
2024-11-20,48,Current,16,16,0
2024-11-20,48,DPD15-29,8,8,0
2024-11-20,48,DPD3-14,32,32,0
2024-11-20,48,DPD30-59,9,9,0
2024-11-20,48,DPD60-89,0,0,0
2024-11-20,48,DPD90+,0,0,0
2024-11-20,6,Current,0,0,0
2024-11-19,100,Current,0,0,0
2024-11-19,100,DPD3-14,0,0,0
2024-11-19,102,Current,0,0,0
2024-11-19,102,DPD60-89,0,0,0
2024-11-19,104,Current,0,0,0
2024-11-19,20,Current,0,0,0
2024-11-19,20,DPD15-29,232,232,0
2024-11-19,20,DPD3-14,341,341,0
2024-11-19,20,DPD30-59,137,137,0
2024-11-19,20,DPD60-89,0,0,0
2024-11-19,20,DPD90+,0,0,0
2024-11-19,22,Current,0,0,0
2024-11-19,22,DPD30-59,1,1,0
2024-11-19,22,DPD60-89,0,0,0
2024-11-19,22,DPD90+,0,0,0
2024-11-19,24,Current,200,200,0
2024-11-19,24,DPD15-29,126,126,0
2024-11-19,24,DPD3-14,213,213,0
2024-11-19,24,DPD30-59,78,78,0
2024-11-19,24,DPD60-89,0,0,0
2024-11-19,24,DPD90+,0,0,0
2024-11-19,26,Current,0,0,0
2024-11-19,26,DPD15-29,10,10,0
2024-11-19,26,DPD3-14,34,34,0
2024-11-19,26,DPD30-59,10,10,0
2024-11-19,26,DPD60-89,0,0,0
2024-11-19,26,DPD90+,0,0,0
2024-11-19,32,Current,0,0,0
2024-11-19,32,DPD15-29,132,132,0
2024-11-19,32,DPD3-14,143,143,0
2024-11-19,32,DPD30-59,71,71,0
2024-11-19,32,DPD60-89,0,0,0
2024-11-19,32,DPD90+,0,0,0
2024-11-19,34,Current,0,0,0
2024-11-19,34,DPD15-29,45,45,0
2024-11-19,34,DPD3-14,64,64,0
2024-11-19,34,DPD30-59,25,25,0
2024-11-19,34,DPD60-89,0,0,0
2024-11-19,34,DPD90+,0,0,0
2024-11-19,36,Current,0,0,0
2024-11-19,36,DPD15-29,35,35,0
2024-11-19,36,DPD3-14,45,45,0
2024-11-19,36,DPD30-59,18,18,0
2024-11-19,36,DPD60-89,0,0,0
2024-11-19,36,DPD90+,0,0,0
2024-11-19,38,Current,38,38,0
2024-11-19,38,DPD15-29,31,31,0
2024-11-19,38,DPD3-14,54,54,0
2024-11-19,38,DPD30-59,18,18,0
2024-11-19,38,DPD60-89,0,0,0
2024-11-19,38,DPD90+,0,0,0
2024-11-19,40,Current,0,0,0
2024-11-19,40,DPD15-29,14,14,0
2024-11-19,40,DPD3-14,33,33,0
2024-11-19,40,DPD30-59,10,10,0
2024-11-19,40,DPD60-89,0,0,0
2024-11-19,40,DPD90+,0,0,0
2024-11-19,42,Current,0,0,0
2024-11-19,42,DPD15-29,8,8,0
2024-11-19,42,DPD3-14,27,27,0
2024-11-19,42,DPD30-59,6,6,0
2024-11-19,42,DPD60-89,0,0,0
2024-11-19,42,DPD90+,0,0,0
2024-11-19,44,Current,0,0,0
2024-11-19,44,DPD15-29,24,24,0
2024-11-19,44,DPD3-14,46,46,0
2024-11-19,44,DPD30-59,15,15,0
2024-11-19,44,DPD60-89,0,0,0
2024-11-19,44,DPD90+,0,0,0
2024-11-19,46,Current,0,0,0
2024-11-19,46,DPD3-14,2,2,0
2024-11-19,48,Current,125,125,0
2024-11-19,48,DPD15-29,17,17,0
2024-11-19,48,DPD3-14,45,45,0
2024-11-19,48,DPD30-59,17,17,0
2024-11-19,48,DPD60-89,0,0,0
2024-11-19,48,DPD90+,0,0,0
2024-11-19,6,Current,0,0,0
2024-11-18,100,Current,0,0,0
2024-11-18,100,DPD3-14,0,0,0
2024-11-18,102,Current,0,0,0
2024-11-18,102,DPD30-59,0,0,0
2024-11-18,104,Current,0,0,0
2024-11-18,20,Current,0,0,0
2024-11-18,20,DPD15-29,182,182,0
2024-11-18,20,DPD3-14,212,212,0
2024-11-18,20,DPD30-59,42,42,0
2024-11-18,20,DPD60-89,0,0,0
2024-11-18,20,DPD90+,0,0,0
2024-11-18,22,Current,0,0,0
2024-11-18,22,DPD30-59,0,0,0
2024-11-18,22,DPD60-89,0,0,0
2024-11-18,22,DPD90+,0,0,0
2024-11-18,24,Current,70,70,0
2024-11-18,24,DPD15-29,85,85,0
2024-11-18,24,DPD3-14,146,146,0
2024-11-18,24,DPD30-59,22,22,0
2024-11-18,24,DPD60-89,0,0,0
2024-11-18,24,DPD90+,0,0,0
2024-11-18,26,Current,0,0,0
2024-11-18,26,DPD15-29,12,12,0
2024-11-18,26,DPD3-14,12,12,0
2024-11-18,26,DPD30-59,1,1,0
2024-11-18,26,DPD60-89,0,0,0
2024-11-18,26,DPD90+,0,0,0
2024-11-18,32,Current,0,0,0
2024-11-18,32,DPD15-29,94,94,0
2024-11-18,32,DPD3-14,83,83,0
2024-11-18,32,DPD30-59,25,25,0
2024-11-18,32,DPD60-89,0,0,0
2024-11-18,32,DPD90+,0,0,0
2024-11-18,34,Current,0,0,0
2024-11-18,34,DPD15-29,24,24,0
2024-11-18,34,DPD3-14,41,41,0
2024-11-18,34,DPD30-59,10,10,0
2024-11-18,34,DPD60-89,0,0,0
2024-11-18,34,DPD90+,0,0,0
2024-11-18,36,Current,0,0,0
2024-11-18,36,DPD15-29,28,28,0
2024-11-18,36,DPD3-14,18,18,0
2024-11-18,36,DPD30-59,5,5,0
2024-11-18,36,DPD60-89,0,0,0
2024-11-18,36,DPD90+,0,0,0
2024-11-18,38,Current,16,16,0
2024-11-18,38,DPD15-29,18,18,0
2024-11-18,38,DPD3-14,31,31,0
2024-11-18,38,DPD30-59,4,4,0
2024-11-18,38,DPD60-89,0,0,0
2024-11-18,38,DPD90+,0,0,0
2024-11-18,40,Current,0,0,0
2024-11-18,40,DPD15-29,17,17,0
2024-11-18,40,DPD3-14,21,21,0
2024-11-18,40,DPD30-59,5,5,0
2024-11-18,40,DPD60-89,0,0,0
2024-11-18,40,DPD90+,0,0,0
2024-11-18,42,Current,0,0,0
2024-11-18,42,DPD15-29,8,8,0
2024-11-18,42,DPD3-14,12,12,0
2024-11-18,42,DPD30-59,1,1,0
2024-11-18,42,DPD60-89,0,0,0
2024-11-18,42,DPD90+,0,0,0
2024-11-18,44,Current,0,0,0
2024-11-18,44,DPD15-29,24,24,0
2024-11-18,44,DPD3-14,32,32,0
2024-11-18,44,DPD30-59,5,5,0
2024-11-18,44,DPD60-89,0,0,0
2024-11-18,44,DPD90+,0,0,0
2024-11-18,46,Current,0,0,0
2024-11-18,46,DPD3-14,0,0,0
2024-11-18,48,Current,35,35,0
2024-11-18,48,DPD15-29,13,13,0
2024-11-18,48,DPD3-14,28,28,0
2024-11-18,48,DPD30-59,6,6,0
2024-11-18,48,DPD60-89,0,0,0
2024-11-18,48,DPD90+,0,0,0
2024-11-18,6,Current,0,0,0
2024-11-17,100,Current,0,0,0
2024-11-17,100,DPD3-14,0,0,0
2024-11-17,102,Current,0,0,0
2024-11-17,102,DPD30-59,0,0,0
2024-11-17,104,Current,0,0,0
2024-11-17,104,DPD3-14,0,0,0
2024-11-17,20,Current,0,0,0
2024-11-17,20,DPD15-29,242,242,0
2024-11-17,20,DPD3-14,243,243,0
2024-11-17,20,DPD30-59,78,78,0
2024-11-17,20,DPD60-89,0,0,0
2024-11-17,20,DPD90+,0,0,0
2024-11-17,22,Current,0,0,0
2024-11-17,22,DPD30-59,0,0,0
2024-11-17,22,DPD60-89,0,0,0
2024-11-17,22,DPD90+,0,0,0
2024-11-17,24,Current,52,52,0
2024-11-17,24,DPD15-29,134,134,0
2024-11-17,24,DPD3-14,162,162,0
2024-11-17,24,DPD30-59,56,56,0
2024-11-17,24,DPD60-89,0,0,0
2024-11-17,24,DPD90+,0,0,0
2024-11-17,26,Current,0,0,0
2024-11-17,26,DPD15-29,13,13,0
2024-11-17,26,DPD3-14,16,16,0
2024-11-17,26,DPD30-59,7,7,0
2024-11-17,26,DPD60-89,0,0,0
2024-11-17,26,DPD90+,0,0,0
2024-11-17,32,Current,0,0,0
2024-11-17,32,DPD15-29,140,140,0
2024-11-17,32,DPD3-14,89,89,0
2024-11-17,32,DPD30-59,49,49,0
2024-11-17,32,DPD60-89,0,0,0
2024-11-17,32,DPD90+,0,0,0
2024-11-17,34,Current,0,0,0
2024-11-17,34,DPD15-29,49,49,0
2024-11-17,34,DPD3-14,48,48,0
2024-11-17,34,DPD30-59,20,20,0
2024-11-17,34,DPD60-89,0,0,0
2024-11-17,34,DPD90+,0,0,0
2024-11-17,36,Current,0,0,0
2024-11-17,36,DPD15-29,37,37,0
2024-11-17,36,DPD3-14,28,28,0
2024-11-17,36,DPD30-59,11,11,0
2024-11-17,36,DPD60-89,0,0,0
2024-11-17,36,DPD90+,0,0,0
2024-11-17,38,Current,12,12,0
2024-11-17,38,DPD15-29,31,31,0
2024-11-17,38,DPD3-14,27,27,0
2024-11-17,38,DPD30-59,11,11,0
2024-11-17,38,DPD60-89,0,0,0
2024-11-17,38,DPD90+,0,0,0
2024-11-17,40,Current,0,0,0
2024-11-17,40,DPD15-29,15,15,0
2024-11-17,40,DPD3-14,25,25,0
2024-11-17,40,DPD30-59,5,5,0
2024-11-17,40,DPD60-89,0,0,0
2024-11-17,40,DPD90+,0,0,0
2024-11-17,42,Current,0,0,0
2024-11-17,42,DPD15-29,9,9,0
2024-11-17,42,DPD3-14,17,17,0
2024-11-17,42,DPD30-59,5,5,0
2024-11-17,42,DPD60-89,0,0,0
2024-11-17,42,DPD90+,0,0,0
2024-11-17,44,Current,0,0,0
2024-11-17,44,DPD15-29,25,25,0
2024-11-17,44,DPD3-14,28,28,0
2024-11-17,44,DPD30-59,10,10,0
2024-11-17,44,DPD60-89,0,0,0
2024-11-17,44,DPD90+,0,0,0
2024-11-17,46,Current,0,0,0
2024-11-17,46,DPD3-14,2,2,0
2024-11-17,48,Current,23,23,0
2024-11-17,48,DPD15-29,14,14,0
2024-11-17,48,DPD3-14,37,37,0
2024-11-17,48,DPD30-59,14,14,0
2024-11-17,48,DPD60-89,0,0,0
2024-11-17,48,DPD90+,0,0,0
2024-11-17,6,Current,0,0,0
2024-11-16,100,Current,0,0,0
2024-11-16,100,DPD3-14,0,0,0
2024-11-16,102,Current,0,0,0
2024-11-16,102,DPD30-59,0,0,0
2024-11-16,104,Current,0,0,0
2024-11-16,20,Current,0,0,0
2024-11-16,20,DPD15-29,148,148,0
2024-11-16,20,DPD3-14,212,212,0
2024-11-16,20,DPD30-59,97,97,0
2024-11-16,20,DPD60-89,0,0,0
2024-11-16,20,DPD90+,0,0,0
2024-11-16,22,Current,0,0,0
2024-11-16,22,DPD30-59,0,0,0
2024-11-16,22,DPD60-89,0,0,0
2024-11-16,22,DPD90+,0,0,0
2024-11-16,24,Current,70,70,0
2024-11-16,24,DPD15-29,77,77,0
2024-11-16,24,DPD3-14,129,129,0
2024-11-16,24,DPD30-59,44,44,0
2024-11-16,24,DPD60-89,0,0,0
2024-11-16,24,DPD90+,0,0,0
2024-11-16,26,Current,0,0,0
2024-11-16,26,DPD15-29,12,12,0
2024-11-16,26,DPD3-14,10,10,0
2024-11-16,26,DPD30-59,3,3,0
2024-11-16,26,DPD60-89,0,0,0
2024-11-16,26,DPD90+,0,0,0
2024-11-16,32,Current,0,0,0
2024-11-16,32,DPD15-29,87,87,0
2024-11-16,32,DPD3-14,68,68,0
2024-11-16,32,DPD30-59,38,38,0
2024-11-16,32,DPD60-89,0,0,0
2024-11-16,32,DPD90+,0,0,0
2024-11-16,34,Current,0,0,0
2024-11-16,34,DPD15-29,25,25,0
2024-11-16,34,DPD3-14,31,31,0
2024-11-16,34,DPD30-59,18,18,0
2024-11-16,34,DPD60-89,0,0,0
2024-11-16,34,DPD90+,0,0,0
2024-11-16,36,Current,0,0,0
2024-11-16,36,DPD15-29,27,27,0
2024-11-16,36,DPD3-14,17,17,0
2024-11-16,36,DPD30-59,11,11,0
2024-11-16,36,DPD60-89,0,0,0
2024-11-16,36,DPD90+,0,0,0
2024-11-16,38,Current,21,21,0
2024-11-16,38,DPD15-29,17,17,0
2024-11-16,38,DPD3-14,25,25,0
2024-11-16,38,DPD30-59,15,15,0
2024-11-16,38,DPD60-89,0,0,0
2024-11-16,38,DPD90+,0,0,0
2024-11-16,40,Current,0,0,0
2024-11-16,40,DPD15-29,15,15,0
2024-11-16,40,DPD3-14,18,18,0
2024-11-16,40,DPD30-59,6,6,0
2024-11-16,40,DPD60-89,0,0,0
2024-11-16,40,DPD90+,0,0,0
2024-11-16,42,Current,0,0,0
2024-11-16,42,DPD15-29,4,4,0
2024-11-16,42,DPD3-14,13,13,0
2024-11-16,42,DPD30-59,3,3,0
2024-11-16,42,DPD60-89,0,0,0
2024-11-16,42,DPD90+,0,0,0
2024-11-16,44,Current,0,0,0
2024-11-16,44,DPD15-29,17,17,0
2024-11-16,44,DPD3-14,30,30,0
2024-11-16,44,DPD30-59,9,9,0
2024-11-16,44,DPD60-89,0,0,0
2024-11-16,44,DPD90+,0,0,0
2024-11-16,46,Current,0,0,0
2024-11-16,46,DPD3-14,0,0,0
2024-11-16,48,Current,41,41,0
2024-11-16,48,DPD15-29,9,9,0
2024-11-16,48,DPD3-14,24,24,0
2024-11-16,48,DPD30-59,10,10,0
2024-11-16,48,DPD60-89,0,0,0
2024-11-16,48,DPD90+,0,0,0
2024-11-16,6,Current,0,0,0
2024-11-15,100,Current,0,0,0
2024-11-15,100,DPD3-14,0,0,0
2024-11-15,102,Current,0,0,0
2024-11-15,102,DPD30-59,0,0,0
2024-11-15,104,Current,0,0,0
2024-11-15,20,Current,3860,3860,0
2024-11-15,20,DPD15-29,301,301,0
2024-11-15,20,DPD3-14,338,338,0
2024-11-15,20,DPD30-59,211,211,0
2024-11-15,20,DPD60-89,34,34,0
2024-11-15,20,DPD90+,36,36,0
2024-11-15,22,Current,0,0,0
2024-11-15,22,DPD30-59,1,1,0
2024-11-15,22,DPD60-89,0,0,0
2024-11-15,22,DPD90+,0,0,0
2024-11-15,24,Current,4745,4745,0
2024-11-15,24,DPD15-29,158,158,0
2024-11-15,24,DPD3-14,238,238,0
2024-11-15,24,DPD30-59,125,125,0
2024-11-15,24,DPD60-89,20,20,0
2024-11-15,24,DPD90+,15,15,0
2024-11-15,26,Current,0,0,0
2024-11-15,26,DPD15-29,13,13,0
2024-11-15,26,DPD3-14,14,14,0
2024-11-15,26,DPD30-59,10,10,0
2024-11-15,26,DPD60-89,0,0,0
2024-11-15,26,DPD90+,0,0,0
2024-11-15,32,Current,194,194,0
2024-11-15,32,DPD15-29,141,141,0
2024-11-15,32,DPD3-14,122,122,0
2024-11-15,32,DPD30-59,80,80,0
2024-11-15,32,DPD60-89,3,3,0
2024-11-15,32,DPD90+,6,6,0
2024-11-15,34,Current,0,0,0
2024-11-15,34,DPD15-29,53,53,0
2024-11-15,34,DPD3-14,43,43,0
2024-11-15,34,DPD30-59,26,26,0
2024-11-15,34,DPD60-89,0,0,0
2024-11-15,34,DPD90+,0,0,0
2024-11-15,36,Current,220,220,0
2024-11-15,36,DPD15-29,36,36,0
2024-11-15,36,DPD3-14,40,40,0
2024-11-15,36,DPD30-59,23,23,0
2024-11-15,36,DPD60-89,1,1,0
2024-11-15,36,DPD90+,0,0,0
2024-11-15,38,Current,234,234,0
2024-11-15,38,DPD15-29,26,26,0
2024-11-15,38,DPD3-14,34,34,0
2024-11-15,38,DPD30-59,22,22,0
2024-11-15,38,DPD60-89,0,0,0
2024-11-15,38,DPD90+,0,0,0
2024-11-15,40,Current,238,238,0
2024-11-15,40,DPD15-29,17,17,0
2024-11-15,40,DPD3-14,29,29,0
2024-11-15,40,DPD30-59,11,11,0
2024-11-15,40,DPD60-89,2,2,0
2024-11-15,40,DPD90+,1,1,0
2024-11-15,42,Current,0,0,0
2024-11-15,42,DPD15-29,13,13,0
2024-11-15,42,DPD3-14,15,15,0
2024-11-15,42,DPD30-59,8,8,0
2024-11-15,42,DPD60-89,0,0,0
2024-11-15,42,DPD90+,0,0,0
2024-11-15,44,Current,156,156,0
2024-11-15,44,DPD15-29,25,25,0
2024-11-15,44,DPD3-14,41,41,0
2024-11-15,44,DPD30-59,19,19,0
2024-11-15,44,DPD60-89,1,1,0
2024-11-15,44,DPD90+,1,1,0
2024-11-15,46,Current,4,4,0
2024-11-15,46,DPD3-14,2,2,0
2024-11-15,48,Current,4468,4468,0
2024-11-15,48,DPD15-29,43,43,0
2024-11-15,48,DPD3-14,97,97,0
2024-11-15,48,DPD30-59,55,55,0
2024-11-15,48,DPD60-89,18,18,0
2024-11-15,48,DPD90+,19,19,0
2024-11-15,6,Current,0,0,0
2024-11-14,100,Current,0,0,0
2024-11-14,100,DPD3-14,0,0,0
2024-11-14,102,Current,0,0,0
2024-11-14,102,DPD30-59,0,0,0
2024-11-14,104,Current,0,0,0
2024-11-14,20,Current,0,0,0
2024-11-14,20,DPD15-29,219,219,0
2024-11-14,20,DPD3-14,174,174,0
2024-11-14,20,DPD30-59,22,22,0
2024-11-14,20,DPD60-89,0,0,0
2024-11-14,20,DPD90+,0,0,0
2024-11-14,22,Current,0,0,0
2024-11-14,22,DPD30-59,0,0,0
2024-11-14,22,DPD60-89,0,0,0
2024-11-14,22,DPD90+,0,0,0
2024-11-14,24,Current,23,23,0
2024-11-14,24,DPD15-29,124,124,0
2024-11-14,24,DPD3-14,109,109,0
2024-11-14,24,DPD30-59,17,17,0
2024-11-14,24,DPD60-89,0,0,0
2024-11-14,24,DPD90+,0,0,0
2024-11-14,26,Current,0,0,0
2024-11-14,26,DPD15-29,16,16,0
2024-11-14,26,DPD3-14,12,12,0
2024-11-14,26,DPD30-59,0,0,0
2024-11-14,26,DPD60-89,0,0,0
2024-11-14,26,DPD90+,0,0,0
2024-11-14,32,Current,0,0,0
2024-11-14,32,DPD15-29,125,125,0
2024-11-14,32,DPD3-14,62,62,0
2024-11-14,32,DPD30-59,21,21,0
2024-11-14,32,DPD60-89,0,0,0
2024-11-14,32,DPD90+,0,0,0
2024-11-14,34,Current,0,0,0
2024-11-14,34,DPD15-29,37,37,0
2024-11-14,34,DPD3-14,29,29,0
2024-11-14,34,DPD30-59,7,7,0
2024-11-14,34,DPD60-89,0,0,0
2024-11-14,34,DPD90+,0,0,0
2024-11-14,36,Current,0,0,0
2024-11-14,36,DPD15-29,37,37,0
2024-11-14,36,DPD3-14,15,15,0
2024-11-14,36,DPD30-59,3,3,0
2024-11-14,36,DPD60-89,0,0,0
2024-11-14,36,DPD90+,0,0,0
2024-11-14,38,Current,0,0,0
2024-11-14,38,DPD15-29,28,28,0
2024-11-14,38,DPD3-14,16,16,0
2024-11-14,38,DPD30-59,6,6,0
2024-11-14,38,DPD60-89,0,0,0
2024-11-14,38,DPD90+,0,0,0
2024-11-14,40,Current,0,0,0
2024-11-14,40,DPD15-29,18,18,0
2024-11-14,40,DPD3-14,14,14,0
2024-11-14,40,DPD30-59,5,5,0
2024-11-14,40,DPD60-89,0,0,0
2024-11-14,40,DPD90+,0,0,0
2024-11-14,42,Current,0,0,0
2024-11-14,42,DPD15-29,9,9,0
2024-11-14,42,DPD3-14,8,8,0
2024-11-14,42,DPD30-59,1,1,0
2024-11-14,42,DPD60-89,0,0,0
2024-11-14,42,DPD90+,0,0,0
2024-11-14,44,Current,0,0,0
2024-11-14,44,DPD15-29,24,24,0
2024-11-14,44,DPD3-14,25,25,0
2024-11-14,44,DPD30-59,4,4,0
2024-11-14,44,DPD60-89,0,0,0
2024-11-14,44,DPD90+,0,0,0
2024-11-14,46,Current,0,0,0
2024-11-14,46,DPD3-14,0,0,0
2024-11-14,48,Current,24,24,0
2024-11-14,48,DPD15-29,16,16,0
2024-11-14,48,DPD3-14,21,21,0
2024-11-14,48,DPD30-59,6,6,0
2024-11-14,48,DPD60-89,0,0,0
2024-11-14,48,DPD90+,0,0,0
2024-11-14,6,Current,0,0,0
2024-11-13,100,Current,0,0,0
2024-11-13,100,DPD3-14,0,0,0
2024-11-13,102,Current,0,0,0
2024-11-13,102,DPD3-14,0,0,0
2024-11-13,102,DPD30-59,0,0,0
2024-11-13,104,Current,0,0,0
2024-11-13,150,Current,5,5,0
2024-11-13,20,Current,0,0,0
2024-11-13,20,DPD15-29,293,293,0
2024-11-13,20,DPD3-14,232,232,0
2024-11-13,20,DPD30-59,94,94,0
2024-11-13,20,DPD60-89,0,0,0
2024-11-13,20,DPD90+,0,0,0
2024-11-13,22,Current,0,0,0
2024-11-13,22,DPD15-29,1,1,0
2024-11-13,22,DPD30-59,0,0,0
2024-11-13,22,DPD60-89,0,0,0
2024-11-13,22,DPD90+,0,0,0
2024-11-13,24,Current,14,14,0
2024-11-13,24,DPD15-29,152,152,0
2024-11-13,24,DPD3-14,170,170,0
2024-11-13,24,DPD30-59,73,73,0
2024-11-13,24,DPD60-89,0,0,0
2024-11-13,24,DPD90+,0,0,0
2024-11-13,26,Current,0,0,0
2024-11-13,26,DPD15-29,18,18,0
2024-11-13,26,DPD3-14,11,11,0
2024-11-13,26,DPD30-59,9,9,0
2024-11-13,26,DPD60-89,0,0,0
2024-11-13,26,DPD90+,0,0,0
2024-11-13,32,Current,0,0,0
2024-11-13,32,DPD15-29,156,156,0
2024-11-13,32,DPD3-14,118,118,0
2024-11-13,32,DPD30-59,63,63,0
2024-11-13,32,DPD60-89,0,0,0
2024-11-13,32,DPD90+,0,0,0
2024-11-13,34,Current,0,0,0
2024-11-13,34,DPD15-29,64,64,0
2024-11-13,34,DPD3-14,36,36,0
2024-11-13,34,DPD30-59,25,25,0
2024-11-13,34,DPD60-89,0,0,0
2024-11-13,34,DPD90+,0,0,0
2024-11-13,36,Current,0,0,0
2024-11-13,36,DPD15-29,39,39,0
2024-11-13,36,DPD3-14,40,40,0
2024-11-13,36,DPD30-59,9,9,0
2024-11-13,36,DPD60-89,0,0,0
2024-11-13,36,DPD90+,0,0,0
2024-11-13,38,Current,0,0,0
2024-11-13,38,DPD15-29,35,35,0
2024-11-13,38,DPD3-14,35,35,0
2024-11-13,38,DPD30-59,13,13,0
2024-11-13,38,DPD60-89,0,0,0
2024-11-13,38,DPD90+,0,0,0
2024-11-13,40,Current,0,0,0
2024-11-13,40,DPD15-29,19,19,0
2024-11-13,40,DPD3-14,27,27,0
2024-11-13,40,DPD30-59,4,4,0
2024-11-13,40,DPD60-89,0,0,0
2024-11-13,40,DPD90+,0,0,0
2024-11-13,42,Current,0,0,0
2024-11-13,42,DPD15-29,11,11,0
2024-11-13,42,DPD3-14,18,18,0
2024-11-13,42,DPD30-59,4,4,0
2024-11-13,42,DPD60-89,0,0,0
2024-11-13,42,DPD90+,0,0,0
2024-11-13,44,Current,0,0,0
2024-11-13,44,DPD15-29,32,32,0
2024-11-13,44,DPD3-14,42,42,0
2024-11-13,44,DPD30-59,8,8,0
2024-11-13,44,DPD60-89,0,0,0
2024-11-13,44,DPD90+,0,0,0
2024-11-13,46,Current,0,0,0
2024-11-13,46,DPD3-14,2,2,0
2024-11-13,48,Current,47,47,0
2024-11-13,48,DPD15-29,17,17,0
2024-11-13,48,DPD3-14,44,44,0
2024-11-13,48,DPD30-59,15,15,0
2024-11-13,48,DPD60-89,0,0,0
2024-11-13,48,DPD90+,0,0,0
2024-11-13,6,Current,0,0,0
2024-11-12,100,Current,0,0,0
2024-11-12,100,DPD3-14,0,0,0
2024-11-12,102,Current,0,0,0
2024-11-12,102,DPD3-14,0,0,0
2024-11-12,102,DPD30-59,0,0,0
2024-11-12,104,Current,0,0,0
2024-11-12,150,Current,4,4,0
2024-11-12,20,Current,0,0,0
2024-11-12,20,DPD15-29,255,255,0
2024-11-12,20,DPD3-14,150,150,0
2024-11-12,20,DPD30-59,104,104,0
2024-11-12,20,DPD60-89,0,0,0
2024-11-12,20,DPD90+,0,0,0
2024-11-12,22,Current,0,0,0
2024-11-12,22,DPD15-29,0,0,0
2024-11-12,22,DPD30-59,0,0,0
2024-11-12,22,DPD60-89,0,0,0
2024-11-12,22,DPD90+,0,0,0
2024-11-12,24,Current,50,50,0
2024-11-12,24,DPD15-29,135,135,0
2024-11-12,24,DPD3-14,102,102,0
2024-11-12,24,DPD30-59,31,31,0
2024-11-12,24,DPD60-89,0,0,0
2024-11-12,24,DPD90+,0,0,0
2024-11-12,26,Current,0,0,0
2024-11-12,26,DPD15-29,15,15,0
2024-11-12,26,DPD3-14,12,12,0
2024-11-12,26,DPD30-59,4,4,0
2024-11-12,26,DPD60-89,0,0,0
2024-11-12,26,DPD90+,0,0,0
2024-11-12,32,Current,0,0,0
2024-11-12,32,DPD15-29,152,152,0
2024-11-12,32,DPD3-14,45,45,0
2024-11-12,32,DPD30-59,29,29,0
2024-11-12,32,DPD60-89,0,0,0
2024-11-12,32,DPD90+,0,0,0
2024-11-12,34,Current,0,0,0
2024-11-12,34,DPD15-29,48,48,0
2024-11-12,34,DPD3-14,29,29,0
2024-11-12,34,DPD30-59,13,13,0
2024-11-12,34,DPD60-89,0,0,0
2024-11-12,34,DPD90+,0,0,0
2024-11-12,36,Current,0,0,0
2024-11-12,36,DPD15-29,42,42,0
2024-11-12,36,DPD3-14,19,19,0
2024-11-12,36,DPD30-59,7,7,0
2024-11-12,36,DPD60-89,0,0,0
2024-11-12,36,DPD90+,0,0,0
2024-11-12,38,Current,0,0,0
2024-11-12,38,DPD15-29,35,35,0
2024-11-12,38,DPD3-14,8,8,0
2024-11-12,38,DPD30-59,9,9,0
2024-11-12,38,DPD60-89,0,0,0
2024-11-12,38,DPD90+,0,0,0
2024-11-12,40,Current,0,0,0
2024-11-12,40,DPD15-29,23,23,0
2024-11-12,40,DPD3-14,13,13,0
2024-11-12,40,DPD30-59,8,8,0
2024-11-12,40,DPD60-89,0,0,0
2024-11-12,40,DPD90+,0,0,0
2024-11-12,42,Current,0,0,0
2024-11-12,42,DPD15-29,9,9,0
2024-11-12,42,DPD3-14,9,9,0
2024-11-12,42,DPD30-59,3,3,0
2024-11-12,42,DPD60-89,0,0,0
2024-11-12,42,DPD90+,0,0,0
2024-11-12,44,Current,0,0,0
2024-11-12,44,DPD15-29,27,27,0
2024-11-12,44,DPD3-14,24,24,0
2024-11-12,44,DPD30-59,9,9,0
2024-11-12,44,DPD60-89,0,0,0
2024-11-12,44,DPD90+,0,0,0
2024-11-12,46,Current,0,0,0
2024-11-12,46,DPD3-14,0,0,0
2024-11-12,48,Current,59,59,0
2024-11-12,48,DPD15-29,20,20,0
2024-11-12,48,DPD3-14,21,21,0
2024-11-12,48,DPD30-59,8,8,0
2024-11-12,48,DPD60-89,0,0,0
2024-11-12,48,DPD90+,0,0,0
2024-11-12,6,Current,0,0,0
2024-11-11,100,Current,0,0,0
2024-11-11,100,DPD3-14,0,0,0
2024-11-11,102,Current,0,0,0
2024-11-11,102,DPD3-14,0,0,0
2024-11-11,102,DPD30-59,0,0,0
2024-11-11,104,Current,0,0,0
2024-11-11,150,Current,11,11,0
2024-11-11,20,Current,0,0,0
2024-11-11,20,DPD15-29,205,205,0
2024-11-11,20,DPD3-14,323,323,0
2024-11-11,20,DPD30-59,140,140,0
2024-11-11,20,DPD60-89,0,0,0
2024-11-11,20,DPD90+,0,0,0
2024-11-11,22,Current,0,0,0
2024-11-11,22,DPD15-29,1,1,0
2024-11-11,22,DPD30-59,1,1,0
2024-11-11,22,DPD60-89,0,0,0
2024-11-11,22,DPD90+,0,0,0
2024-11-11,24,Current,76,76,0
2024-11-11,24,DPD15-29,116,116,0
2024-11-11,24,DPD3-14,188,188,0
2024-11-11,24,DPD30-59,98,98,0
2024-11-11,24,DPD60-89,0,0,0
2024-11-11,24,DPD90+,0,0,0
2024-11-11,26,Current,0,0,0
2024-11-11,26,DPD15-29,14,14,0
2024-11-11,26,DPD3-14,16,16,0
2024-11-11,26,DPD30-59,12,12,0
2024-11-11,26,DPD60-89,0,0,0
2024-11-11,26,DPD90+,0,0,0
2024-11-11,32,Current,0,0,0
2024-11-11,32,DPD15-29,115,115,0
2024-11-11,32,DPD3-14,139,139,0
2024-11-11,32,DPD30-59,76,76,0
2024-11-11,32,DPD60-89,0,0,0
2024-11-11,32,DPD90+,0,0,0
2024-11-11,34,Current,0,0,0
2024-11-11,34,DPD15-29,43,43,0
2024-11-11,34,DPD3-14,51,51,0
2024-11-11,34,DPD30-59,23,23,0
2024-11-11,34,DPD60-89,0,0,0
2024-11-11,34,DPD90+,0,0,0
2024-11-11,36,Current,0,0,0
2024-11-11,36,DPD15-29,27,27,0
2024-11-11,36,DPD3-14,47,47,0
2024-11-11,36,DPD30-59,17,17,0
2024-11-11,36,DPD60-89,0,0,0
2024-11-11,36,DPD90+,0,0,0
2024-11-11,38,Current,0,0,0
2024-11-11,38,DPD15-29,20,20,0
2024-11-11,38,DPD3-14,44,44,0
2024-11-11,38,DPD30-59,23,23,0
2024-11-11,38,DPD60-89,0,0,0
2024-11-11,38,DPD90+,0,0,0
2024-11-11,40,Current,0,0,0
2024-11-11,40,DPD15-29,13,13,0
2024-11-11,40,DPD3-14,19,19,0
2024-11-11,40,DPD30-59,10,10,0
2024-11-11,40,DPD60-89,0,0,0
2024-11-11,40,DPD90+,0,0,0
2024-11-11,42,Current,0,0,0
2024-11-11,42,DPD15-29,11,11,0
2024-11-11,42,DPD3-14,13,13,0
2024-11-11,42,DPD30-59,12,12,0
2024-11-11,42,DPD60-89,0,0,0
2024-11-11,42,DPD90+,0,0,0
2024-11-11,44,Current,0,0,0
2024-11-11,44,DPD15-29,26,26,0
2024-11-11,44,DPD3-14,41,41,0
2024-11-11,44,DPD30-59,18,18,0
2024-11-11,44,DPD60-89,0,0,0
2024-11-11,44,DPD90+,0,0,0
2024-11-11,46,Current,0,0,0
2024-11-11,46,DPD3-14,2,2,0
2024-11-11,48,Current,64,64,0
2024-11-11,48,DPD15-29,17,17,0
2024-11-11,48,DPD3-14,43,43,0
2024-11-11,48,DPD30-59,25,25,0
2024-11-11,48,DPD60-89,0,0,0
2024-11-11,48,DPD90+,0,0,0
2024-11-11,6,Current,0,0,0
2024-11-10,100,Current,0,0,0
2024-11-10,100,DPD3-14,0,0,0
2024-11-10,102,Current,0,0,0
2024-11-10,102,DPD3-14,0,0,0
2024-11-10,102,DPD30-59,0,0,0
2024-11-10,104,Current,0,0,0
2024-11-10,150,Current,18,18,0
2024-11-10,20,Current,0,0,0
2024-11-10,20,DPD15-29,212,212,0
2024-11-10,20,DPD3-14,180,180,0
2024-11-10,20,DPD30-59,22,22,0
2024-11-10,20,DPD60-89,0,0,0
2024-11-10,20,DPD90+,0,0,0
2024-11-10,22,Current,0,0,0
2024-11-10,22,DPD15-29,0,0,0
2024-11-10,22,DPD30-59,0,0,0
2024-11-10,22,DPD60-89,0,0,0
2024-11-10,22,DPD90+,0,0,0
2024-11-10,24,Current,81,81,0
2024-11-10,24,DPD15-29,107,107,0
2024-11-10,24,DPD3-14,127,127,0
2024-11-10,24,DPD30-59,11,11,0
2024-11-10,24,DPD60-89,0,0,0
2024-11-10,24,DPD90+,0,0,0
2024-11-10,26,Current,0,0,0
2024-11-10,26,DPD15-29,13,13,0
2024-11-10,26,DPD3-14,16,16,0
2024-11-10,26,DPD30-59,1,1,0
2024-11-10,26,DPD60-89,0,0,0
2024-11-10,26,DPD90+,0,0,0
2024-11-10,32,Current,0,0,0
2024-11-10,32,DPD15-29,130,130,0
2024-11-10,32,DPD3-14,70,70,0
2024-11-10,32,DPD30-59,11,11,0
2024-11-10,32,DPD60-89,0,0,0
2024-11-10,32,DPD90+,0,0,0
2024-11-10,34,Current,0,0,0
2024-11-10,34,DPD15-29,43,43,0
2024-11-10,34,DPD3-14,36,36,0
2024-11-10,34,DPD30-59,4,4,0
2024-11-10,34,DPD60-89,0,0,0
2024-11-10,34,DPD90+,0,0,0
2024-11-10,36,Current,0,0,0
2024-11-10,36,DPD15-29,37,37,0
2024-11-10,36,DPD3-14,28,28,0
2024-11-10,36,DPD30-59,3,3,0
2024-11-10,36,DPD60-89,0,0,0
2024-11-10,36,DPD90+,0,0,0
2024-11-10,38,Current,2,2,0
2024-11-10,38,DPD15-29,35,35,0
2024-11-10,38,DPD3-14,14,14,0
2024-11-10,38,DPD30-59,4,4,0
2024-11-10,38,DPD60-89,0,0,0
2024-11-10,38,DPD90+,0,0,0
2024-11-10,40,Current,0,0,0
2024-11-10,40,DPD15-29,19,19,0
2024-11-10,40,DPD3-14,16,16,0
2024-11-10,40,DPD30-59,5,5,0
2024-11-10,40,DPD60-89,0,0,0
2024-11-10,40,DPD90+,0,0,0
2024-11-10,42,Current,0,0,0
2024-11-10,42,DPD15-29,7,7,0
2024-11-10,42,DPD3-14,10,10,0
2024-11-10,42,DPD30-59,1,1,0
2024-11-10,42,DPD60-89,0,0,0
2024-11-10,42,DPD90+,0,0,0
2024-11-10,44,Current,0,0,0
2024-11-10,44,DPD15-29,21,21,0
2024-11-10,44,DPD3-14,29,29,0
2024-11-10,44,DPD30-59,4,4,0
2024-11-10,44,DPD60-89,0,0,0
2024-11-10,44,DPD90+,0,0,0
2024-11-10,46,Current,0,0,0
2024-11-10,46,DPD3-14,0,0,0
2024-11-10,48,Current,37,37,0
2024-11-10,48,DPD15-29,16,16,0
2024-11-10,48,DPD3-14,25,25,0
2024-11-10,48,DPD30-59,3,3,0
2024-11-10,48,DPD60-89,0,0,0
2024-11-10,48,DPD90+,0,0,0
2024-11-10,6,Current,0,0,0
2024-11-09,100,Current,0,0,0
2024-11-09,100,DPD3-14,0,0,0
2024-11-09,102,Current,0,0,0
2024-11-09,102,DPD3-14,0,0,0
2024-11-09,102,DPD30-59,0,0,0
2024-11-09,104,Current,0,0,0
2024-11-09,150,Current,10,10,0
2024-11-09,20,Current,0,0,0
2024-11-09,20,DPD15-29,193,193,0
2024-11-09,20,DPD3-14,314,314,0
2024-11-09,20,DPD30-59,77,77,0
2024-11-09,20,DPD60-89,0,0,0
2024-11-09,20,DPD90+,0,0,0
2024-11-09,22,Current,0,0,0
2024-11-09,22,DPD15-29,1,1,0
2024-11-09,22,DPD30-59,0,0,0
2024-11-09,22,DPD60-89,0,0,0
2024-11-09,22,DPD90+,0,0,0
2024-11-09,24,Current,50,50,0
2024-11-09,24,DPD15-29,112,112,0
2024-11-09,24,DPD3-14,181,181,0
2024-11-09,24,DPD30-59,56,56,0
2024-11-09,24,DPD60-89,0,0,0
2024-11-09,24,DPD90+,0,0,0
2024-11-09,26,Current,0,0,0
2024-11-09,26,DPD15-29,17,17,0
2024-11-09,26,DPD3-14,15,15,0
2024-11-09,26,DPD30-59,9,9,0
2024-11-09,26,DPD60-89,0,0,0
2024-11-09,26,DPD90+,0,0,0
2024-11-09,32,Current,0,0,0
2024-11-09,32,DPD15-29,103,103,0
2024-11-09,32,DPD3-14,144,144,0
2024-11-09,32,DPD30-59,53,53,0
2024-11-09,32,DPD60-89,0,0,0
2024-11-09,32,DPD90+,0,0,0
2024-11-09,34,Current,0,0,0
2024-11-09,34,DPD15-29,37,37,0
2024-11-09,34,DPD3-14,48,48,0
2024-11-09,34,DPD30-59,23,23,0
2024-11-09,34,DPD60-89,0,0,0
2024-11-09,34,DPD90+,0,0,0
2024-11-09,36,Current,0,0,0
2024-11-09,36,DPD15-29,26,26,0
2024-11-09,36,DPD3-14,48,48,0
2024-11-09,36,DPD30-59,10,10,0
2024-11-09,36,DPD60-89,0,0,0
2024-11-09,36,DPD90+,0,0,0
2024-11-09,38,Current,0,0,0
2024-11-09,38,DPD15-29,18,18,0
2024-11-09,38,DPD3-14,43,43,0
2024-11-09,38,DPD30-59,12,12,0
2024-11-09,38,DPD60-89,0,0,0
2024-11-09,38,DPD90+,0,0,0
2024-11-09,40,Current,0,0,0
2024-11-09,40,DPD15-29,14,14,0
2024-11-09,40,DPD3-14,16,16,0
2024-11-09,40,DPD30-59,2,2,0
2024-11-09,40,DPD60-89,0,0,0
2024-11-09,40,DPD90+,0,0,0
2024-11-09,42,Current,0,0,0
2024-11-09,42,DPD15-29,8,8,0
2024-11-09,42,DPD3-14,13,13,0
2024-11-09,42,DPD30-59,2,2,0
2024-11-09,42,DPD60-89,0,0,0
2024-11-09,42,DPD90+,0,0,0
2024-11-09,44,Current,0,0,0
2024-11-09,44,DPD15-29,23,23,0
2024-11-09,44,DPD3-14,32,32,0
2024-11-09,44,DPD30-59,9,9,0
2024-11-09,44,DPD60-89,0,0,0
2024-11-09,44,DPD90+,0,0,0
2024-11-09,46,Current,0,0,0
2024-11-09,48,Current,37,37,0
2024-11-09,48,DPD15-29,17,17,0
2024-11-09,48,DPD3-14,39,39,0
2024-11-09,48,DPD30-59,15,15,0
2024-11-09,48,DPD60-89,0,0,0
2024-11-09,48,DPD90+,0,0,0
2024-11-09,6,Current,0,0,0
2024-11-08,100,Current,0,0,0
2024-11-08,100,DPD3-14,0,0,0
2024-11-08,102,Current,0,0,0
2024-11-08,102,DPD30-59,0,0,0
2024-11-08,104,Current,0,0,0
2024-11-08,150,Current,11,11,0
2024-11-08,20,Current,0,0,0
2024-11-08,20,DPD15-29,203,203,0
2024-11-08,20,DPD3-14,203,203,0
2024-11-08,20,DPD30-59,81,81,0
2024-11-08,20,DPD60-89,0,0,0
2024-11-08,20,DPD90+,0,0,0
2024-11-08,22,Current,0,0,0
2024-11-08,22,DPD15-29,0,0,0
2024-11-08,22,DPD30-59,0,0,0
2024-11-08,22,DPD60-89,0,0,0
2024-11-08,22,DPD90+,0,0,0
2024-11-08,24,Current,29,29,0
2024-11-08,24,DPD15-29,108,108,0
2024-11-08,24,DPD3-14,106,106,0
2024-11-08,24,DPD30-59,33,33,0
2024-11-08,24,DPD60-89,0,0,0
2024-11-08,24,DPD90+,0,0,0
2024-11-08,26,Current,0,0,0
2024-11-08,26,DPD15-29,15,15,0
2024-11-08,26,DPD3-14,13,13,0
2024-11-08,26,DPD30-59,2,2,0
2024-11-08,26,DPD60-89,0,0,0
2024-11-08,26,DPD90+,0,0,0
2024-11-08,32,Current,0,0,0
2024-11-08,32,DPD15-29,114,114,0
2024-11-08,32,DPD3-14,86,86,0
2024-11-08,32,DPD30-59,35,35,0
2024-11-08,32,DPD60-89,0,0,0
2024-11-08,32,DPD90+,0,0,0
2024-11-08,34,Current,0,0,0
2024-11-08,34,DPD15-29,46,46,0
2024-11-08,34,DPD3-14,38,38,0
2024-11-08,34,DPD30-59,13,13,0
2024-11-08,34,DPD60-89,0,0,0
2024-11-08,34,DPD90+,0,0,0
2024-11-08,36,Current,0,0,0
2024-11-08,36,DPD15-29,36,36,0
2024-11-08,36,DPD3-14,32,32,0
2024-11-08,36,DPD30-59,6,6,0
2024-11-08,36,DPD60-89,0,0,0
2024-11-08,36,DPD90+,0,0,0
2024-11-08,38,Current,0,0,0
2024-11-08,38,DPD15-29,37,37,0
2024-11-08,38,DPD3-14,21,21,0
2024-11-08,38,DPD30-59,10,10,0
2024-11-08,38,DPD60-89,0,0,0
2024-11-08,38,DPD90+,0,0,0
2024-11-08,40,Current,0,0,0
2024-11-08,40,DPD15-29,18,18,0
2024-11-08,40,DPD3-14,17,17,0
2024-11-08,40,DPD30-59,10,10,0
2024-11-08,40,DPD60-89,0,0,0
2024-11-08,40,DPD90+,0,0,0
2024-11-08,42,Current,0,0,0
2024-11-08,42,DPD15-29,9,9,0
2024-11-08,42,DPD3-14,12,12,0
2024-11-08,42,DPD30-59,2,2,0
2024-11-08,42,DPD60-89,0,0,0
2024-11-08,42,DPD90+,0,0,0
2024-11-08,44,Current,0,0,0
2024-11-08,44,DPD15-29,25,25,0
2024-11-08,44,DPD3-14,23,23,0
2024-11-08,44,DPD30-59,10,10,0
2024-11-08,44,DPD60-89,0,0,0
2024-11-08,44,DPD90+,0,0,0
2024-11-08,46,Current,0,0,0
2024-11-08,48,Current,57,57,0
2024-11-08,48,DPD15-29,13,13,0
2024-11-08,48,DPD3-14,21,21,0
2024-11-08,48,DPD30-59,9,9,0
2024-11-08,48,DPD60-89,0,0,0
2024-11-08,48,DPD90+,0,0,0
2024-11-08,6,Current,0,0,0
2024-11-07,100,Current,0,0,0
2024-11-07,100,DPD3-14,0,0,0
2024-11-07,102,Current,0,0,0
2024-11-07,102,DPD30-59,0,0,0
2024-11-07,104,Current,0,0,0
2024-11-07,150,Current,8,8,0
2024-11-07,20,Current,0,0,0
2024-11-07,20,DPD15-29,218,218,0
2024-11-07,20,DPD3-14,349,349,0
2024-11-07,20,DPD30-59,173,173,0
2024-11-07,20,DPD60-89,0,0,0
2024-11-07,20,DPD90+,0,0,0
2024-11-07,22,Current,0,0,0
2024-11-07,22,DPD15-29,1,1,0
2024-11-07,22,DPD30-59,1,1,0
2024-11-07,22,DPD60-89,0,0,0
2024-11-07,22,DPD90+,0,0,0
2024-11-07,24,Current,47,47,0
2024-11-07,24,DPD15-29,127,127,0
2024-11-07,24,DPD3-14,182,182,0
2024-11-07,24,DPD30-59,103,103,0
2024-11-07,24,DPD60-89,0,0,0
2024-11-07,24,DPD90+,0,0,0
2024-11-07,26,Current,0,0,0
2024-11-07,26,DPD15-29,15,15,0
2024-11-07,26,DPD3-14,22,22,0
2024-11-07,26,DPD30-59,10,10,0
2024-11-07,26,DPD60-89,0,0,0
2024-11-07,26,DPD90+,0,0,0
2024-11-07,32,Current,0,0,0
2024-11-07,32,DPD15-29,121,121,0
2024-11-07,32,DPD3-14,164,164,0
2024-11-07,32,DPD30-59,77,77,0
2024-11-07,32,DPD60-89,0,0,0
2024-11-07,32,DPD90+,0,0,0
2024-11-07,34,Current,0,0,0
2024-11-07,34,DPD15-29,41,41,0
2024-11-07,34,DPD3-14,55,55,0
2024-11-07,34,DPD30-59,30,30,0
2024-11-07,34,DPD60-89,0,0,0
2024-11-07,34,DPD90+,0,0,0
2024-11-07,36,Current,0,0,0
2024-11-07,36,DPD15-29,29,29,0
2024-11-07,36,DPD3-14,49,49,0
2024-11-07,36,DPD30-59,15,15,0
2024-11-07,36,DPD60-89,0,0,0
2024-11-07,36,DPD90+,0,0,0
2024-11-07,38,Current,0,0,0
2024-11-07,38,DPD15-29,21,21,0
2024-11-07,38,DPD3-14,43,43,0
2024-11-07,38,DPD30-59,26,26,0
2024-11-07,38,DPD60-89,0,0,0
2024-11-07,38,DPD90+,0,0,0
2024-11-07,40,Current,0,0,0
2024-11-07,40,DPD15-29,15,15,0
2024-11-07,40,DPD3-14,21,21,0
2024-11-07,40,DPD30-59,10,10,0
2024-11-07,40,DPD60-89,0,0,0
2024-11-07,40,DPD90+,0,0,0
2024-11-07,42,Current,0,0,0
2024-11-07,42,DPD15-29,7,7,0
2024-11-07,42,DPD3-14,15,15,0
2024-11-07,42,DPD30-59,12,12,0
2024-11-07,42,DPD60-89,0,0,0
2024-11-07,42,DPD90+,0,0,0
2024-11-07,44,Current,0,0,0
2024-11-07,44,DPD15-29,25,25,0
2024-11-07,44,DPD3-14,38,38,0
2024-11-07,44,DPD30-59,19,19,0
2024-11-07,44,DPD60-89,0,0,0
2024-11-07,44,DPD90+,0,0,0
2024-11-07,46,Current,0,0,0
2024-11-07,48,Current,51,51,0
2024-11-07,48,DPD15-29,21,21,0
2024-11-07,48,DPD3-14,27,27,0
2024-11-07,48,DPD30-59,25,25,0
2024-11-07,48,DPD60-89,0,0,0
2024-11-07,48,DPD90+,0,0,0
2024-11-07,6,Current,0,0,0
2024-11-06,100,Current,0,0,0
2024-11-06,100,DPD3-14,0,0,0
2024-11-06,102,Current,0,0,0
2024-11-06,102,DPD30-59,0,0,0
2024-11-06,104,Current,0,0,0
2024-11-06,150,Current,7,7,0
2024-11-06,20,Current,0,0,0
2024-11-06,20,DPD15-29,211,211,0
2024-11-06,20,DPD3-14,214,214,0
2024-11-06,20,DPD30-59,15,15,0
2024-11-06,20,DPD60-89,0,0,0
2024-11-06,20,DPD90+,0,0,0
2024-11-06,22,Current,0,0,0
2024-11-06,22,DPD15-29,0,0,0
2024-11-06,22,DPD30-59,0,0,0
2024-11-06,22,DPD60-89,0,0,0
2024-11-06,22,DPD90+,0,0,0
2024-11-06,24,Current,33,33,0
2024-11-06,24,DPD15-29,110,110,0
2024-11-06,24,DPD3-14,110,110,0
2024-11-06,24,DPD30-59,4,4,0
2024-11-06,24,DPD60-89,0,0,0
2024-11-06,24,DPD90+,0,0,0
2024-11-06,26,Current,0,0,0
2024-11-06,26,DPD15-29,12,12,0
2024-11-06,26,DPD3-14,13,13,0
2024-11-06,26,DPD30-59,2,2,0
2024-11-06,26,DPD60-89,0,0,0
2024-11-06,26,DPD90+,0,0,0
2024-11-06,32,Current,0,0,0
2024-11-06,32,DPD15-29,115,115,0
2024-11-06,32,DPD3-14,107,107,0
2024-11-06,32,DPD30-59,4,4,0
2024-11-06,32,DPD60-89,0,0,0
2024-11-06,32,DPD90+,0,0,0
2024-11-06,34,Current,0,0,0
2024-11-06,34,DPD15-29,46,46,0
2024-11-06,34,DPD3-14,39,39,0
2024-11-06,34,DPD30-59,1,1,0
2024-11-06,34,DPD60-89,0,0,0
2024-11-06,34,DPD90+,0,0,0
2024-11-06,36,Current,0,0,0
2024-11-06,36,DPD15-29,34,34,0
2024-11-06,36,DPD3-14,33,33,0
2024-11-06,36,DPD30-59,0,0,0
2024-11-06,36,DPD60-89,0,0,0
2024-11-06,36,DPD90+,0,0,0
2024-11-06,38,Current,0,0,0
2024-11-06,38,DPD15-29,35,35,0
2024-11-06,38,DPD3-14,24,24,0
2024-11-06,38,DPD30-59,2,2,0
2024-11-06,38,DPD60-89,0,0,0
2024-11-06,38,DPD90+,0,0,0
2024-11-06,40,Current,0,0,0
2024-11-06,40,DPD15-29,16,16,0
2024-11-06,40,DPD3-14,16,16,0
2024-11-06,40,DPD30-59,2,2,0
2024-11-06,40,DPD60-89,0,0,0
2024-11-06,40,DPD90+,0,0,0
2024-11-06,42,Current,0,0,0
2024-11-06,42,DPD15-29,10,10,0
2024-11-06,42,DPD3-14,14,14,0
2024-11-06,42,DPD30-59,1,1,0
2024-11-06,42,DPD60-89,0,0,0
2024-11-06,42,DPD90+,0,0,0
2024-11-06,44,Current,0,0,0
2024-11-06,44,DPD15-29,24,24,0
2024-11-06,44,DPD3-14,30,30,0
2024-11-06,44,DPD30-59,2,2,0
2024-11-06,44,DPD60-89,0,0,0
2024-11-06,44,DPD90+,0,0,0
2024-11-06,46,Current,0,0,0
2024-11-06,46,DPD30-59,0,0,0
2024-11-06,48,Current,13,13,0
2024-11-06,48,DPD15-29,14,14,0
2024-11-06,48,DPD3-14,24,24,0
2024-11-06,48,DPD30-59,3,3,0
2024-11-06,48,DPD60-89,0,0,0
2024-11-06,48,DPD90+,0,0,0
2024-11-06,6,Current,0,0,0
2024-11-05,100,Current,0,0,0
2024-11-05,102,Current,0,0,0
2024-11-05,102,DPD30-59,0,0,0
2024-11-05,104,Current,0,0,0
2024-11-05,150,Current,17,17,0
2024-11-05,20,Current,0,0,0
2024-11-05,20,DPD15-29,215,215,0
2024-11-05,20,DPD3-14,411,411,0
2024-11-05,20,DPD30-59,96,96,0
2024-11-05,20,DPD60-89,0,0,0
2024-11-05,20,DPD90+,0,0,0
2024-11-05,22,Current,0,0,0
2024-11-05,22,DPD15-29,0,0,0
2024-11-05,22,DPD3-14,1,1,0
2024-11-05,22,DPD30-59,0,0,0
2024-11-05,22,DPD60-89,0,0,0
2024-11-05,22,DPD90+,0,0,0
2024-11-05,24,Current,66,66,0
2024-11-05,24,DPD15-29,134,134,0
2024-11-05,24,DPD3-14,213,213,0
2024-11-05,24,DPD30-59,69,69,0
2024-11-05,24,DPD60-89,0,0,0
2024-11-05,24,DPD90+,0,0,0
2024-11-05,26,Current,0,0,0
2024-11-05,26,DPD15-29,20,20,0
2024-11-05,26,DPD3-14,20,20,0
2024-11-05,26,DPD30-59,10,10,0
2024-11-05,26,DPD60-89,0,0,0
2024-11-05,26,DPD90+,0,0,0
2024-11-05,32,Current,0,0,0
2024-11-05,32,DPD15-29,118,118,0
2024-11-05,32,DPD3-14,189,189,0
2024-11-05,32,DPD30-59,65,65,0
2024-11-05,32,DPD60-89,0,0,0
2024-11-05,32,DPD90+,0,0,0
2024-11-05,34,Current,0,0,0
2024-11-05,34,DPD15-29,42,42,0
2024-11-05,34,DPD3-14,63,63,0
2024-11-05,34,DPD30-59,27,27,0
2024-11-05,34,DPD60-89,0,0,0
2024-11-05,34,DPD90+,0,0,0
2024-11-05,36,Current,0,0,0
2024-11-05,36,DPD15-29,34,34,0
2024-11-05,36,DPD3-14,51,51,0
2024-11-05,36,DPD30-59,12,12,0
2024-11-05,36,DPD60-89,0,0,0
2024-11-05,36,DPD90+,0,0,0
2024-11-05,38,Current,5,5,0
2024-11-05,38,DPD15-29,26,26,0
2024-11-05,38,DPD3-14,57,57,0
2024-11-05,38,DPD30-59,14,14,0
2024-11-05,38,DPD60-89,0,0,0
2024-11-05,38,DPD90+,0,0,0
2024-11-05,40,Current,0,0,0
2024-11-05,40,DPD15-29,16,16,0
2024-11-05,40,DPD3-14,29,29,0
2024-11-05,40,DPD30-59,4,4,0
2024-11-05,40,DPD60-89,0,0,0
2024-11-05,40,DPD90+,0,0,0
2024-11-05,42,Current,0,0,0
2024-11-05,42,DPD15-29,8,8,0
2024-11-05,42,DPD3-14,14,14,0
2024-11-05,42,DPD30-59,4,4,0
2024-11-05,42,DPD60-89,0,0,0
2024-11-05,42,DPD90+,0,0,0
2024-11-05,44,Current,0,0,0
2024-11-05,44,DPD15-29,21,21,0
2024-11-05,44,DPD3-14,53,53,0
2024-11-05,44,DPD30-59,13,13,0
2024-11-05,44,DPD60-89,0,0,0
2024-11-05,44,DPD90+,0,0,0
2024-11-05,46,Current,0,0,0
2024-11-05,46,DPD15-29,0,0,0
2024-11-05,46,DPD3-14,1,1,0
2024-11-05,48,Current,25,25,0
2024-11-05,48,DPD15-29,23,23,0
2024-11-05,48,DPD3-14,33,33,0
2024-11-05,48,DPD30-59,18,18,0
2024-11-05,48,DPD60-89,0,0,0
2024-11-05,48,DPD90+,0,0,0
2024-11-05,6,Current,0,0,0
2024-11-04,100,Current,0,0,0
2024-11-04,102,Current,0,0,0
2024-11-04,102,DPD30-59,0,0,0
2024-11-04,104,Current,0,0,0
2024-11-04,150,Current,13,13,0
2024-11-04,20,Current,0,0,0
2024-11-04,20,DPD15-29,195,195,0
2024-11-04,20,DPD3-14,230,230,0
2024-11-04,20,DPD30-59,75,75,0
2024-11-04,20,DPD60-89,0,0,0
2024-11-04,20,DPD90+,0,0,0
2024-11-04,22,Current,0,0,0
2024-11-04,22,DPD3-14,1,1,0
2024-11-04,22,DPD30-59,0,0,0
2024-11-04,22,DPD60-89,0,0,0
2024-11-04,22,DPD90+,0,0,0
2024-11-04,24,Current,52,52,0
2024-11-04,24,DPD15-29,110,110,0
2024-11-04,24,DPD3-14,127,127,0
2024-11-04,24,DPD30-59,33,33,0
2024-11-04,24,DPD60-89,0,0,0
2024-11-04,24,DPD90+,0,0,0
2024-11-04,26,Current,0,0,0
2024-11-04,26,DPD15-29,13,13,0
2024-11-04,26,DPD3-14,12,12,0
2024-11-04,26,DPD30-59,3,3,0
2024-11-04,26,DPD60-89,0,0,0
2024-11-04,26,DPD90+,0,0,0
2024-11-04,32,Current,0,0,0
2024-11-04,32,DPD15-29,112,112,0
2024-11-04,32,DPD3-14,123,123,0
2024-11-04,32,DPD30-59,37,37,0
2024-11-04,32,DPD60-89,0,0,0
2024-11-04,32,DPD90+,0,0,0
2024-11-04,34,Current,0,0,0
2024-11-04,34,DPD15-29,51,51,0
2024-11-04,34,DPD3-14,40,40,0
2024-11-04,34,DPD30-59,14,14,0
2024-11-04,34,DPD60-89,0,0,0
2024-11-04,34,DPD90+,0,0,0
2024-11-04,36,Current,0,0,0
2024-11-04,36,DPD15-29,31,31,0
2024-11-04,36,DPD3-14,40,40,0
2024-11-04,36,DPD30-59,9,9,0
2024-11-04,36,DPD60-89,0,0,0
2024-11-04,36,DPD90+,0,0,0
2024-11-04,38,Current,0,0,0
2024-11-04,38,DPD15-29,28,28,0
2024-11-04,38,DPD3-14,38,38,0
2024-11-04,38,DPD30-59,8,8,0
2024-11-04,38,DPD60-89,0,0,0
2024-11-04,38,DPD90+,0,0,0
2024-11-04,40,Current,0,0,0
2024-11-04,40,DPD15-29,11,11,0
2024-11-04,40,DPD3-14,24,24,0
2024-11-04,40,DPD30-59,11,11,0
2024-11-04,40,DPD60-89,0,0,0
2024-11-04,40,DPD90+,0,0,0
2024-11-04,42,Current,0,0,0
2024-11-04,42,DPD15-29,12,12,0
2024-11-04,42,DPD3-14,12,12,0
2024-11-04,42,DPD30-59,0,0,0
2024-11-04,42,DPD60-89,0,0,0
2024-11-04,42,DPD90+,0,0,0
2024-11-04,44,Current,0,0,0
2024-11-04,44,DPD15-29,31,31,0
2024-11-04,44,DPD3-14,27,27,0
2024-11-04,44,DPD30-59,9,9,0
2024-11-04,44,DPD60-89,0,0,0
2024-11-04,44,DPD90+,0,0,0
2024-11-04,46,Current,0,0,0
2024-11-04,46,DPD15-29,1,1,0
2024-11-04,46,DPD3-14,0,0,0
2024-11-04,48,Current,63,63,0
2024-11-04,48,DPD15-29,16,16,0
2024-11-04,48,DPD3-14,20,20,0
2024-11-04,48,DPD30-59,9,9,0
2024-11-04,48,DPD60-89,0,0,0
2024-11-04,48,DPD90+,0,0,0
2024-11-04,6,Current,0,0,0
2024-11-03,100,Current,0,0,0
2024-11-03,102,Current,0,0,0
2024-11-03,102,DPD30-59,0,0,0
2024-11-03,104,Current,0,0,0
2024-11-03,150,Current,13,13,0
2024-11-03,20,Current,0,0,0
2024-11-03,20,DPD15-29,202,202,0
2024-11-03,20,DPD3-14,353,353,0
2024-11-03,20,DPD30-59,185,185,0
2024-11-03,20,DPD60-89,0,0,0
2024-11-03,20,DPD90+,0,0,0
2024-11-03,22,Current,0,0,0
2024-11-03,22,DPD3-14,1,1,0
2024-11-03,22,DPD30-59,1,1,0
2024-11-03,22,DPD60-89,0,0,0
2024-11-03,22,DPD90+,0,0,0
2024-11-03,24,Current,78,78,0
2024-11-03,24,DPD15-29,122,122,0
2024-11-03,24,DPD3-14,196,196,0
2024-11-03,24,DPD30-59,104,104,0
2024-11-03,24,DPD60-89,0,0,0
2024-11-03,24,DPD90+,0,0,0
2024-11-03,26,Current,0,0,0
2024-11-03,26,DPD15-29,12,12,0
2024-11-03,26,DPD3-14,23,23,0
2024-11-03,26,DPD30-59,8,8,0
2024-11-03,26,DPD60-89,0,0,0
2024-11-03,26,DPD90+,0,0,0
2024-11-03,32,Current,0,0,0
2024-11-03,32,DPD15-29,100,100,0
2024-11-03,32,DPD3-14,176,176,0
2024-11-03,32,DPD30-59,77,77,0
2024-11-03,32,DPD60-89,0,0,0
2024-11-03,32,DPD90+,0,0,0
2024-11-03,34,Current,0,0,0
2024-11-03,34,DPD15-29,35,35,0
2024-11-03,34,DPD3-14,70,70,0
2024-11-03,34,DPD30-59,32,32,0
2024-11-03,34,DPD60-89,0,0,0
2024-11-03,34,DPD90+,0,0,0
2024-11-03,36,Current,0,0,0
2024-11-03,36,DPD15-29,24,24,0
2024-11-03,36,DPD3-14,52,52,0
2024-11-03,36,DPD30-59,21,21,0
2024-11-03,36,DPD60-89,0,0,0
2024-11-03,36,DPD90+,0,0,0
2024-11-03,38,Current,9,9,0
2024-11-03,38,DPD15-29,22,22,0
2024-11-03,38,DPD3-14,55,55,0
2024-11-03,38,DPD30-59,30,30,0
2024-11-03,38,DPD60-89,0,0,0
2024-11-03,38,DPD90+,0,0,0
2024-11-03,40,Current,0,0,0
2024-11-03,40,DPD15-29,15,15,0
2024-11-03,40,DPD3-14,23,23,0
2024-11-03,40,DPD30-59,12,12,0
2024-11-03,40,DPD60-89,0,0,0
2024-11-03,40,DPD90+,0,0,0
2024-11-03,42,Current,0,0,0
2024-11-03,42,DPD15-29,7,7,0
2024-11-03,42,DPD3-14,14,14,0
2024-11-03,42,DPD30-59,11,11,0
2024-11-03,42,DPD60-89,0,0,0
2024-11-03,42,DPD90+,0,0,0
2024-11-03,44,Current,0,0,0
2024-11-03,44,DPD15-29,20,20,0
2024-11-03,44,DPD3-14,37,37,0
2024-11-03,44,DPD30-59,20,20,0
2024-11-03,44,DPD60-89,0,0,0
2024-11-03,44,DPD90+,0,0,0
2024-11-03,46,Current,0,0,0
2024-11-03,46,DPD15-29,0,0,0
2024-11-03,48,Current,54,54,0
2024-11-03,48,DPD15-29,25,25,0
2024-11-03,48,DPD3-14,26,26,0
2024-11-03,48,DPD30-59,28,28,0
2024-11-03,48,DPD60-89,0,0,0
2024-11-03,48,DPD90+,0,0,0
2024-11-03,6,Current,0,0,0
2024-11-02,100,Current,0,0,0
2024-11-02,102,Current,0,0,0
2024-11-02,102,DPD30-59,0,0,0
2024-11-02,104,Current,0,0,0
2024-11-02,150,Current,5,5,0
2024-11-02,20,Current,0,0,0
2024-11-02,20,DPD15-29,182,182,0
2024-11-02,20,DPD3-14,252,252,0
2024-11-02,20,DPD30-59,82,82,0
2024-11-02,20,DPD60-89,0,0,0
2024-11-02,20,DPD90+,0,0,0
2024-11-02,22,Current,0,0,0
2024-11-02,22,DPD3-14,1,1,0
2024-11-02,22,DPD30-59,0,0,0
2024-11-02,22,DPD60-89,0,0,0
2024-11-02,22,DPD90+,0,0,0
2024-11-02,24,Current,40,40,0
2024-11-02,24,DPD15-29,92,92,0
2024-11-02,24,DPD3-14,149,149,0
2024-11-02,24,DPD30-59,56,56,0
2024-11-02,24,DPD60-89,0,0,0
2024-11-02,24,DPD90+,0,0,0
2024-11-02,26,Current,0,0,0
2024-11-02,26,DPD15-29,10,10,0
2024-11-02,26,DPD3-14,16,16,0
2024-11-02,26,DPD30-59,10,10,0
2024-11-02,26,DPD60-89,0,0,0
2024-11-02,26,DPD90+,0,0,0
2024-11-02,32,Current,0,0,0
2024-11-02,32,DPD15-29,101,101,0
2024-11-02,32,DPD3-14,134,134,0
2024-11-02,32,DPD30-59,59,59,0
2024-11-02,32,DPD60-89,0,0,0
2024-11-02,32,DPD90+,0,0,0
2024-11-02,34,Current,0,0,0
2024-11-02,34,DPD15-29,49,49,0
2024-11-02,34,DPD3-14,45,45,0
2024-11-02,34,DPD30-59,24,24,0
2024-11-02,34,DPD60-89,0,0,0
2024-11-02,34,DPD90+,0,0,0
2024-11-02,36,Current,0,0,0
2024-11-02,36,DPD15-29,28,28,0
2024-11-02,36,DPD3-14,44,44,0
2024-11-02,36,DPD30-59,13,13,0
2024-11-02,36,DPD60-89,0,0,0
2024-11-02,36,DPD90+,0,0,0
2024-11-02,38,Current,1,1,0
2024-11-02,38,DPD15-29,20,20,0
2024-11-02,38,DPD3-14,46,46,0
2024-11-02,38,DPD30-59,14,14,0
2024-11-02,38,DPD60-89,0,0,0
2024-11-02,38,DPD90+,0,0,0
2024-11-02,40,Current,0,0,0
2024-11-02,40,DPD15-29,11,11,0
2024-11-02,40,DPD3-14,24,24,0
2024-11-02,40,DPD30-59,3,3,0
2024-11-02,40,DPD60-89,0,0,0
2024-11-02,40,DPD90+,0,0,0
2024-11-02,42,Current,0,0,0
2024-11-02,42,DPD15-29,11,11,0
2024-11-02,42,DPD3-14,13,13,0
2024-11-02,42,DPD30-59,4,4,0
2024-11-02,42,DPD60-89,0,0,0
2024-11-02,42,DPD90+,0,0,0
2024-11-02,44,Current,0,0,0
2024-11-02,44,DPD15-29,26,26,0
2024-11-02,44,DPD3-14,32,32,0
2024-11-02,44,DPD30-59,14,14,0
2024-11-02,44,DPD60-89,0,0,0
2024-11-02,44,DPD90+,0,0,0
2024-11-02,46,Current,0,0,0
2024-11-02,46,DPD15-29,1,1,0
2024-11-02,48,Current,46,46,0
2024-11-02,48,DPD15-29,17,17,0
2024-11-02,48,DPD3-14,22,22,0
2024-11-02,48,DPD30-59,15,15,0
2024-11-02,48,DPD60-89,0,0,0
2024-11-02,48,DPD90+,0,0,0
2024-11-02,6,Current,0,0,0
2024-11-01,100,Current,0,0,0
2024-11-01,102,Current,0,0,0
2024-11-01,102,DPD30-59,0,0,0
2024-11-01,104,Current,0,0,0
2024-11-01,150,Current,84,84,0
2024-11-01,20,Current,3910,3910,0
2024-11-01,20,DPD15-29,281,281,0
2024-11-01,20,DPD3-14,524,524,0
2024-11-01,20,DPD30-59,139,139,0
2024-11-01,20,DPD60-89,39,39,0
2024-11-01,20,DPD90+,29,29,0
2024-11-01,22,Current,0,0,0
2024-11-01,22,DPD3-14,1,1,0
2024-11-01,22,DPD30-59,0,0,0
2024-11-01,22,DPD60-89,0,0,0
2024-11-01,22,DPD90+,0,0,0
2024-11-01,24,Current,4617,4617,0
2024-11-01,24,DPD15-29,147,147,0
2024-11-01,24,DPD3-14,323,323,0
2024-11-01,24,DPD30-59,70,70,0
2024-11-01,24,DPD60-89,28,28,0
2024-11-01,24,DPD90+,11,11,0
2024-11-01,26,Current,0,0,0
2024-11-01,26,DPD15-29,12,12,0
2024-11-01,26,DPD3-14,30,30,0
2024-11-01,26,DPD30-59,2,2,0
2024-11-01,26,DPD60-89,0,0,0
2024-11-01,26,DPD90+,0,0,0
2024-11-01,32,Current,196,196,0
2024-11-01,32,DPD15-29,99,99,0
2024-11-01,32,DPD3-14,227,227,0
2024-11-01,32,DPD30-59,42,42,0
2024-11-01,32,DPD60-89,3,3,0
2024-11-01,32,DPD90+,5,5,0
2024-11-01,34,Current,0,0,0
2024-11-01,34,DPD15-29,27,27,0
2024-11-01,34,DPD3-14,86,86,0
2024-11-01,34,DPD30-59,9,9,0
2024-11-01,34,DPD60-89,0,0,0
2024-11-01,34,DPD90+,0,0,0
2024-11-01,36,Current,221,221,0
2024-11-01,36,DPD15-29,28,28,0
2024-11-01,36,DPD3-14,65,65,0
2024-11-01,36,DPD30-59,6,6,0
2024-11-01,36,DPD60-89,1,1,0
2024-11-01,36,DPD90+,1,1,0
2024-11-01,38,Current,102,102,0
2024-11-01,38,DPD15-29,25,25,0
2024-11-01,38,DPD3-14,66,66,0
2024-11-01,38,DPD30-59,10,10,0
2024-11-01,38,DPD60-89,0,0,0
2024-11-01,38,DPD90+,0,0,0
2024-11-01,40,Current,242,242,0
2024-11-01,40,DPD15-29,14,14,0
2024-11-01,40,DPD3-14,35,35,0
2024-11-01,40,DPD30-59,15,15,0
2024-11-01,40,DPD60-89,1,1,0
2024-11-01,40,DPD90+,1,1,0
2024-11-01,42,Current,0,0,0
2024-11-01,42,DPD15-29,6,6,0
2024-11-01,42,DPD3-14,15,15,0
2024-11-01,42,DPD30-59,1,1,0
2024-11-01,42,DPD60-89,0,0,0
2024-11-01,42,DPD90+,0,0,0
2024-11-01,44,Current,159,159,0
2024-11-01,44,DPD15-29,25,25,0
2024-11-01,44,DPD3-14,45,45,0
2024-11-01,44,DPD30-59,8,8,0
2024-11-01,44,DPD60-89,1,1,0
2024-11-01,44,DPD90+,2,2,0
2024-11-01,46,Current,4,4,0
2024-11-01,46,DPD15-29,0,0,0
2024-11-01,48,Current,4459,4459,0
2024-11-01,48,DPD15-29,59,59,0
2024-11-01,48,DPD3-14,100,100,0
2024-11-01,48,DPD30-59,42,42,0
2024-11-01,48,DPD60-89,20,20,0
2024-11-01,48,DPD90+,13,13,0
2024-11-01,6,Current,0,0,0
2024-10-31,100,Current,0,0,0
2024-10-31,102,Current,0,0,0
2024-10-31,102,DPD3-14,1,1,0
2024-10-31,102,DPD30-59,0,0,0
2024-10-31,104,Current,0,0,0
2024-10-31,150,Current,14,14,0
2024-10-31,20,Current,0,0,0
2024-10-31,20,DPD15-29,205,205,0
2024-10-31,20,DPD3-14,336,336,0
2024-10-31,20,DPD30-59,98,98,0
2024-10-31,20,DPD60-89,0,0,0
2024-10-31,20,DPD90+,0,0,0
2024-10-31,22,Current,0,0,0
2024-10-31,22,DPD3-14,1,1,0
2024-10-31,22,DPD30-59,0,0,0
2024-10-31,22,DPD60-89,0,0,0
2024-10-31,22,DPD90+,0,0,0
2024-10-31,24,Current,68,68,0
2024-10-31,24,DPD15-29,114,114,0
2024-10-31,24,DPD3-14,219,219,0
2024-10-31,24,DPD30-59,58,58,0
2024-10-31,24,DPD60-89,0,0,0
2024-10-31,24,DPD90+,0,0,0
2024-10-31,26,Current,0,0,0
2024-10-31,26,DPD15-29,11,11,0
2024-10-31,26,DPD3-14,17,17,0
2024-10-31,26,DPD30-59,2,2,0
2024-10-31,26,DPD60-89,0,0,0
2024-10-31,26,DPD90+,0,0,0
2024-10-31,32,Current,0,0,0
2024-10-31,32,DPD15-29,112,112,0
2024-10-31,32,DPD3-14,187,187,0
2024-10-31,32,DPD30-59,33,33,0
2024-10-31,32,DPD60-89,0,0,0
2024-10-31,32,DPD90+,0,0,0
2024-10-31,34,Current,0,0,0
2024-10-31,34,DPD15-29,42,42,0
2024-10-31,34,DPD3-14,65,65,0
2024-10-31,34,DPD30-59,19,19,0
2024-10-31,34,DPD60-89,0,0,0
2024-10-31,34,DPD90+,0,0,0
2024-10-31,36,Current,0,0,0
2024-10-31,36,DPD15-29,38,38,0
2024-10-31,36,DPD3-14,60,60,0
2024-10-31,36,DPD30-59,9,9,0
2024-10-31,36,DPD60-89,0,0,0
2024-10-31,36,DPD90+,0,0,0
2024-10-31,38,Current,0,0,0
2024-10-31,38,DPD15-29,33,33,0
2024-10-31,38,DPD3-14,59,59,0
2024-10-31,38,DPD30-59,13,13,0
2024-10-31,38,DPD60-89,0,0,0
2024-10-31,38,DPD90+,0,0,0
2024-10-31,40,Current,0,0,0
2024-10-31,40,DPD15-29,12,12,0
2024-10-31,40,DPD3-14,38,38,0
2024-10-31,40,DPD30-59,11,11,0
2024-10-31,40,DPD60-89,0,0,0
2024-10-31,40,DPD90+,0,0,0
2024-10-31,42,Current,0,0,0
2024-10-31,42,DPD15-29,14,14,0
2024-10-31,42,DPD3-14,14,14,0
2024-10-31,42,DPD30-59,6,6,0
2024-10-31,42,DPD60-89,0,0,0
2024-10-31,42,DPD90+,0,0,0
2024-10-31,44,Current,1,1,0
2024-10-31,44,DPD15-29,30,30,0
2024-10-31,44,DPD3-14,44,44,0
2024-10-31,44,DPD30-59,8,8,0
2024-10-31,44,DPD60-89,0,0,0
2024-10-31,44,DPD90+,0,0,0
2024-10-31,46,Current,0,0,0
2024-10-31,46,DPD15-29,1,1,0
2024-10-31,48,Current,59,59,0
2024-10-31,48,DPD15-29,21,21,0
2024-10-31,48,DPD3-14,40,40,0
2024-10-31,48,DPD30-59,14,14,0
2024-10-31,48,DPD60-89,0,0,0
2024-10-31,48,DPD90+,0,0,0
2024-10-31,6,Current,0,0,0
2024-10-30,100,Current,0,0,0
2024-10-30,100,DPD3-14,1,1,0
2024-10-30,102,Current,0,0,0
2024-10-30,102,DPD3-14,0,0,0
2024-10-30,102,DPD30-59,0,0,0
2024-10-30,104,Current,0,0,0
2024-10-30,150,Current,10,10,0
2024-10-30,20,Current,0,0,0
2024-10-30,20,DPD15-29,170,170,0
2024-10-30,20,DPD3-14,293,293,0
2024-10-30,20,DPD30-59,99,99,0
2024-10-30,20,DPD60-89,0,0,0
2024-10-30,20,DPD90+,0,0,0
2024-10-30,22,Current,0,0,0
2024-10-30,22,DPD3-14,1,1,0
2024-10-30,22,DPD30-59,1,1,0
2024-10-30,22,DPD60-89,0,0,0
2024-10-30,22,DPD90+,0,0,0
2024-10-30,24,Current,28,28,0
2024-10-30,24,DPD15-29,95,95,0
2024-10-30,24,DPD3-14,166,166,0
2024-10-30,24,DPD30-59,55,55,0
2024-10-30,24,DPD60-89,0,0,0
2024-10-30,24,DPD90+,0,0,0
2024-10-30,26,Current,0,0,0
2024-10-30,26,DPD15-29,9,9,0
2024-10-30,26,DPD3-14,18,18,0
2024-10-30,26,DPD30-59,7,7,0
2024-10-30,26,DPD60-89,0,0,0
2024-10-30,26,DPD90+,0,0,0
2024-10-30,32,Current,0,0,0
2024-10-30,32,DPD15-29,79,79,0
2024-10-30,32,DPD3-14,145,145,0
2024-10-30,32,DPD30-59,46,46,0
2024-10-30,32,DPD60-89,0,0,0
2024-10-30,32,DPD90+,0,0,0
2024-10-30,34,Current,0,0,0
2024-10-30,34,DPD15-29,25,25,0
2024-10-30,34,DPD3-14,53,53,0
2024-10-30,34,DPD30-59,18,18,0
2024-10-30,34,DPD60-89,0,0,0
2024-10-30,34,DPD90+,0,0,0
2024-10-30,36,Current,0,0,0
2024-10-30,36,DPD15-29,16,16,0
2024-10-30,36,DPD3-14,39,39,0
2024-10-30,36,DPD30-59,12,12,0
2024-10-30,36,DPD60-89,0,0,0
2024-10-30,36,DPD90+,0,0,0
2024-10-30,38,Current,0,0,0
2024-10-30,38,DPD15-29,22,22,0
2024-10-30,38,DPD3-14,42,42,0
2024-10-30,38,DPD30-59,16,16,0
2024-10-30,38,DPD60-89,0,0,0
2024-10-30,38,DPD90+,0,0,0
2024-10-30,40,Current,0,0,0
2024-10-30,40,DPD15-29,10,10,0
2024-10-30,40,DPD3-14,25,25,0
2024-10-30,40,DPD30-59,2,2,0
2024-10-30,40,DPD60-89,0,0,0
2024-10-30,40,DPD90+,0,0,0
2024-10-30,42,Current,0,0,0
2024-10-30,42,DPD15-29,6,6,0
2024-10-30,42,DPD3-14,11,11,0
2024-10-30,42,DPD30-59,8,8,0
2024-10-30,42,DPD60-89,0,0,0
2024-10-30,42,DPD90+,0,0,0
2024-10-30,44,Current,0,0,0
2024-10-30,44,DPD15-29,16,16,0
2024-10-30,44,DPD3-14,31,31,0
2024-10-30,44,DPD30-59,17,17,0
2024-10-30,44,DPD60-89,0,0,0
2024-10-30,44,DPD90+,0,0,0
2024-10-30,46,Current,0,0,0
2024-10-30,46,DPD15-29,0,0,0
2024-10-30,48,Current,34,34,0
2024-10-30,48,DPD15-29,24,24,0
2024-10-30,48,DPD3-14,39,39,0
2024-10-30,48,DPD30-59,14,14,0
2024-10-30,48,DPD60-89,0,0,0
2024-10-30,48,DPD90+,0,0,0
2024-10-30,6,Current,0,0,0
2024-10-29,100,Current,0,0,0
2024-10-29,100,DPD3-14,0,0,0
2024-10-29,102,Current,0,0,0
2024-10-29,102,DPD3-14,1,1,0
2024-10-29,102,DPD30-59,0,0,0
2024-10-29,104,Current,0,0,0
2024-10-29,150,Current,9,9,0
2024-10-29,20,Current,0,0,0
2024-10-29,20,DPD15-29,143,143,0
2024-10-29,20,DPD3-14,395,395,0
2024-10-29,20,DPD30-59,86,86,0
2024-10-29,20,DPD60-89,0,0,0
2024-10-29,20,DPD90+,0,0,0
2024-10-29,22,Current,0,0,0
2024-10-29,22,DPD3-14,1,1,0
2024-10-29,22,DPD30-59,0,0,0
2024-10-29,22,DPD60-89,0,0,0
2024-10-29,22,DPD90+,0,0,0
2024-10-29,24,Current,47,47,0
2024-10-29,24,DPD15-29,72,72,0
2024-10-29,24,DPD3-14,227,227,0
2024-10-29,24,DPD30-59,56,56,0
2024-10-29,24,DPD60-89,0,0,0
2024-10-29,24,DPD90+,1,1,0
2024-10-29,26,Current,0,0,0
2024-10-29,26,DPD15-29,5,5,0
2024-10-29,26,DPD3-14,24,24,0
2024-10-29,26,DPD30-59,13,13,0
2024-10-29,26,DPD60-89,0,0,0
2024-10-29,26,DPD90+,0,0,0
2024-10-29,32,Current,0,0,0
2024-10-29,32,DPD15-29,68,68,0
2024-10-29,32,DPD3-14,195,195,0
2024-10-29,32,DPD30-59,53,53,0
2024-10-29,32,DPD60-89,0,0,0
2024-10-29,32,DPD90+,0,0,0
2024-10-29,34,Current,0,0,0
2024-10-29,34,DPD15-29,26,26,0
2024-10-29,34,DPD3-14,83,83,0
2024-10-29,34,DPD30-59,27,27,0
2024-10-29,34,DPD60-89,0,0,0
2024-10-29,34,DPD90+,0,0,0
2024-10-29,36,Current,0,0,0
2024-10-29,36,DPD15-29,23,23,0
2024-10-29,36,DPD3-14,75,75,0
2024-10-29,36,DPD30-59,11,11,0
2024-10-29,36,DPD60-89,0,0,0
2024-10-29,36,DPD90+,0,0,0
2024-10-29,38,Current,5,5,0
2024-10-29,38,DPD15-29,22,22,0
2024-10-29,38,DPD3-14,77,77,0
2024-10-29,38,DPD30-59,12,12,0
2024-10-29,38,DPD60-89,0,0,0
2024-10-29,38,DPD90+,0,0,0
2024-10-29,40,Current,0,0,0
2024-10-29,40,DPD15-29,9,9,0
2024-10-29,40,DPD3-14,40,40,0
2024-10-29,40,DPD30-59,1,1,0
2024-10-29,40,DPD60-89,0,0,0
2024-10-29,40,DPD90+,0,0,0
2024-10-29,42,Current,0,0,0
2024-10-29,42,DPD15-29,9,9,0
2024-10-29,42,DPD3-14,16,16,0
2024-10-29,42,DPD30-59,4,4,0
2024-10-29,42,DPD60-89,0,0,0
2024-10-29,42,DPD90+,0,0,0
2024-10-29,44,Current,0,0,0
2024-10-29,44,DPD15-29,21,21,0
2024-10-29,44,DPD3-14,53,53,0
2024-10-29,44,DPD30-59,14,14,0
2024-10-29,44,DPD60-89,0,0,0
2024-10-29,44,DPD90+,0,0,0
2024-10-29,46,Current,0,0,0
2024-10-29,46,DPD15-29,1,1,0
2024-10-29,48,Current,23,23,0
2024-10-29,48,DPD15-29,16,16,0
2024-10-29,48,DPD3-14,45,45,0
2024-10-29,48,DPD30-59,13,13,0
2024-10-29,48,DPD60-89,0,0,0
2024-10-29,48,DPD90+,0,0,0
2024-10-29,6,Current,0,0,0
2024-10-28,100,Current,0,0,0
2024-10-28,102,Current,0,0,0
2024-10-28,102,DPD3-14,0,0,0
2024-10-28,102,DPD30-59,0,0,0
2024-10-28,104,Current,0,0,0
2024-10-28,150,Current,12,12,0
2024-10-28,20,Current,0,0,0
2024-10-28,20,DPD15-29,180,180,0
2024-10-28,20,DPD3-14,339,339,0
2024-10-28,20,DPD30-59,79,79,0
2024-10-28,20,DPD60-89,0,0,0
2024-10-28,20,DPD90+,0,0,0
2024-10-28,22,Current,0,0,0
2024-10-28,22,DPD3-14,1,1,0
2024-10-28,22,DPD30-59,0,0,0
2024-10-28,22,DPD60-89,0,0,0
2024-10-28,22,DPD90+,0,0,0
2024-10-28,24,Current,53,53,0
2024-10-28,24,DPD15-29,89,89,0
2024-10-28,24,DPD3-14,193,193,0
2024-10-28,24,DPD30-59,38,38,0
2024-10-28,24,DPD60-89,0,0,0
2024-10-28,24,DPD90+,0,0,0
2024-10-28,26,Current,0,0,0
2024-10-28,26,DPD15-29,16,16,0
2024-10-28,26,DPD3-14,23,23,0
2024-10-28,26,DPD30-59,5,5,0
2024-10-28,26,DPD60-89,0,0,0
2024-10-28,26,DPD90+,0,0,0
2024-10-28,32,Current,0,0,0
2024-10-28,32,DPD15-29,76,76,0
2024-10-28,32,DPD3-14,172,172,0
2024-10-28,32,DPD30-59,42,42,0
2024-10-28,32,DPD60-89,0,0,0
2024-10-28,32,DPD90+,0,0,0
2024-10-28,34,Current,0,0,0
2024-10-28,34,DPD15-29,31,31,0
2024-10-28,34,DPD3-14,60,60,0
2024-10-28,34,DPD30-59,9,9,0
2024-10-28,34,DPD60-89,0,0,0
2024-10-28,34,DPD90+,0,0,0
2024-10-28,36,Current,0,0,0
2024-10-28,36,DPD15-29,18,18,0
2024-10-28,36,DPD3-14,40,40,0
2024-10-28,36,DPD30-59,5,5,0
2024-10-28,36,DPD60-89,0,0,0
2024-10-28,36,DPD90+,0,0,0
2024-10-28,38,Current,2,2,0
2024-10-28,38,DPD15-29,26,26,0
2024-10-28,38,DPD3-14,47,47,0
2024-10-28,38,DPD30-59,8,8,0
2024-10-28,38,DPD60-89,0,0,0
2024-10-28,38,DPD90+,0,0,0
2024-10-28,40,Current,0,0,0
2024-10-28,40,DPD15-29,11,11,0
2024-10-28,40,DPD3-14,36,36,0
2024-10-28,40,DPD30-59,13,13,0
2024-10-28,40,DPD60-89,0,0,0
2024-10-28,40,DPD90+,0,0,0
2024-10-28,42,Current,0,0,0
2024-10-28,42,DPD15-29,10,10,0
2024-10-28,42,DPD3-14,11,11,0
2024-10-28,42,DPD30-59,3,3,0
2024-10-28,42,DPD60-89,0,0,0
2024-10-28,42,DPD90+,0,0,0
2024-10-28,44,Current,0,0,0
2024-10-28,44,DPD15-29,18,18,0
2024-10-28,44,DPD3-14,37,37,0
2024-10-28,44,DPD30-59,11,11,0
2024-10-28,44,DPD60-89,0,0,0
2024-10-28,44,DPD90+,0,0,0
2024-10-28,46,Current,0,0,0
2024-10-28,46,DPD15-29,0,0,0
2024-10-28,48,Current,37,37,0
2024-10-28,48,DPD15-29,24,24,0
2024-10-28,48,DPD3-14,52,52,0
2024-10-28,48,DPD30-59,8,8,0
2024-10-28,48,DPD60-89,0,0,0
2024-10-28,48,DPD90+,0,0,0
2024-10-28,6,Current,0,0,0
2024-10-27,100,Current,0,0,0
2024-10-27,102,Current,0,0,0
2024-10-27,102,DPD30-59,0,0,0
2024-10-27,104,Current,0,0,0
2024-10-27,150,Current,6,6,0
2024-10-27,20,Current,0,0,0
2024-10-27,20,DPD15-29,181,181,0
2024-10-27,20,DPD3-14,368,368,0
2024-10-27,20,DPD30-59,93,93,0
2024-10-27,20,DPD60-89,0,0,0
2024-10-27,20,DPD90+,0,0,0
2024-10-27,22,Current,0,0,0
2024-10-27,22,DPD15-29,0,0,0
2024-10-27,22,DPD3-14,1,1,0
2024-10-27,22,DPD30-59,0,0,0
2024-10-27,22,DPD60-89,0,0,0
2024-10-27,22,DPD90+,0,0,0
2024-10-27,24,Current,80,80,0
2024-10-27,24,DPD15-29,87,87,0
2024-10-27,24,DPD3-14,225,225,0
2024-10-27,24,DPD30-59,61,61,0
2024-10-27,24,DPD60-89,0,0,0
2024-10-27,24,DPD90+,0,0,0
2024-10-27,26,Current,0,0,0
2024-10-27,26,DPD15-29,11,11,0
2024-10-27,26,DPD3-14,26,26,0
2024-10-27,26,DPD30-59,3,3,0
2024-10-27,26,DPD60-89,0,0,0
2024-10-27,26,DPD90+,0,0,0
2024-10-27,32,Current,0,0,0
2024-10-27,32,DPD15-29,81,81,0
2024-10-27,32,DPD3-14,179,179,0
2024-10-27,32,DPD30-59,46,46,0
2024-10-27,32,DPD60-89,0,0,0
2024-10-27,32,DPD90+,0,0,0
2024-10-27,34,Current,0,0,0
2024-10-27,34,DPD15-29,31,31,0
2024-10-27,34,DPD3-14,80,80,0
2024-10-27,34,DPD30-59,20,20,0
2024-10-27,34,DPD60-89,0,0,0
2024-10-27,34,DPD90+,0,0,0
2024-10-27,36,Current,0,0,0
2024-10-27,36,DPD15-29,26,26,0
2024-10-27,36,DPD3-14,64,64,0
2024-10-27,36,DPD30-59,11,11,0
2024-10-27,36,DPD60-89,0,0,0
2024-10-27,36,DPD90+,0,0,0
2024-10-27,38,Current,6,6,0
2024-10-27,38,DPD15-29,30,30,0
2024-10-27,38,DPD3-14,74,74,0
2024-10-27,38,DPD30-59,15,15,0
2024-10-27,38,DPD60-89,0,0,0
2024-10-27,38,DPD90+,0,0,0
2024-10-27,40,Current,0,0,0
2024-10-27,40,DPD15-29,15,15,0
2024-10-27,40,DPD3-14,29,29,0
2024-10-27,40,DPD30-59,11,11,0
2024-10-27,40,DPD60-89,0,0,0
2024-10-27,40,DPD90+,0,0,0
2024-10-27,42,Current,0,0,0
2024-10-27,42,DPD15-29,9,9,0
2024-10-27,42,DPD3-14,15,15,0
2024-10-27,42,DPD30-59,5,5,0
2024-10-27,42,DPD60-89,0,0,0
2024-10-27,42,DPD90+,0,0,0
2024-10-27,44,Current,0,0,0
2024-10-27,44,DPD15-29,24,24,0
2024-10-27,44,DPD3-14,50,50,0
2024-10-27,44,DPD30-59,10,10,0
2024-10-27,44,DPD60-89,0,0,0
2024-10-27,44,DPD90+,0,0,0
2024-10-27,46,Current,0,0,0
2024-10-27,46,DPD15-29,1,1,0
2024-10-27,48,Current,40,40,0
2024-10-27,48,DPD15-29,18,18,0
2024-10-27,48,DPD3-14,50,50,0
2024-10-27,48,DPD30-59,14,14,0
2024-10-27,48,DPD60-89,0,0,0
2024-10-27,48,DPD90+,0,0,0
2024-10-27,6,Current,0,0,0
2024-10-26,100,Current,0,0,0
2024-10-26,102,Current,0,0,0
2024-10-26,102,DPD30-59,0,0,0
2024-10-26,104,Current,0,0,0
2024-10-26,150,Current,15,15,0
2024-10-26,20,Current,0,0,0
2024-10-26,20,DPD15-29,160,160,0
2024-10-26,20,DPD3-14,297,297,0
2024-10-26,20,DPD30-59,86,86,0
2024-10-26,20,DPD60-89,0,0,0
2024-10-26,20,DPD90+,0,0,0
2024-10-26,22,Current,0,0,0
2024-10-26,22,DPD15-29,1,1,0
2024-10-26,22,DPD3-14,1,1,0
2024-10-26,22,DPD30-59,0,0,0
2024-10-26,22,DPD60-89,0,0,0
2024-10-26,22,DPD90+,0,0,0
2024-10-26,24,Current,92,92,0
2024-10-26,24,DPD15-29,80,80,0
2024-10-26,24,DPD3-14,189,189,0
2024-10-26,24,DPD30-59,46,46,0
2024-10-26,24,DPD60-89,0,0,0
2024-10-26,24,DPD90+,0,0,0
2024-10-26,26,Current,0,0,0
2024-10-26,26,DPD15-29,12,12,0
2024-10-26,26,DPD3-14,24,24,0
2024-10-26,26,DPD30-59,7,7,0
2024-10-26,26,DPD60-89,0,0,0
2024-10-26,26,DPD90+,0,0,0
2024-10-26,32,Current,0,0,0
2024-10-26,32,DPD15-29,64,64,0
2024-10-26,32,DPD3-14,167,167,0
2024-10-26,32,DPD30-59,40,40,0
2024-10-26,32,DPD60-89,0,0,0
2024-10-26,32,DPD90+,0,0,0
2024-10-26,34,Current,0,0,0
2024-10-26,34,DPD15-29,24,24,0
2024-10-26,34,DPD3-14,61,61,0
2024-10-26,34,DPD30-59,17,17,0
2024-10-26,34,DPD60-89,0,0,0
2024-10-26,34,DPD90+,0,0,0
2024-10-26,36,Current,0,0,0
2024-10-26,36,DPD15-29,14,14,0
2024-10-26,36,DPD3-14,39,39,0
2024-10-26,36,DPD30-59,10,10,0
2024-10-26,36,DPD60-89,0,0,0
2024-10-26,36,DPD90+,0,0,0
2024-10-26,38,Current,5,5,0
2024-10-26,38,DPD15-29,23,23,0
2024-10-26,38,DPD3-14,43,43,0
2024-10-26,38,DPD30-59,8,8,0
2024-10-26,38,DPD60-89,0,0,0
2024-10-26,38,DPD90+,0,0,0
2024-10-26,40,Current,0,0,0
2024-10-26,40,DPD15-29,10,10,0
2024-10-26,40,DPD3-14,35,35,0
2024-10-26,40,DPD30-59,1,1,0
2024-10-26,40,DPD60-89,0,0,0
2024-10-26,40,DPD90+,0,0,0
2024-10-26,42,Current,0,0,0
2024-10-26,42,DPD15-29,10,10,0
2024-10-26,42,DPD3-14,10,10,0
2024-10-26,42,DPD30-59,11,11,0
2024-10-26,42,DPD60-89,0,0,0
2024-10-26,42,DPD90+,0,0,0
2024-10-26,44,Current,0,0,0
2024-10-26,44,DPD15-29,19,19,0
2024-10-26,44,DPD3-14,34,34,0
2024-10-26,44,DPD30-59,13,13,0
2024-10-26,44,DPD60-89,0,0,0
2024-10-26,44,DPD90+,0,0,0
2024-10-26,46,Current,0,0,0
2024-10-26,46,DPD15-29,0,0,0
2024-10-26,48,Current,45,45,0
2024-10-26,48,DPD15-29,18,18,0
2024-10-26,48,DPD3-14,48,48,0
2024-10-26,48,DPD30-59,12,12,0
2024-10-26,48,DPD60-89,0,0,0
2024-10-26,48,DPD90+,0,0,0
2024-10-26,6,Current,0,0,0
2024-10-25,100,Current,0,0,0
2024-10-25,102,Current,0,0,0
2024-10-25,102,DPD30-59,0,0,0
2024-10-25,104,Current,0,0,0
2024-10-25,150,Current,13,13,0
2024-10-25,20,Current,0,0,0
2024-10-25,20,DPD15-29,212,212,0
2024-10-25,20,DPD3-14,341,341,0
2024-10-25,20,DPD30-59,72,72,0
2024-10-25,20,DPD60-89,0,0,0
2024-10-25,20,DPD90+,0,0,0
2024-10-25,22,Current,0,0,0
2024-10-25,22,DPD15-29,1,1,0
2024-10-25,22,DPD3-14,1,1,0
2024-10-25,22,DPD30-59,0,0,0
2024-10-25,22,DPD60-89,0,0,0
2024-10-25,24,Current,97,97,0
2024-10-25,24,DPD15-29,98,98,0
2024-10-25,24,DPD3-14,204,204,0
2024-10-25,24,DPD30-59,42,42,0
2024-10-25,24,DPD60-89,0,0,0
2024-10-25,24,DPD90+,0,0,0
2024-10-25,26,Current,0,0,0
2024-10-25,26,DPD15-29,11,11,0
2024-10-25,26,DPD3-14,22,22,0
2024-10-25,26,DPD30-59,8,8,0
2024-10-25,26,DPD60-89,0,0,0
2024-10-25,26,DPD90+,0,0,0
2024-10-25,32,Current,0,0,0
2024-10-25,32,DPD15-29,95,95,0
2024-10-25,32,DPD3-14,167,167,0
2024-10-25,32,DPD30-59,44,44,0
2024-10-25,32,DPD60-89,0,0,0
2024-10-25,32,DPD90+,0,0,0
2024-10-25,34,Current,0,0,0
2024-10-25,34,DPD15-29,33,33,0
2024-10-25,34,DPD3-14,73,73,0
2024-10-25,34,DPD30-59,21,21,0
2024-10-25,34,DPD60-89,0,0,0
2024-10-25,34,DPD90+,0,0,0
2024-10-25,36,Current,0,0,0
2024-10-25,36,DPD15-29,32,32,0
2024-10-25,36,DPD3-14,61,61,0
2024-10-25,36,DPD30-59,8,8,0
2024-10-25,36,DPD60-89,0,0,0
2024-10-25,36,DPD90+,0,0,0
2024-10-25,38,Current,6,6,0
2024-10-25,38,DPD15-29,34,34,0
2024-10-25,38,DPD3-14,69,69,0
2024-10-25,38,DPD30-59,14,14,0
2024-10-25,38,DPD60-89,0,0,0
2024-10-25,38,DPD90+,0,0,0
2024-10-25,40,Current,0,0,0
2024-10-25,40,DPD15-29,15,15,0
2024-10-25,40,DPD3-14,34,34,0
2024-10-25,40,DPD30-59,1,1,0
2024-10-25,40,DPD60-89,0,0,0
2024-10-25,40,DPD90+,0,0,0
2024-10-25,42,Current,0,0,0
2024-10-25,42,DPD15-29,12,12,0
2024-10-25,42,DPD3-14,17,17,0
2024-10-25,42,DPD30-59,6,6,0
2024-10-25,42,DPD60-89,0,0,0
2024-10-25,42,DPD90+,0,0,0
2024-10-25,44,Current,0,0,0
2024-10-25,44,DPD15-29,28,28,0
2024-10-25,44,DPD3-14,45,45,0
2024-10-25,44,DPD30-59,9,9,0
2024-10-25,44,DPD60-89,0,0,0
2024-10-25,44,DPD90+,0,0,0
2024-10-25,46,Current,0,0,0
2024-10-25,46,DPD15-29,1,1,0
2024-10-25,48,Current,42,42,0
2024-10-25,48,DPD15-29,21,21,0
2024-10-25,48,DPD3-14,45,45,0
2024-10-25,48,DPD30-59,12,12,0
2024-10-25,48,DPD60-89,0,0,0
2024-10-25,48,DPD90+,0,0,0
2024-10-25,6,Current,0,0,0
2024-10-24,100,Current,0,0,0
2024-10-24,102,Current,0,0,0
2024-10-24,102,DPD30-59,0,0,0
2024-10-24,104,Current,0,0,0
2024-10-24,150,Current,17,17,0
2024-10-24,20,Current,0,0,0
2024-10-24,20,DPD15-29,168,168,0
2024-10-24,20,DPD3-14,306,306,0
2024-10-24,20,DPD30-59,81,81,0
2024-10-24,20,DPD60-89,0,0,0
2024-10-24,20,DPD90+,0,0,0
2024-10-24,22,Current,0,0,0
2024-10-24,22,DPD15-29,1,1,0
2024-10-24,22,DPD3-14,0,0,0
2024-10-24,22,DPD30-59,0,0,0
2024-10-24,22,DPD60-89,0,0,0
2024-10-24,24,Current,44,44,0
2024-10-24,24,DPD15-29,92,92,0
2024-10-24,24,DPD3-14,220,220,0
2024-10-24,24,DPD30-59,33,33,0
2024-10-24,24,DPD60-89,0,0,0
2024-10-24,24,DPD90+,0,0,0
2024-10-24,26,Current,0,0,0
2024-10-24,26,DPD15-29,14,14,0
2024-10-24,26,DPD3-14,30,30,0
2024-10-24,26,DPD30-59,4,4,0
2024-10-24,26,DPD60-89,0,0,0
2024-10-24,26,DPD90+,0,0,0
2024-10-24,32,Current,0,0,0
2024-10-24,32,DPD15-29,70,70,0
2024-10-24,32,DPD3-14,154,154,0
2024-10-24,32,DPD30-59,45,45,0
2024-10-24,32,DPD60-89,0,0,0
2024-10-24,32,DPD90+,0,0,0
2024-10-24,34,Current,0,0,0
2024-10-24,34,DPD15-29,31,31,0
2024-10-24,34,DPD3-14,58,58,0
2024-10-24,34,DPD30-59,8,8,0
2024-10-24,34,DPD60-89,0,0,0
2024-10-24,34,DPD90+,0,0,0
2024-10-24,36,Current,0,0,0
2024-10-24,36,DPD15-29,18,18,0
2024-10-24,36,DPD3-14,43,43,0
2024-10-24,36,DPD30-59,5,5,0
2024-10-24,36,DPD60-89,0,0,0
2024-10-24,36,DPD90+,0,0,0
2024-10-24,38,Current,0,0,0
2024-10-24,38,DPD15-29,21,21,0
2024-10-24,38,DPD3-14,48,48,0
2024-10-24,38,DPD30-59,6,6,0
2024-10-24,38,DPD60-89,0,0,0
2024-10-24,38,DPD90+,0,0,0
2024-10-24,40,Current,0,0,0
2024-10-24,40,DPD15-29,7,7,0
2024-10-24,40,DPD3-14,31,31,0
2024-10-24,40,DPD30-59,13,13,0
2024-10-24,40,DPD60-89,0,0,0
2024-10-24,40,DPD90+,0,0,0
2024-10-24,42,Current,0,0,0
2024-10-24,42,DPD15-29,12,12,0
2024-10-24,42,DPD3-14,14,14,0
2024-10-24,42,DPD30-59,2,2,0
2024-10-24,42,DPD60-89,0,0,0
2024-10-24,42,DPD90+,0,0,0
2024-10-24,44,Current,0,0,0
2024-10-24,44,DPD15-29,19,19,0
2024-10-24,44,DPD3-14,43,43,0
2024-10-24,44,DPD30-59,9,9,0
2024-10-24,44,DPD60-89,0,0,0
2024-10-24,44,DPD90+,0,0,0
2024-10-24,46,Current,0,0,0
2024-10-24,46,DPD15-29,0,0,0
2024-10-24,48,Current,23,23,0
2024-10-24,48,DPD15-29,16,16,0
2024-10-24,48,DPD3-14,52,52,0
2024-10-24,48,DPD30-59,9,9,0
2024-10-24,48,DPD60-89,0,0,0
2024-10-24,48,DPD90+,0,0,0
2024-10-24,6,Current,0,0,0
2024-10-23,100,Current,0,0,0
2024-10-23,102,Current,0,0,0
2024-10-23,102,DPD30-59,0,0,0
2024-10-23,104,Current,0,0,0
2024-10-23,150,Current,10,10,0
2024-10-23,20,Current,0,0,0
2024-10-23,20,DPD15-29,221,221,0
2024-10-23,20,DPD3-14,287,287,0
2024-10-23,20,DPD30-59,103,103,0
2024-10-23,20,DPD60-89,0,0,0
2024-10-23,20,DPD90+,0,0,0
2024-10-23,22,Current,0,0,0
2024-10-23,22,DPD15-29,1,1,0
2024-10-23,22,DPD3-14,1,1,0
2024-10-23,22,DPD30-59,0,0,0
2024-10-23,22,DPD60-89,0,0,0
2024-10-23,24,Current,44,44,0
2024-10-23,24,DPD15-29,96,96,0
2024-10-23,24,DPD3-14,183,183,0
2024-10-23,24,DPD30-59,69,69,0
2024-10-23,24,DPD60-89,0,0,0
2024-10-23,24,DPD90+,0,0,0
2024-10-23,26,Current,0,0,0
2024-10-23,26,DPD15-29,13,13,0
2024-10-23,26,DPD3-14,22,22,0
2024-10-23,26,DPD30-59,4,4,0
2024-10-23,26,DPD60-89,0,0,0
2024-10-23,26,DPD90+,0,0,0
2024-10-23,32,Current,0,0,0
2024-10-23,32,DPD15-29,104,104,0
2024-10-23,32,DPD3-14,151,151,0
2024-10-23,32,DPD30-59,48,48,0
2024-10-23,32,DPD60-89,0,0,0
2024-10-23,32,DPD90+,0,0,0
2024-10-23,34,Current,0,0,0
2024-10-23,34,DPD15-29,31,31,0
2024-10-23,34,DPD3-14,68,68,0
2024-10-23,34,DPD30-59,23,23,0
2024-10-23,34,DPD60-89,0,0,0
2024-10-23,34,DPD90+,0,0,0
2024-10-23,36,Current,0,0,0
2024-10-23,36,DPD15-29,28,28,0
2024-10-23,36,DPD3-14,55,55,0
2024-10-23,36,DPD30-59,15,15,0
2024-10-23,36,DPD60-89,0,0,0
2024-10-23,36,DPD90+,0,0,0
2024-10-23,38,Current,0,0,0
2024-10-23,38,DPD15-29,36,36,0
2024-10-23,38,DPD3-14,51,51,0
2024-10-23,38,DPD30-59,15,15,0
2024-10-23,38,DPD60-89,0,0,0
2024-10-23,38,DPD90+,0,0,0
2024-10-23,40,Current,0,0,0
2024-10-23,40,DPD15-29,13,13,0
2024-10-23,40,DPD3-14,22,22,0
2024-10-23,40,DPD30-59,11,11,0
2024-10-23,40,DPD60-89,0,0,0
2024-10-23,40,DPD90+,0,0,0
2024-10-23,42,Current,0,0,0
2024-10-23,42,DPD15-29,13,13,0
2024-10-23,42,DPD3-14,22,22,0
2024-10-23,42,DPD30-59,3,3,0
2024-10-23,42,DPD60-89,0,0,0
2024-10-23,42,DPD90+,0,0,0
2024-10-23,44,Current,0,0,0
2024-10-23,44,DPD15-29,28,28,0
2024-10-23,44,DPD3-14,40,40,0
2024-10-23,44,DPD30-59,10,10,0
2024-10-23,44,DPD60-89,0,0,0
2024-10-23,44,DPD90+,0,0,0
2024-10-23,46,Current,0,0,0
2024-10-23,46,DPD15-29,1,1,0
2024-10-23,48,Current,30,30,0
2024-10-23,48,DPD15-29,23,23,0
2024-10-23,48,DPD3-14,41,41,0
2024-10-23,48,DPD30-59,14,14,0
2024-10-23,48,DPD60-89,0,0,0
2024-10-23,48,DPD90+,0,0,0
2024-10-23,6,Current,0,0,0
2024-10-22,100,Current,0,0,0
2024-10-22,102,Current,0,0,0
2024-10-22,102,DPD30-59,0,0,0
2024-10-22,104,Current,0,0,0
2024-10-22,150,Current,0,0,0
2024-10-22,20,Current,0,0,0
2024-10-22,20,DPD15-29,166,166,0
2024-10-22,20,DPD3-14,310,310,0
2024-10-22,20,DPD30-59,93,93,0
2024-10-22,20,DPD60-89,0,0,0
2024-10-22,20,DPD90+,0,0,0
2024-10-22,22,Current,0,0,0
2024-10-22,22,DPD15-29,1,1,0
2024-10-22,22,DPD3-14,0,0,0
2024-10-22,22,DPD30-59,0,0,0
2024-10-22,22,DPD60-89,0,0,0
2024-10-22,24,Current,65,65,0
2024-10-22,24,DPD15-29,95,95,0
2024-10-22,24,DPD3-14,207,207,0
2024-10-22,24,DPD30-59,58,58,0
2024-10-22,24,DPD60-89,0,0,0
2024-10-22,24,DPD90+,0,0,0
2024-10-22,26,Current,0,0,0
2024-10-22,26,DPD15-29,16,16,0
2024-10-22,26,DPD3-14,25,25,0
2024-10-22,26,DPD30-59,6,6,0
2024-10-22,26,DPD60-89,0,0,0
2024-10-22,26,DPD90+,0,0,0
2024-10-22,32,Current,0,0,0
2024-10-22,32,DPD15-29,76,76,0
2024-10-22,32,DPD3-14,153,153,0
2024-10-22,32,DPD30-59,52,52,0
2024-10-22,32,DPD60-89,0,0,0
2024-10-22,32,DPD90+,0,0,0
2024-10-22,34,Current,0,0,0
2024-10-22,34,DPD15-29,34,34,0
2024-10-22,34,DPD3-14,59,59,0
2024-10-22,34,DPD30-59,23,23,0
2024-10-22,34,DPD60-89,0,0,0
2024-10-22,34,DPD90+,0,0,0
2024-10-22,36,Current,0,0,0
2024-10-22,36,DPD15-29,21,21,0
2024-10-22,36,DPD3-14,37,37,0
2024-10-22,36,DPD30-59,11,11,0
2024-10-22,36,DPD60-89,0,0,0
2024-10-22,36,DPD90+,0,0,0
2024-10-22,38,Current,5,5,0
2024-10-22,38,DPD15-29,22,22,0
2024-10-22,38,DPD3-14,44,44,0
2024-10-22,38,DPD30-59,13,13,0
2024-10-22,38,DPD60-89,0,0,0
2024-10-22,38,DPD90+,0,0,0
2024-10-22,40,Current,0,0,0
2024-10-22,40,DPD15-29,8,8,0
2024-10-22,40,DPD3-14,28,28,0
2024-10-22,40,DPD30-59,3,3,0
2024-10-22,40,DPD60-89,0,0,0
2024-10-22,40,DPD90+,0,0,0
2024-10-22,42,Current,0,0,0
2024-10-22,42,DPD15-29,14,14,0
2024-10-22,42,DPD3-14,17,17,0
2024-10-22,42,DPD30-59,9,9,0
2024-10-22,42,DPD60-89,0,0,0
2024-10-22,42,DPD90+,0,0,0
2024-10-22,44,Current,0,0,0
2024-10-22,44,DPD15-29,16,16,0
2024-10-22,44,DPD3-14,43,43,0
2024-10-22,44,DPD30-59,16,16,0
2024-10-22,44,DPD60-89,0,0,0
2024-10-22,44,DPD90+,0,0,0
2024-10-22,46,Current,0,0,0
2024-10-22,46,DPD15-29,0,0,0
2024-10-22,48,Current,27,27,0
2024-10-22,48,DPD15-29,15,15,0
2024-10-22,48,DPD3-14,53,53,0
2024-10-22,48,DPD30-59,11,11,0
2024-10-22,48,DPD60-89,0,0,0
2024-10-22,48,DPD90+,0,0,0
2024-10-22,6,Current,0,0,0
2024-10-21,100,Current,0,0,0
2024-10-21,100,DPD3-14,1,1,0
2024-10-21,102,Current,0,0,0
2024-10-21,102,DPD30-59,0,0,0
2024-10-21,104,Current,0,0,0
2024-10-21,20,Current,0,0,0
2024-10-21,20,DPD15-29,231,231,0
2024-10-21,20,DPD3-14,341,341,0
2024-10-21,20,DPD30-59,68,68,0
2024-10-21,20,DPD60-89,0,0,0
2024-10-21,20,DPD90+,0,0,0
2024-10-21,22,Current,0,0,0
2024-10-21,22,DPD15-29,1,1,0
2024-10-21,22,DPD30-59,1,1,0
2024-10-21,22,DPD60-89,0,0,0
2024-10-21,24,Current,75,75,0
2024-10-21,24,DPD15-29,104,104,0
2024-10-21,24,DPD3-14,196,196,0
2024-10-21,24,DPD30-59,42,42,0
2024-10-21,24,DPD60-89,0,0,0
2024-10-21,24,DPD90+,0,0,0
2024-10-21,26,Current,0,0,0
2024-10-21,26,DPD15-29,18,18,0
2024-10-21,26,DPD3-14,24,24,0
2024-10-21,26,DPD30-59,12,12,0
2024-10-21,26,DPD60-89,0,0,0
2024-10-21,26,DPD90+,0,0,0
2024-10-21,32,Current,0,0,0
2024-10-21,32,DPD15-29,108,108,0
2024-10-21,32,DPD3-14,150,150,0
2024-10-21,32,DPD30-59,36,36,0
2024-10-21,32,DPD60-89,0,0,0
2024-10-21,32,DPD90+,0,0,0
2024-10-21,34,Current,0,0,0
2024-10-21,34,DPD15-29,33,33,0
2024-10-21,34,DPD3-14,71,71,0
2024-10-21,34,DPD30-59,15,15,0
2024-10-21,34,DPD60-89,0,0,0
2024-10-21,34,DPD90+,0,0,0
2024-10-21,36,Current,0,0,0
2024-10-21,36,DPD15-29,29,29,0
2024-10-21,36,DPD3-14,47,47,0
2024-10-21,36,DPD30-59,10,10,0
2024-10-21,36,DPD60-89,0,0,0
2024-10-21,36,DPD90+,0,0,0
2024-10-21,38,Current,12,12,0
2024-10-21,38,DPD15-29,39,39,0
2024-10-21,38,DPD3-14,51,51,0
2024-10-21,38,DPD30-59,14,14,0
2024-10-21,38,DPD60-89,0,0,0
2024-10-21,38,DPD90+,0,0,0
2024-10-21,40,Current,0,0,0
2024-10-21,40,DPD15-29,14,14,0
2024-10-21,40,DPD3-14,32,32,0
2024-10-21,40,DPD30-59,3,3,0
2024-10-21,40,DPD60-89,0,0,0
2024-10-21,40,DPD90+,0,0,0
2024-10-21,42,Current,0,0,0
2024-10-21,42,DPD15-29,11,11,0
2024-10-21,42,DPD3-14,30,30,0
2024-10-21,42,DPD30-59,6,6,0
2024-10-21,42,DPD60-89,0,0,0
2024-10-21,42,DPD90+,0,0,0
2024-10-21,44,Current,0,0,0
2024-10-21,44,DPD15-29,25,25,0
2024-10-21,44,DPD3-14,45,45,0
2024-10-21,44,DPD30-59,11,11,0
2024-10-21,44,DPD60-89,0,0,0
2024-10-21,44,DPD90+,0,0,0
2024-10-21,46,Current,0,0,0
2024-10-21,46,DPD3-14,1,1,0
2024-10-21,48,Current,36,36,0
2024-10-21,48,DPD15-29,25,25,0
2024-10-21,48,DPD3-14,42,42,0
2024-10-21,48,DPD30-59,10,10,0
2024-10-21,48,DPD60-89,0,0,0
2024-10-21,48,DPD90+,0,0,0
2024-10-21,6,Current,0,0,0
2024-10-20,100,Current,0,0,0
2024-10-20,100,DPD15-29,0,0,0
2024-10-20,100,DPD3-14,0,0,0
2024-10-20,102,Current,0,0,0
2024-10-20,102,DPD30-59,0,0,0
2024-10-20,104,Current,0,0,0
2024-10-20,20,Current,0,0,0
2024-10-20,20,DPD15-29,151,151,0
2024-10-20,20,DPD3-14,315,315,0
2024-10-20,20,DPD30-59,62,62,0
2024-10-20,20,DPD60-89,0,0,0
2024-10-20,20,DPD90+,0,0,0
2024-10-20,22,Current,0,0,0
2024-10-20,22,DPD15-29,1,1,0
2024-10-20,22,DPD30-59,0,0,0
2024-10-20,22,DPD60-89,0,0,0
2024-10-20,24,Current,117,117,0
2024-10-20,24,DPD15-29,91,91,0
2024-10-20,24,DPD3-14,198,198,0
2024-10-20,24,DPD30-59,34,34,0
2024-10-20,24,DPD60-89,0,0,0
2024-10-20,24,DPD90+,0,0,0
2024-10-20,26,Current,0,0,0
2024-10-20,26,DPD15-29,14,14,0
2024-10-20,26,DPD3-14,28,28,0
2024-10-20,26,DPD30-59,7,7,0
2024-10-20,26,DPD60-89,0,0,0
2024-10-20,26,DPD90+,0,0,0
2024-10-20,32,Current,0,0,0
2024-10-20,32,DPD15-29,85,85,0
2024-10-20,32,DPD3-14,145,145,0
2024-10-20,32,DPD30-59,37,37,0
2024-10-20,32,DPD60-89,0,0,0
2024-10-20,32,DPD90+,0,0,0
2024-10-20,34,Current,0,0,0
2024-10-20,34,DPD15-29,40,40,0
2024-10-20,34,DPD3-14,45,45,0
2024-10-20,34,DPD30-59,15,15,0
2024-10-20,34,DPD60-89,0,0,0
2024-10-20,34,DPD90+,0,0,0
2024-10-20,36,Current,0,0,0
2024-10-20,36,DPD15-29,30,30,0
2024-10-20,36,DPD3-14,28,28,0
2024-10-20,36,DPD30-59,4,4,0
2024-10-20,36,DPD60-89,0,0,0
2024-10-20,36,DPD90+,0,0,0
2024-10-20,38,Current,18,18,0
2024-10-20,38,DPD15-29,24,24,0
2024-10-20,38,DPD3-14,44,44,0
2024-10-20,38,DPD30-59,6,6,0
2024-10-20,38,DPD60-89,0,0,0
2024-10-20,38,DPD90+,0,0,0
2024-10-20,40,Current,0,0,0
2024-10-20,40,DPD15-29,11,11,0
2024-10-20,40,DPD3-14,27,27,0
2024-10-20,40,DPD30-59,10,10,0
2024-10-20,40,DPD60-89,0,0,0
2024-10-20,40,DPD90+,0,0,0
2024-10-20,42,Current,0,0,0
2024-10-20,42,DPD15-29,12,12,0
2024-10-20,42,DPD3-14,17,17,0
2024-10-20,42,DPD30-59,1,1,0
2024-10-20,42,DPD60-89,0,0,0
2024-10-20,42,DPD90+,0,0,0
2024-10-20,44,Current,0,0,0
2024-10-20,44,DPD15-29,22,22,0
2024-10-20,44,DPD3-14,39,39,0
2024-10-20,44,DPD30-59,11,11,0
2024-10-20,44,DPD60-89,0,0,0
2024-10-20,44,DPD90+,0,0,0
2024-10-20,46,Current,0,0,0
2024-10-20,46,DPD3-14,0,0,0
2024-10-20,48,Current,70,70,0
2024-10-20,48,DPD15-29,15,15,0
2024-10-20,48,DPD3-14,53,53,0
2024-10-20,48,DPD30-59,6,6,0
2024-10-20,48,DPD60-89,0,0,0
2024-10-20,48,DPD90+,0,0,0
2024-10-20,6,Current,0,0,0
2024-10-19,100,Current,0,0,0
2024-10-19,100,DPD15-29,0,0,0
2024-10-19,100,DPD3-14,1,1,0
2024-10-19,102,Current,0,0,0
2024-10-19,102,DPD15-29,0,0,0
2024-10-19,104,Current,0,0,0
2024-10-19,20,Current,0,0,0
2024-10-19,20,DPD15-29,226,226,0
2024-10-19,20,DPD3-14,281,281,0
2024-10-19,20,DPD30-59,91,91,0
2024-10-19,20,DPD60-89,0,0,0
2024-10-19,20,DPD90+,0,0,0
2024-10-19,22,Current,0,0,0
2024-10-19,22,DPD15-29,1,1,0
2024-10-19,22,DPD30-59,0,0,0
2024-10-19,22,DPD60-89,0,0,0
2024-10-19,24,Current,85,85,0
2024-10-19,24,DPD15-29,105,105,0
2024-10-19,24,DPD3-14,162,162,0
2024-10-19,24,DPD30-59,64,64,0
2024-10-19,24,DPD60-89,0,0,0
2024-10-19,24,DPD90+,0,0,0
2024-10-19,26,Current,0,0,0
2024-10-19,26,DPD15-29,16,16,0
2024-10-19,26,DPD3-14,25,25,0
2024-10-19,26,DPD30-59,4,4,0
2024-10-19,26,DPD60-89,0,0,0
2024-10-19,26,DPD90+,0,0,0
2024-10-19,32,Current,0,0,0
2024-10-19,32,DPD15-29,112,112,0
2024-10-19,32,DPD3-14,130,130,0
2024-10-19,32,DPD30-59,54,54,0
2024-10-19,32,DPD60-89,0,0,0
2024-10-19,32,DPD90+,0,0,0
2024-10-19,34,Current,0,0,0
2024-10-19,34,DPD15-29,37,37,0
2024-10-19,34,DPD3-14,60,60,0
2024-10-19,34,DPD30-59,26,26,0
2024-10-19,34,DPD60-89,0,0,0
2024-10-19,34,DPD90+,0,0,0
2024-10-19,36,Current,0,0,0
2024-10-19,36,DPD15-29,29,29,0
2024-10-19,36,DPD3-14,42,42,0
2024-10-19,36,DPD30-59,14,14,0
2024-10-19,36,DPD60-89,0,0,0
2024-10-19,36,DPD90+,0,0,0
2024-10-19,38,Current,18,18,0
2024-10-19,38,DPD15-29,40,40,0
2024-10-19,38,DPD3-14,47,47,0
2024-10-19,38,DPD30-59,13,13,0
2024-10-19,38,DPD60-89,0,0,0
2024-10-19,38,DPD90+,0,0,0
2024-10-19,40,Current,0,0,0
2024-10-19,40,DPD15-29,13,13,0
2024-10-19,40,DPD3-14,27,27,0
2024-10-19,40,DPD30-59,10,10,0
2024-10-19,40,DPD60-89,0,0,0
2024-10-19,40,DPD90+,0,0,0
2024-10-19,42,Current,0,0,0
2024-10-19,42,DPD15-29,12,12,0
2024-10-19,42,DPD3-14,25,25,0
2024-10-19,42,DPD30-59,2,2,0
2024-10-19,42,DPD60-89,0,0,0
2024-10-19,42,DPD90+,0,0,0
2024-10-19,44,Current,0,0,0
2024-10-19,44,DPD15-29,26,26,0
2024-10-19,44,DPD3-14,40,40,0
2024-10-19,44,DPD30-59,10,10,0
2024-10-19,44,DPD60-89,0,0,0
2024-10-19,44,DPD90+,0,0,0
2024-10-19,46,Current,0,0,0
2024-10-19,46,DPD3-14,1,1,0
2024-10-19,48,Current,42,42,0
2024-10-19,48,DPD15-29,18,18,0
2024-10-19,48,DPD3-14,41,41,0
2024-10-19,48,DPD30-59,14,14,0
2024-10-19,48,DPD60-89,0,0,0
2024-10-19,48,DPD90+,0,0,0
2024-10-19,6,Current,0,0,0
2024-10-18,100,Current,0,0,0
2024-10-18,100,DPD15-29,0,0,0
2024-10-18,100,DPD3-14,0,0,0
2024-10-18,102,Current,0,0,0
2024-10-18,102,DPD15-29,0,0,0
2024-10-18,104,Current,0,0,0
2024-10-18,20,Current,0,0,0
2024-10-18,20,DPD15-29,174,174,0
2024-10-18,20,DPD3-14,271,271,0
2024-10-18,20,DPD30-59,80,80,0
2024-10-18,20,DPD60-89,0,0,0
2024-10-18,20,DPD90+,0,0,0
2024-10-18,22,Current,0,0,0
2024-10-18,22,DPD15-29,1,1,0
2024-10-18,22,DPD30-59,0,0,0
2024-10-18,22,DPD60-89,0,0,0
2024-10-18,24,Current,91,91,0
2024-10-18,24,DPD15-29,97,97,0
2024-10-18,24,DPD3-14,192,192,0
2024-10-18,24,DPD30-59,53,53,0
2024-10-18,24,DPD60-89,0,0,0
2024-10-18,24,DPD90+,0,0,0
2024-10-18,26,Current,0,0,0
2024-10-18,26,DPD15-29,15,15,0
2024-10-18,26,DPD3-14,23,23,0
2024-10-18,26,DPD30-59,4,4,0
2024-10-18,26,DPD60-89,0,0,0
2024-10-18,26,DPD90+,0,0,0
2024-10-18,32,Current,0,0,0
2024-10-18,32,DPD15-29,88,88,0
2024-10-18,32,DPD3-14,115,115,0
2024-10-18,32,DPD30-59,42,42,0
2024-10-18,32,DPD60-89,0,0,0
2024-10-18,32,DPD90+,0,0,0
2024-10-18,34,Current,0,0,0
2024-10-18,34,DPD15-29,44,44,0
2024-10-18,34,DPD3-14,44,44,0
2024-10-18,34,DPD30-59,21,21,0
2024-10-18,34,DPD60-89,0,0,0
2024-10-18,34,DPD90+,0,0,0
2024-10-18,36,Current,0,0,0
2024-10-18,36,DPD15-29,33,33,0
2024-10-18,36,DPD3-14,24,24,0
2024-10-18,36,DPD30-59,7,7,0
2024-10-18,36,DPD60-89,0,0,0
2024-10-18,36,DPD90+,0,0,0
2024-10-18,38,Current,25,25,0
2024-10-18,38,DPD15-29,24,24,0
2024-10-18,38,DPD3-14,39,39,0
2024-10-18,38,DPD30-59,10,10,0
2024-10-18,38,DPD60-89,0,0,0
2024-10-18,38,DPD90+,0,0,0
2024-10-18,40,Current,0,0,0
2024-10-18,40,DPD15-29,12,12,0
2024-10-18,40,DPD3-14,25,25,0
2024-10-18,40,DPD30-59,4,4,0
2024-10-18,40,DPD60-89,0,0,0
2024-10-18,40,DPD90+,0,0,0
2024-10-18,42,Current,0,0,0
2024-10-18,42,DPD15-29,14,14,0
2024-10-18,42,DPD3-14,14,14,0
2024-10-18,42,DPD30-59,10,10,0
2024-10-18,42,DPD60-89,0,0,0
2024-10-18,42,DPD90+,0,0,0
2024-10-18,44,Current,0,0,0
2024-10-18,44,DPD15-29,23,23,0
2024-10-18,44,DPD3-14,29,29,0
2024-10-18,44,DPD30-59,16,16,0
2024-10-18,44,DPD60-89,0,0,0
2024-10-18,44,DPD90+,0,0,0
2024-10-18,46,Current,0,0,0
2024-10-18,46,DPD3-14,0,0,0
2024-10-18,48,Current,55,55,0
2024-10-18,48,DPD15-29,14,14,0
2024-10-18,48,DPD3-14,45,45,0
2024-10-18,48,DPD30-59,13,13,0
2024-10-18,48,DPD60-89,0,0,0
2024-10-18,48,DPD90+,0,0,0
2024-10-18,6,Current,0,0,0
2024-10-17,100,Current,0,0,0
2024-10-17,100,DPD3-14,0,0,0
2024-10-17,102,Current,0,0,0
2024-10-17,102,DPD15-29,0,0,0
2024-10-17,104,Current,0,0,0
2024-10-17,20,Current,0,0,0
2024-10-17,20,DPD15-29,252,252,0
2024-10-17,20,DPD3-14,151,151,0
2024-10-17,20,DPD30-59,66,66,0
2024-10-17,20,DPD60-89,0,0,0
2024-10-17,20,DPD90+,0,0,0
2024-10-17,22,Current,0,0,0
2024-10-17,22,DPD15-29,1,1,0
2024-10-17,22,DPD30-59,1,1,0
2024-10-17,22,DPD60-89,0,0,0
2024-10-17,24,Current,36,36,0
2024-10-17,24,DPD15-29,129,129,0
2024-10-17,24,DPD3-14,84,84,0
2024-10-17,24,DPD30-59,35,35,0
2024-10-17,24,DPD60-89,0,0,0
2024-10-17,24,DPD90+,0,0,0
2024-10-17,26,Current,0,0,0
2024-10-17,26,DPD15-29,17,17,0
2024-10-17,26,DPD3-14,18,18,0
2024-10-17,26,DPD30-59,10,10,0
2024-10-17,26,DPD60-89,0,0,0
2024-10-17,26,DPD90+,0,0,0
2024-10-17,32,Current,0,0,0
2024-10-17,32,DPD15-29,128,128,0
2024-10-17,32,DPD3-14,66,66,0
2024-10-17,32,DPD30-59,32,32,0
2024-10-17,32,DPD60-89,0,0,0
2024-10-17,32,DPD90+,0,0,0
2024-10-17,34,Current,0,0,0
2024-10-17,34,DPD15-29,46,46,0
2024-10-17,34,DPD3-14,29,29,0
2024-10-17,34,DPD30-59,14,14,0
2024-10-17,34,DPD60-89,0,0,0
2024-10-17,34,DPD90+,0,0,0
2024-10-17,36,Current,0,0,0
2024-10-17,36,DPD15-29,32,32,0
2024-10-17,36,DPD3-14,22,22,0
2024-10-17,36,DPD30-59,7,7,0
2024-10-17,36,DPD60-89,0,0,0
2024-10-17,36,DPD90+,0,0,0
2024-10-17,38,Current,8,8,0
2024-10-17,38,DPD15-29,46,46,0
2024-10-17,38,DPD3-14,23,23,0
2024-10-17,38,DPD30-59,11,11,0
2024-10-17,38,DPD60-89,0,0,0
2024-10-17,38,DPD90+,0,0,0
2024-10-17,40,Current,0,0,0
2024-10-17,40,DPD15-29,14,14,0
2024-10-17,40,DPD3-14,15,15,0
2024-10-17,40,DPD30-59,3,3,0
2024-10-17,40,DPD60-89,0,0,0
2024-10-17,40,DPD90+,0,0,0
2024-10-17,42,Current,0,0,0
2024-10-17,42,DPD15-29,14,14,0
2024-10-17,42,DPD3-14,10,10,0
2024-10-17,42,DPD30-59,7,7,0
2024-10-17,42,DPD60-89,0,0,0
2024-10-17,42,DPD90+,0,0,0
2024-10-17,44,Current,0,0,0
2024-10-17,44,DPD15-29,30,30,0
2024-10-17,44,DPD3-14,22,22,0
2024-10-17,44,DPD30-59,10,10,0
2024-10-17,44,DPD60-89,0,0,0
2024-10-17,44,DPD90+,0,0,0
2024-10-17,46,Current,0,0,0
2024-10-17,46,DPD3-14,1,1,0
2024-10-17,48,Current,26,26,0
2024-10-17,48,DPD15-29,20,20,0
2024-10-17,48,DPD3-14,32,32,0
2024-10-17,48,DPD30-59,9,9,0
2024-10-17,48,DPD60-89,0,0,0
2024-10-17,48,DPD90+,0,0,0
2024-10-17,6,Current,0,0,0
2024-10-16,100,Current,0,0,0
2024-10-16,100,DPD3-14,0,0,0
2024-10-16,102,Current,0,0,0
2024-10-16,102,DPD15-29,0,0,0
2024-10-16,104,Current,0,0,0
2024-10-16,20,Current,0,0,0
2024-10-16,20,DPD15-29,193,193,0
2024-10-16,20,DPD3-14,263,263,0
2024-10-16,20,DPD30-59,90,90,0
2024-10-16,20,DPD60-89,0,0,0
2024-10-16,20,DPD90+,0,0,0
2024-10-16,22,Current,0,0,0
2024-10-16,22,DPD15-29,2,2,0
2024-10-16,22,DPD30-59,0,0,0
2024-10-16,22,DPD60-89,0,0,0
2024-10-16,24,Current,61,61,0
2024-10-16,24,DPD15-29,111,111,0
2024-10-16,24,DPD3-14,190,190,0
2024-10-16,24,DPD30-59,42,42,0
2024-10-16,24,DPD60-89,0,0,0
2024-10-16,24,DPD90+,0,0,0
2024-10-16,26,Current,0,0,0
2024-10-16,26,DPD15-29,17,17,0
2024-10-16,26,DPD3-14,18,18,0
2024-10-16,26,DPD30-59,8,8,0
2024-10-16,26,DPD60-89,0,0,0
2024-10-16,26,DPD90+,0,0,0
2024-10-16,32,Current,0,0,0
2024-10-16,32,DPD15-29,111,111,0
2024-10-16,32,DPD3-14,102,102,0
2024-10-16,32,DPD30-59,53,53,0
2024-10-16,32,DPD60-89,0,0,0
2024-10-16,32,DPD90+,0,0,0
2024-10-16,34,Current,0,0,0
2024-10-16,34,DPD15-29,45,45,0
2024-10-16,34,DPD3-14,39,39,0
2024-10-16,34,DPD30-59,13,13,0
2024-10-16,34,DPD60-89,0,0,0
2024-10-16,34,DPD90+,0,0,0
2024-10-16,36,Current,0,0,0
2024-10-16,36,DPD15-29,37,37,0
2024-10-16,36,DPD3-14,25,25,0
2024-10-16,36,DPD30-59,5,5,0
2024-10-16,36,DPD60-89,0,0,0
2024-10-16,36,DPD90+,0,0,0
2024-10-16,38,Current,11,11,0
2024-10-16,38,DPD15-29,31,31,0
2024-10-16,38,DPD3-14,47,47,0
2024-10-16,38,DPD30-59,10,10,0
2024-10-16,38,DPD60-89,0,0,0
2024-10-16,38,DPD90+,0,0,0
2024-10-16,40,Current,0,0,0
2024-10-16,40,DPD15-29,18,18,0
2024-10-16,40,DPD3-14,27,27,0
2024-10-16,40,DPD30-59,10,10,0
2024-10-16,40,DPD60-89,0,0,0
2024-10-16,40,DPD90+,0,0,0
2024-10-16,42,Current,0,0,0
2024-10-16,42,DPD15-29,12,12,0
2024-10-16,42,DPD3-14,14,14,0
2024-10-16,42,DPD30-59,2,2,0
2024-10-16,42,DPD60-89,0,0,0
2024-10-16,42,DPD90+,0,0,0
2024-10-16,44,Current,1,1,0
2024-10-16,44,DPD15-29,27,27,0
2024-10-16,44,DPD3-14,29,29,0
2024-10-16,44,DPD30-59,13,13,0
2024-10-16,44,DPD60-89,0,0,0
2024-10-16,44,DPD90+,0,0,0
2024-10-16,46,Current,0,0,0
2024-10-16,46,DPD3-14,0,0,0
2024-10-16,48,Current,28,28,0
2024-10-16,48,DPD15-29,22,22,0
2024-10-16,48,DPD3-14,42,42,0
2024-10-16,48,DPD30-59,5,5,0
2024-10-16,48,DPD60-89,0,0,0
2024-10-16,48,DPD90+,0,0,0
2024-10-16,6,Current,0,0,0
2024-10-15,100,Current,0,0,0
2024-10-15,100,DPD3-14,0,0,0
2024-10-15,102,Current,0,0,0
2024-10-15,102,DPD15-29,0,0,0
2024-10-15,104,Current,0,0,0
2024-10-15,20,Current,4010,4010,0
2024-10-15,20,DPD15-29,326,326,0
2024-10-15,20,DPD3-14,351,351,0
2024-10-15,20,DPD30-59,186,186,0
2024-10-15,20,DPD60-89,43,43,0
2024-10-15,20,DPD90+,24,24,0
2024-10-15,22,Current,0,0,0
2024-10-15,22,DPD15-29,1,1,0
2024-10-15,22,DPD30-59,1,1,0
2024-10-15,22,DPD60-89,0,0,0
2024-10-15,24,Current,4473,4473,0
2024-10-15,24,DPD15-29,180,180,0
2024-10-15,24,DPD3-14,207,207,0
2024-10-15,24,DPD30-59,111,111,0
2024-10-15,24,DPD60-89,22,22,0
2024-10-15,24,DPD90+,15,15,0
2024-10-15,26,Current,0,0,0
2024-10-15,26,DPD15-29,26,26,0
2024-10-15,26,DPD3-14,16,16,0
2024-10-15,26,DPD30-59,3,3,0
2024-10-15,26,DPD60-89,0,0,0
2024-10-15,26,DPD90+,0,0,0
2024-10-15,32,Current,207,207,0
2024-10-15,32,DPD15-29,150,150,0
2024-10-15,32,DPD3-14,114,114,0
2024-10-15,32,DPD30-59,71,71,0
2024-10-15,32,DPD60-89,8,8,0
2024-10-15,32,DPD90+,1,1,0
2024-10-15,34,Current,0,0,0
2024-10-15,34,DPD15-29,70,70,0
2024-10-15,34,DPD3-14,32,32,0
2024-10-15,34,DPD30-59,31,31,0
2024-10-15,34,DPD60-89,0,0,0
2024-10-15,34,DPD90+,0,0,0
2024-10-15,36,Current,227,227,0
2024-10-15,36,DPD15-29,39,39,0
2024-10-15,36,DPD3-14,35,35,0
2024-10-15,36,DPD30-59,16,16,0
2024-10-15,36,DPD60-89,1,1,0
2024-10-15,36,DPD90+,1,1,0
2024-10-15,38,Current,142,142,0
2024-10-15,38,DPD15-29,40,40,0
2024-10-15,38,DPD3-14,42,42,0
2024-10-15,38,DPD30-59,12,12,0
2024-10-15,38,DPD60-89,0,0,0
2024-10-15,38,DPD90+,0,0,0
2024-10-15,40,Current,249,249,0
2024-10-15,40,DPD15-29,17,17,0
2024-10-15,40,DPD3-14,29,29,0
2024-10-15,40,DPD30-59,14,14,0
2024-10-15,40,DPD60-89,0,0,0
2024-10-15,40,DPD90+,3,3,0
2024-10-15,42,Current,0,0,0
2024-10-15,42,DPD15-29,15,15,0
2024-10-15,42,DPD3-14,11,11,0
2024-10-15,42,DPD30-59,4,4,0
2024-10-15,42,DPD60-89,0,0,0
2024-10-15,42,DPD90+,0,0,0
2024-10-15,44,Current,162,162,0
2024-10-15,44,DPD15-29,30,30,0
2024-10-15,44,DPD3-14,46,46,0
2024-10-15,44,DPD30-59,16,16,0
2024-10-15,44,DPD60-89,0,0,0
2024-10-15,44,DPD90+,2,2,0
2024-10-15,46,Current,4,4,0
2024-10-15,46,DPD3-14,2,2,0
2024-10-15,48,Current,4425,4425,0
2024-10-15,48,DPD15-29,61,61,0
2024-10-15,48,DPD3-14,91,91,0
2024-10-15,48,DPD30-59,38,38,0
2024-10-15,48,DPD60-89,25,25,0
2024-10-15,48,DPD90+,6,6,0
2024-10-15,6,Current,0,0,0
2024-10-14,100,Current,0,0,0
2024-10-14,100,DPD3-14,0,0,0
2024-10-14,102,Current,0,0,0
2024-10-14,102,DPD15-29,0,0,0
2024-10-14,104,Current,0,0,0
2024-10-14,20,Current,0,0,0
2024-10-14,20,DPD15-29,245,245,0
2024-10-14,20,DPD3-14,218,218,0
2024-10-14,20,DPD30-59,85,85,0
2024-10-14,20,DPD60-89,0,0,0
2024-10-14,20,DPD90+,0,0,0
2024-10-14,22,Current,0,0,0
2024-10-14,22,DPD15-29,2,2,0
2024-10-14,22,DPD30-59,0,0,0
2024-10-14,22,DPD60-89,0,0,0
2024-10-14,24,Current,107,107,0
2024-10-14,24,DPD15-29,129,129,0
2024-10-14,24,DPD3-14,153,153,0
2024-10-14,24,DPD30-59,59,59,0
2024-10-14,24,DPD60-89,0,0,0
2024-10-14,24,DPD90+,0,0,0
2024-10-14,26,Current,0,0,0
2024-10-14,26,DPD15-29,22,22,0
2024-10-14,26,DPD3-14,16,16,0
2024-10-14,26,DPD30-59,4,4,0
2024-10-14,26,DPD60-89,0,0,0
2024-10-14,26,DPD90+,0,0,0
2024-10-14,32,Current,0,0,0
2024-10-14,32,DPD15-29,136,136,0
2024-10-14,32,DPD3-14,82,82,0
2024-10-14,32,DPD30-59,43,43,0
2024-10-14,32,DPD60-89,0,0,0
2024-10-14,32,DPD90+,0,0,0
2024-10-14,34,Current,0,0,0
2024-10-14,34,DPD15-29,51,51,0
2024-10-14,34,DPD3-14,29,29,0
2024-10-14,34,DPD30-59,16,16,0
2024-10-14,34,DPD60-89,0,0,0
2024-10-14,34,DPD90+,0,0,0
2024-10-14,36,Current,0,0,0
2024-10-14,36,DPD15-29,45,45,0
2024-10-14,36,DPD3-14,26,26,0
2024-10-14,36,DPD30-59,11,11,0
2024-10-14,36,DPD60-89,0,0,0
2024-10-14,36,DPD90+,0,0,0
2024-10-14,38,Current,29,29,0
2024-10-14,38,DPD15-29,45,45,0
2024-10-14,38,DPD3-14,31,31,0
2024-10-14,38,DPD30-59,9,9,0
2024-10-14,38,DPD60-89,0,0,0
2024-10-14,38,DPD90+,0,0,0
2024-10-14,40,Current,0,0,0
2024-10-14,40,DPD15-29,21,21,0
2024-10-14,40,DPD3-14,21,21,0
2024-10-14,40,DPD30-59,3,3,0
2024-10-14,40,DPD60-89,0,0,0
2024-10-14,40,DPD90+,0,0,0
2024-10-14,42,Current,0,0,0
2024-10-14,42,DPD15-29,13,13,0
2024-10-14,42,DPD3-14,11,11,0
2024-10-14,42,DPD30-59,12,12,0
2024-10-14,42,DPD60-89,0,0,0
2024-10-14,42,DPD90+,0,0,0
2024-10-14,44,Current,0,0,0
2024-10-14,44,DPD15-29,34,34,0
2024-10-14,44,DPD3-14,28,28,0
2024-10-14,44,DPD30-59,11,11,0
2024-10-14,44,DPD60-89,0,0,0
2024-10-14,44,DPD90+,0,0,0
2024-10-14,46,Current,0,0,0
2024-10-14,46,DPD3-14,0,0,0
2024-10-14,48,Current,51,51,0
2024-10-14,48,DPD15-29,24,24,0
2024-10-14,48,DPD3-14,32,32,0
2024-10-14,48,DPD30-59,7,7,0
2024-10-14,48,DPD60-89,0,0,0
2024-10-14,48,DPD90+,0,0,0
2024-10-14,6,Current,0,0,0
2024-10-13,100,Current,0,0,0
2024-10-13,100,DPD3-14,0,0,0
2024-10-13,102,Current,0,0,0
2024-10-13,102,DPD15-29,0,0,0
2024-10-13,104,Current,0,0,0
2024-10-13,20,Current,0,0,0
2024-10-13,20,DPD15-29,233,233,0
2024-10-13,20,DPD3-14,271,271,0
2024-10-13,20,DPD30-59,59,59,0
2024-10-13,20,DPD60-89,0,0,0
2024-10-13,20,DPD90+,0,0,0
2024-10-13,22,Current,0,0,0
2024-10-13,22,DPD15-29,2,2,0
2024-10-13,22,DPD30-59,1,1,0
2024-10-13,22,DPD60-89,0,0,0
2024-10-13,24,Current,107,107,0
2024-10-13,24,DPD15-29,141,141,0
2024-10-13,24,DPD3-14,154,154,0
2024-10-13,24,DPD30-59,29,29,0
2024-10-13,24,DPD60-89,0,0,0
2024-10-13,24,DPD90+,0,0,0
2024-10-13,26,Current,0,0,0
2024-10-13,26,DPD15-29,21,21,0
2024-10-13,26,DPD3-14,21,21,0
2024-10-13,26,DPD30-59,6,6,0
2024-10-13,26,DPD60-89,0,0,0
2024-10-13,26,DPD90+,0,0,0
2024-10-13,32,Current,0,0,0
2024-10-13,32,DPD15-29,136,136,0
2024-10-13,32,DPD3-14,123,123,0
2024-10-13,32,DPD30-59,29,29,0
2024-10-13,32,DPD60-89,0,0,0
2024-10-13,32,DPD90+,0,0,0
2024-10-13,34,Current,0,0,0
2024-10-13,34,DPD15-29,66,66,0
2024-10-13,34,DPD3-14,45,45,0
2024-10-13,34,DPD30-59,11,11,0
2024-10-13,34,DPD60-89,0,0,0
2024-10-13,34,DPD90+,0,0,0
2024-10-13,36,Current,0,0,0
2024-10-13,36,DPD15-29,38,38,0
2024-10-13,36,DPD3-14,36,36,0
2024-10-13,36,DPD30-59,8,8,0
2024-10-13,36,DPD60-89,0,0,0
2024-10-13,36,DPD90+,0,0,0
2024-10-13,38,Current,23,23,0
2024-10-13,38,DPD15-29,33,33,0
2024-10-13,38,DPD3-14,43,43,0
2024-10-13,38,DPD30-59,12,12,0
2024-10-13,38,DPD60-89,0,0,0
2024-10-13,38,DPD90+,0,0,0
2024-10-13,40,Current,0,0,0
2024-10-13,40,DPD15-29,15,15,0
2024-10-13,40,DPD3-14,27,27,0
2024-10-13,40,DPD30-59,3,3,0
2024-10-13,40,DPD60-89,0,0,0
2024-10-13,40,DPD90+,0,0,0
2024-10-13,42,Current,0,0,0
2024-10-13,42,DPD15-29,13,13,0
2024-10-13,42,DPD3-14,15,15,0
2024-10-13,42,DPD30-59,7,7,0
2024-10-13,42,DPD60-89,0,0,0
2024-10-13,42,DPD90+,0,0,0
2024-10-13,44,Current,0,0,0
2024-10-13,44,DPD15-29,25,25,0
2024-10-13,44,DPD3-14,47,47,0
2024-10-13,44,DPD30-59,11,11,0
2024-10-13,44,DPD60-89,0,0,0
2024-10-13,44,DPD90+,0,0,0
2024-10-13,46,Current,0,0,0
2024-10-13,46,DPD3-14,2,2,0
2024-10-13,48,Current,55,55,0
2024-10-13,48,DPD15-29,26,26,0
2024-10-13,48,DPD3-14,38,38,0
2024-10-13,48,DPD30-59,9,9,0
2024-10-13,48,DPD60-89,0,0,0
2024-10-13,48,DPD90+,0,0,0
2024-10-13,6,Current,0,0,0
2024-10-12,100,Current,0,0,0
2024-10-12,100,DPD3-14,0,0,0
2024-10-12,102,Current,0,0,0
2024-10-12,102,DPD15-29,0,0,0
2024-10-12,104,Current,0,0,0
2024-10-12,20,Current,0,0,0
2024-10-12,20,DPD15-29,184,184,0
2024-10-12,20,DPD3-14,231,231,0
2024-10-12,20,DPD30-59,66,66,0
2024-10-12,20,DPD60-89,0,0,0
2024-10-12,20,DPD90+,0,0,0
2024-10-12,22,Current,0,0,0
2024-10-12,22,DPD15-29,1,1,0
2024-10-12,22,DPD3-14,1,1,0
2024-10-12,22,DPD30-59,0,0,0
2024-10-12,22,DPD60-89,0,0,0
2024-10-12,24,Current,92,92,0
2024-10-12,24,DPD15-29,100,100,0
2024-10-12,24,DPD3-14,158,158,0
2024-10-12,24,DPD30-59,38,38,0
2024-10-12,24,DPD60-89,0,0,0
2024-10-12,24,DPD90+,0,0,0
2024-10-12,26,Current,0,0,0
2024-10-12,26,DPD15-29,14,14,0
2024-10-12,26,DPD3-14,19,19,0
2024-10-12,26,DPD30-59,6,6,0
2024-10-12,26,DPD60-89,0,0,0
2024-10-12,26,DPD90+,0,0,0
2024-10-12,32,Current,0,0,0
2024-10-12,32,DPD15-29,104,104,0
2024-10-12,32,DPD3-14,98,98,0
2024-10-12,32,DPD30-59,43,43,0
2024-10-12,32,DPD60-89,0,0,0
2024-10-12,32,DPD90+,0,0,0
2024-10-12,34,Current,0,0,0
2024-10-12,34,DPD15-29,34,34,0
2024-10-12,34,DPD3-14,41,41,0
2024-10-12,34,DPD30-59,11,11,0
2024-10-12,34,DPD60-89,0,0,0
2024-10-12,34,DPD90+,0,0,0
2024-10-12,36,Current,0,0,0
2024-10-12,36,DPD15-29,33,33,0
2024-10-12,36,DPD3-14,33,33,0
2024-10-12,36,DPD30-59,5,5,0
2024-10-12,36,DPD60-89,0,0,0
2024-10-12,36,DPD90+,0,0,0
2024-10-12,38,Current,36,36,0
2024-10-12,38,DPD15-29,27,27,0
2024-10-12,38,DPD3-14,42,42,0
2024-10-12,38,DPD30-59,5,5,0
2024-10-12,38,DPD60-89,0,0,0
2024-10-12,38,DPD90+,0,0,0
2024-10-12,40,Current,0,0,0
2024-10-12,40,DPD15-29,16,16,0
2024-10-12,40,DPD3-14,21,21,0
2024-10-12,40,DPD30-59,7,7,0
2024-10-12,40,DPD60-89,0,0,0
2024-10-12,40,DPD90+,0,0,0
2024-10-12,42,Current,0,0,0
2024-10-12,42,DPD15-29,11,11,0
2024-10-12,42,DPD3-14,15,15,0
2024-10-12,42,DPD30-59,2,2,0
2024-10-12,42,DPD60-89,0,0,0
2024-10-12,42,DPD90+,0,0,0
2024-10-12,44,Current,0,0,0
2024-10-12,44,DPD15-29,24,24,0
2024-10-12,44,DPD3-14,33,33,0
2024-10-12,44,DPD30-59,9,9,0
2024-10-12,44,DPD60-89,0,0,0
2024-10-12,44,DPD90+,0,0,0
2024-10-12,46,Current,0,0,0
2024-10-12,46,DPD3-14,0,0,0
2024-10-12,48,Current,45,45,0
2024-10-12,48,DPD15-29,22,22,0
2024-10-12,48,DPD3-14,23,23,0
2024-10-12,48,DPD30-59,4,4,0
2024-10-12,48,DPD60-89,0,0,0
2024-10-12,48,DPD90+,0,0,0
2024-10-12,6,Current,0,0,0
2024-10-11,100,Current,0,0,0
2024-10-11,100,DPD3-14,0,0,0
2024-10-11,102,Current,0,0,0
2024-10-11,102,DPD15-29,0,0,0
2024-10-11,104,Current,0,0,0
2024-10-11,20,Current,0,0,0
2024-10-11,20,DPD15-29,222,222,0
2024-10-11,20,DPD3-14,285,285,0
2024-10-11,20,DPD30-59,116,116,0
2024-10-11,20,DPD60-89,0,0,0
2024-10-11,20,DPD90+,0,0,0
2024-10-11,22,Current,0,0,0
2024-10-11,22,DPD15-29,1,1,0
2024-10-11,22,DPD3-14,1,1,0
2024-10-11,22,DPD30-59,0,0,0
2024-10-11,22,DPD60-89,0,0,0
2024-10-11,24,Current,101,101,0
2024-10-11,24,DPD15-29,133,133,0
2024-10-11,24,DPD3-14,159,159,0
2024-10-11,24,DPD30-59,67,67,0
2024-10-11,24,DPD60-89,0,0,0
2024-10-11,24,DPD90+,0,0,0
2024-10-11,26,Current,0,0,0
2024-10-11,26,DPD15-29,19,19,0
2024-10-11,26,DPD3-14,25,25,0
2024-10-11,26,DPD30-59,4,4,0
2024-10-11,26,DPD60-89,0,0,0
2024-10-11,26,DPD90+,0,0,0
2024-10-11,32,Current,0,0,0
2024-10-11,32,DPD15-29,132,132,0
2024-10-11,32,DPD3-14,126,126,0
2024-10-11,32,DPD30-59,58,58,0
2024-10-11,32,DPD60-89,0,0,0
2024-10-11,32,DPD90+,0,0,0
2024-10-11,34,Current,0,0,0
2024-10-11,34,DPD15-29,65,65,0
2024-10-11,34,DPD3-14,48,48,0
2024-10-11,34,DPD30-59,24,24,0
2024-10-11,34,DPD60-89,0,0,0
2024-10-11,34,DPD90+,0,0,0
2024-10-11,36,Current,0,0,0
2024-10-11,36,DPD15-29,36,36,0
2024-10-11,36,DPD3-14,38,38,0
2024-10-11,36,DPD30-59,15,15,0
2024-10-11,36,DPD60-89,0,0,0
2024-10-11,36,DPD90+,0,0,0
2024-10-11,38,Current,17,17,0
2024-10-11,38,DPD15-29,30,30,0
2024-10-11,38,DPD3-14,50,50,0
2024-10-11,38,DPD30-59,14,14,0
2024-10-11,38,DPD60-89,0,0,0
2024-10-11,38,DPD90+,0,0,0
2024-10-11,40,Current,0,0,0
2024-10-11,40,DPD15-29,14,14,0
2024-10-11,40,DPD3-14,24,24,0
2024-10-11,40,DPD30-59,12,12,0
2024-10-11,40,DPD60-89,0,0,0
2024-10-11,40,DPD90+,0,0,0
2024-10-11,42,Current,0,0,0
2024-10-11,42,DPD15-29,13,13,0
2024-10-11,42,DPD3-14,17,17,0
2024-10-11,42,DPD30-59,3,3,0
2024-10-11,42,DPD60-89,0,0,0
2024-10-11,42,DPD90+,0,0,0
2024-10-11,44,Current,0,0,0
2024-10-11,44,DPD15-29,23,23,0
2024-10-11,44,DPD3-14,48,48,0
2024-10-11,44,DPD30-59,14,14,0
2024-10-11,44,DPD60-89,0,0,0
2024-10-11,44,DPD90+,0,0,0
2024-10-11,46,Current,0,0,0
2024-10-11,46,DPD3-14,2,2,0
2024-10-11,48,Current,47,47,0
2024-10-11,48,DPD15-29,31,31,0
2024-10-11,48,DPD3-14,41,41,0
2024-10-11,48,DPD30-59,10,10,0
2024-10-11,48,DPD60-89,0,0,0
2024-10-11,48,DPD90+,0,0,0
2024-10-11,6,Current,0,0,0
2024-10-10,100,Current,0,0,0
2024-10-10,100,DPD3-14,0,0,0
2024-10-10,102,Current,0,0,0
2024-10-10,102,DPD15-29,0,0,0
2024-10-10,104,Current,0,0,0
2024-10-10,20,Current,0,0,0
2024-10-10,20,DPD15-29,202,202,0
2024-10-10,20,DPD3-14,235,235,0
2024-10-10,20,DPD30-59,81,81,0
2024-10-10,20,DPD60-89,0,0,0
2024-10-10,20,DPD90+,0,0,0
2024-10-10,22,Current,0,0,0
2024-10-10,22,DPD15-29,1,1,0
2024-10-10,22,DPD3-14,1,1,0
2024-10-10,22,DPD30-59,1,1,0
2024-10-10,22,DPD60-89,0,0,0
2024-10-10,24,Current,58,58,0
2024-10-10,24,DPD15-29,103,103,0
2024-10-10,24,DPD3-14,176,176,0
2024-10-10,24,DPD30-59,54,54,0
2024-10-10,24,DPD60-89,0,0,0
2024-10-10,24,DPD90+,0,0,0
2024-10-10,26,Current,0,0,0
2024-10-10,26,DPD15-29,17,17,0
2024-10-10,26,DPD3-14,23,23,0
2024-10-10,26,DPD30-59,3,3,0
2024-10-10,26,DPD60-89,0,0,0
2024-10-10,26,DPD90+,0,0,0
2024-10-10,32,Current,0,0,0
2024-10-10,32,DPD15-29,103,103,0
2024-10-10,32,DPD3-14,106,106,0
2024-10-10,32,DPD30-59,48,48,0
2024-10-10,32,DPD60-89,0,0,0
2024-10-10,32,DPD90+,0,0,0
2024-10-10,34,Current,0,0,0
2024-10-10,34,DPD15-29,34,34,0
2024-10-10,34,DPD3-14,45,45,0
2024-10-10,34,DPD30-59,19,19,0
2024-10-10,34,DPD60-89,0,0,0
2024-10-10,34,DPD90+,0,0,0
2024-10-10,36,Current,0,0,0
2024-10-10,36,DPD15-29,34,34,0
2024-10-10,36,DPD3-14,38,38,0
2024-10-10,36,DPD30-59,12,12,0
2024-10-10,36,DPD60-89,0,0,0
2024-10-10,36,DPD90+,0,0,0
2024-10-10,38,Current,8,8,0
2024-10-10,38,DPD15-29,27,27,0
2024-10-10,38,DPD3-14,44,44,0
2024-10-10,38,DPD30-59,7,7,0
2024-10-10,38,DPD60-89,0,0,0
2024-10-10,38,DPD90+,0,0,0
2024-10-10,40,Current,0,0,0
2024-10-10,40,DPD15-29,18,18,0
2024-10-10,40,DPD3-14,21,21,0
2024-10-10,40,DPD30-59,3,3,0
2024-10-10,40,DPD60-89,0,0,0
2024-10-10,40,DPD90+,0,0,0
2024-10-10,42,Current,0,0,0
2024-10-10,42,DPD15-29,13,13,0
2024-10-10,42,DPD3-14,13,13,0
2024-10-10,42,DPD30-59,8,8,0
2024-10-10,42,DPD60-89,0,0,0
2024-10-10,42,DPD90+,1,1,0
2024-10-10,44,Current,0,0,0
2024-10-10,44,DPD15-29,27,27,0
2024-10-10,44,DPD3-14,34,34,0
2024-10-10,44,DPD30-59,11,11,0
2024-10-10,44,DPD60-89,0,0,0
2024-10-10,44,DPD90+,0,0,0
2024-10-10,46,Current,0,0,0
2024-10-10,46,DPD3-14,0,0,0
2024-10-10,48,Current,26,26,0
2024-10-10,48,DPD15-29,25,25,0
2024-10-10,48,DPD3-14,28,28,0
2024-10-10,48,DPD30-59,5,5,0
2024-10-10,48,DPD60-89,0,0,0
2024-10-10,48,DPD90+,0,0,0
2024-10-10,6,Current,0,0,0
2024-10-09,100,Current,0,0,0
2024-10-09,100,DPD3-14,0,0,0
2024-10-09,102,Current,0,0,0
2024-10-09,102,DPD15-29,0,0,0
2024-10-09,104,Current,0,0,0
2024-10-09,20,Current,0,0,0
2024-10-09,20,DPD15-29,221,221,0
2024-10-09,20,DPD3-14,332,332,0
2024-10-09,20,DPD30-59,76,76,0
2024-10-09,20,DPD60-89,0,0,0
2024-10-09,20,DPD90+,0,0,0
2024-10-09,22,Current,0,0,0
2024-10-09,22,DPD15-29,1,1,0
2024-10-09,22,DPD3-14,1,1,0
2024-10-09,22,DPD30-59,1,1,0
2024-10-09,22,DPD60-89,0,0,0
2024-10-09,24,Current,77,77,0
2024-10-09,24,DPD15-29,129,129,0
2024-10-09,24,DPD3-14,168,168,0
2024-10-09,24,DPD30-59,37,37,0
2024-10-09,24,DPD60-89,0,0,0
2024-10-09,24,DPD90+,0,0,0
2024-10-09,26,Current,0,0,0
2024-10-09,26,DPD15-29,17,17,0
2024-10-09,26,DPD3-14,30,30,0
2024-10-09,26,DPD30-59,8,8,0
2024-10-09,26,DPD60-89,0,0,0
2024-10-09,26,DPD90+,0,0,0
2024-10-09,32,Current,0,0,0
2024-10-09,32,DPD15-29,139,139,0
2024-10-09,32,DPD3-14,145,145,0
2024-10-09,32,DPD30-59,34,34,0
2024-10-09,32,DPD60-89,0,0,0
2024-10-09,32,DPD90+,0,0,0
2024-10-09,34,Current,0,0,0
2024-10-09,34,DPD15-29,72,72,0
2024-10-09,34,DPD3-14,51,51,0
2024-10-09,34,DPD30-59,10,10,0
2024-10-09,34,DPD60-89,0,0,0
2024-10-09,34,DPD90+,0,0,0
2024-10-09,36,Current,0,0,0
2024-10-09,36,DPD15-29,33,33,0
2024-10-09,36,DPD3-14,55,55,0
2024-10-09,36,DPD30-59,7,7,0
2024-10-09,36,DPD60-89,0,0,0
2024-10-09,36,DPD90+,0,0,0
2024-10-09,38,Current,9,9,0
2024-10-09,38,DPD15-29,32,32,0
2024-10-09,38,DPD3-14,55,55,0
2024-10-09,38,DPD30-59,12,12,0
2024-10-09,38,DPD60-89,0,0,0
2024-10-09,38,DPD90+,0,0,0
2024-10-09,40,Current,0,0,0
2024-10-09,40,DPD15-29,12,12,0
2024-10-09,40,DPD3-14,23,23,0
2024-10-09,40,DPD30-59,4,4,0
2024-10-09,40,DPD60-89,0,0,0
2024-10-09,40,DPD90+,0,0,0
2024-10-09,42,Current,0,0,0
2024-10-09,42,DPD15-29,12,12,0
2024-10-09,42,DPD3-14,19,19,0
2024-10-09,42,DPD30-59,6,6,0
2024-10-09,42,DPD60-89,0,0,0
2024-10-09,42,DPD90+,0,0,0
2024-10-09,44,Current,0,0,0
2024-10-09,44,DPD15-29,21,21,0
2024-10-09,44,DPD3-14,40,40,0
2024-10-09,44,DPD30-59,16,16,0
2024-10-09,44,DPD60-89,0,0,0
2024-10-09,44,DPD90+,0,0,0
2024-10-09,46,Current,0,0,0
2024-10-09,48,Current,33,33,0
2024-10-09,48,DPD15-29,30,30,0
2024-10-09,48,DPD3-14,41,41,0
2024-10-09,48,DPD30-59,8,8,0
2024-10-09,48,DPD60-89,0,0,0
2024-10-09,48,DPD90+,0,0,0
2024-10-09,6,Current,0,0,0
2024-10-08,100,Current,0,0,0
2024-10-08,100,DPD3-14,0,0,0
2024-10-08,102,Current,0,0,0
2024-10-08,102,DPD15-29,0,0,0
2024-10-08,104,Current,0,0,0
2024-10-08,20,Current,0,0,0
2024-10-08,20,DPD15-29,225,225,0
2024-10-08,20,DPD3-14,257,257,0
2024-10-08,20,DPD30-59,77,77,0
2024-10-08,20,DPD60-89,0,0,0
2024-10-08,20,DPD90+,0,0,0
2024-10-08,22,Current,0,0,0
2024-10-08,22,DPD15-29,1,1,0
2024-10-08,22,DPD3-14,1,1,0
2024-10-08,22,DPD30-59,0,0,0
2024-10-08,22,DPD60-89,0,0,0
2024-10-08,24,Current,57,57,0
2024-10-08,24,DPD15-29,117,117,0
2024-10-08,24,DPD3-14,165,165,0
2024-10-08,24,DPD30-59,44,44,0
2024-10-08,24,DPD60-89,0,0,0
2024-10-08,24,DPD90+,0,0,0
2024-10-08,26,Current,0,0,0
2024-10-08,26,DPD15-29,17,17,0
2024-10-08,26,DPD3-14,23,23,0
2024-10-08,26,DPD30-59,7,7,0
2024-10-08,26,DPD60-89,0,0,0
2024-10-08,26,DPD90+,0,0,0
2024-10-08,32,Current,0,0,0
2024-10-08,32,DPD15-29,108,108,0
2024-10-08,32,DPD3-14,127,127,0
2024-10-08,32,DPD30-59,46,46,0
2024-10-08,32,DPD60-89,0,0,0
2024-10-08,32,DPD90+,0,0,0
2024-10-08,34,Current,0,0,0
2024-10-08,34,DPD15-29,36,36,0
2024-10-08,34,DPD3-14,60,60,0
2024-10-08,34,DPD30-59,16,16,0
2024-10-08,34,DPD60-89,0,0,0
2024-10-08,34,DPD90+,0,0,0
2024-10-08,36,Current,0,0,0
2024-10-08,36,DPD15-29,34,34,0
2024-10-08,36,DPD3-14,43,43,0
2024-10-08,36,DPD30-59,3,3,0
2024-10-08,36,DPD60-89,0,0,0
2024-10-08,36,DPD90+,0,0,0
2024-10-08,38,Current,16,16,0
2024-10-08,38,DPD15-29,28,28,0
2024-10-08,38,DPD3-14,52,52,0
2024-10-08,38,DPD30-59,11,11,0
2024-10-08,38,DPD60-89,0,0,0
2024-10-08,38,DPD90+,0,0,0
2024-10-08,40,Current,0,0,0
2024-10-08,40,DPD15-29,22,22,0
2024-10-08,40,DPD3-14,17,17,0
2024-10-08,40,DPD30-59,4,4,0
2024-10-08,40,DPD60-89,0,0,0
2024-10-08,40,DPD90+,0,0,0
2024-10-08,42,Current,0,0,0
2024-10-08,42,DPD15-29,13,13,0
2024-10-08,42,DPD3-14,20,20,0
2024-10-08,42,DPD30-59,3,3,0
2024-10-08,42,DPD60-89,0,0,0
2024-10-08,42,DPD90+,0,0,0
2024-10-08,44,Current,0,0,0
2024-10-08,44,DPD15-29,28,28,0
2024-10-08,44,DPD3-14,35,35,0
2024-10-08,44,DPD30-59,11,11,0
2024-10-08,44,DPD60-89,0,0,0
2024-10-08,44,DPD90+,0,0,0
2024-10-08,46,Current,0,0,0
2024-10-08,48,Current,31,31,0
2024-10-08,48,DPD15-29,24,24,0
2024-10-08,48,DPD3-14,34,34,0
2024-10-08,48,DPD30-59,4,4,0
2024-10-08,48,DPD60-89,0,0,0
2024-10-08,48,DPD90+,0,0,0
2024-10-08,6,Current,0,0,0
2024-10-07,100,Current,0,0,0
2024-10-07,100,DPD3-14,0,0,0
2024-10-07,102,Current,0,0,0
2024-10-07,102,DPD15-29,0,0,0
2024-10-07,104,Current,0,0,0
2024-10-07,20,Current,0,0,0
2024-10-07,20,DPD15-29,214,214,0
2024-10-07,20,DPD3-14,416,416,0
2024-10-07,20,DPD30-59,121,121,0
2024-10-07,20,DPD60-89,0,0,0
2024-10-07,20,DPD90+,0,0,0
2024-10-07,22,Current,0,0,0
2024-10-07,22,DPD15-29,1,1,0
2024-10-07,22,DPD3-14,1,1,0
2024-10-07,22,DPD30-59,0,0,0
2024-10-07,22,DPD60-89,0,0,0
2024-10-07,24,Current,95,95,0
2024-10-07,24,DPD15-29,130,130,0
2024-10-07,24,DPD3-14,221,221,0
2024-10-07,24,DPD30-59,84,84,0
2024-10-07,24,DPD60-89,0,0,0
2024-10-07,24,DPD90+,0,0,0
2024-10-07,26,Current,0,0,0
2024-10-07,26,DPD15-29,14,14,0
2024-10-07,26,DPD3-14,34,34,0
2024-10-07,26,DPD30-59,5,5,0
2024-10-07,26,DPD60-89,0,0,0
2024-10-07,26,DPD90+,0,0,0
2024-10-07,32,Current,0,0,0
2024-10-07,32,DPD15-29,145,145,0
2024-10-07,32,DPD3-14,183,183,0
2024-10-07,32,DPD30-59,66,66,0
2024-10-07,32,DPD60-89,0,0,0
2024-10-07,32,DPD90+,0,0,0
2024-10-07,34,Current,0,0,0
2024-10-07,34,DPD15-29,74,74,0
2024-10-07,34,DPD3-14,66,66,0
2024-10-07,34,DPD30-59,25,25,0
2024-10-07,34,DPD60-89,0,0,0
2024-10-07,34,DPD90+,0,0,0
2024-10-07,36,Current,0,0,0
2024-10-07,36,DPD15-29,28,28,0
2024-10-07,36,DPD3-14,63,63,0
2024-10-07,36,DPD30-59,16,16,0
2024-10-07,36,DPD60-89,0,0,0
2024-10-07,36,DPD90+,0,0,0
2024-10-07,38,Current,23,23,0
2024-10-07,38,DPD15-29,39,39,0
2024-10-07,38,DPD3-14,82,82,0
2024-10-07,38,DPD30-59,13,13,0
2024-10-07,38,DPD60-89,0,0,0
2024-10-07,38,DPD90+,0,0,0
2024-10-07,40,Current,0,0,0
2024-10-07,40,DPD15-29,14,14,0
2024-10-07,40,DPD3-14,34,34,0
2024-10-07,40,DPD30-59,14,14,0
2024-10-07,40,DPD60-89,0,0,0
2024-10-07,40,DPD90+,0,0,0
2024-10-07,42,Current,0,0,0
2024-10-07,42,DPD15-29,10,10,0
2024-10-07,42,DPD3-14,24,24,0
2024-10-07,42,DPD30-59,5,5,0
2024-10-07,42,DPD60-89,0,0,0
2024-10-07,42,DPD90+,0,0,0
2024-10-07,44,Current,0,0,0
2024-10-07,44,DPD15-29,26,26,0
2024-10-07,44,DPD3-14,58,58,0
2024-10-07,44,DPD30-59,16,16,0
2024-10-07,44,DPD60-89,0,0,0
2024-10-07,44,DPD90+,0,0,0
2024-10-07,46,Current,0,0,0
2024-10-07,48,Current,53,53,0
2024-10-07,48,DPD15-29,35,35,0
2024-10-07,48,DPD3-14,42,42,0
2024-10-07,48,DPD30-59,9,9,0
2024-10-07,48,DPD60-89,0,0,0
2024-10-07,48,DPD90+,0,0,0
2024-10-07,6,Current,0,0,0
2024-10-06,100,Current,0,0,0
2024-10-06,100,DPD3-14,1,1,0
2024-10-06,102,Current,0,0,0
2024-10-06,102,DPD15-29,0,0,0
2024-10-06,104,Current,0,0,0
2024-10-06,20,Current,0,0,0
2024-10-06,20,DPD15-29,224,224,0
2024-10-06,20,DPD3-14,275,275,0
2024-10-06,20,DPD30-59,76,76,0
2024-10-06,20,DPD60-89,0,0,0
2024-10-06,20,DPD90+,0,0,0
2024-10-06,22,Current,0,0,0
2024-10-06,22,DPD15-29,0,0,0
2024-10-06,22,DPD3-14,2,2,0
2024-10-06,22,DPD30-59,0,0,0
2024-10-06,22,DPD60-89,0,0,0
2024-10-06,24,Current,105,105,0
2024-10-06,24,DPD15-29,111,111,0
2024-10-06,24,DPD3-14,166,166,0
2024-10-06,24,DPD30-59,47,47,0
2024-10-06,24,DPD60-89,0,0,0
2024-10-06,24,DPD90+,0,0,0
2024-10-06,26,Current,0,0,0
2024-10-06,26,DPD15-29,16,16,0
2024-10-06,26,DPD3-14,24,24,0
2024-10-06,26,DPD30-59,4,4,0
2024-10-06,26,DPD60-89,0,0,0
2024-10-06,26,DPD90+,0,0,0
2024-10-06,32,Current,0,0,0
2024-10-06,32,DPD15-29,99,99,0
2024-10-06,32,DPD3-14,144,144,0
2024-10-06,32,DPD30-59,51,51,0
2024-10-06,32,DPD60-89,0,0,0
2024-10-06,32,DPD90+,0,0,0
2024-10-06,34,Current,0,0,0
2024-10-06,34,DPD15-29,35,35,0
2024-10-06,34,DPD3-14,58,58,0
2024-10-06,34,DPD30-59,15,15,0
2024-10-06,34,DPD60-89,0,0,0
2024-10-06,34,DPD90+,0,0,0
2024-10-06,36,Current,0,0,0
2024-10-06,36,DPD15-29,28,28,0
2024-10-06,36,DPD3-14,38,38,0
2024-10-06,36,DPD30-59,13,13,0
2024-10-06,36,DPD60-89,0,0,0
2024-10-06,36,DPD90+,0,0,0
2024-10-06,38,Current,17,17,0
2024-10-06,38,DPD15-29,28,28,0
2024-10-06,38,DPD3-14,49,49,0
2024-10-06,38,DPD30-59,6,6,0
2024-10-06,38,DPD60-89,0,0,0
2024-10-06,38,DPD90+,0,0,0
2024-10-06,40,Current,0,0,0
2024-10-06,40,DPD15-29,22,22,0
2024-10-06,40,DPD3-14,21,21,0
2024-10-06,40,DPD30-59,3,3,0
2024-10-06,40,DPD60-89,0,0,0
2024-10-06,40,DPD90+,0,0,0
2024-10-06,42,Current,0,0,0
2024-10-06,42,DPD15-29,9,9,0
2024-10-06,42,DPD3-14,23,23,0
2024-10-06,42,DPD30-59,8,8,0
2024-10-06,42,DPD60-89,0,0,0
2024-10-06,42,DPD90+,0,0,0
2024-10-06,44,Current,0,0,0
2024-10-06,44,DPD15-29,27,27,0
2024-10-06,44,DPD3-14,38,38,0
2024-10-06,44,DPD30-59,10,10,0
2024-10-06,44,DPD60-89,0,0,0
2024-10-06,44,DPD90+,0,0,0
2024-10-06,46,Current,0,0,0
2024-10-06,48,Current,47,47,0
2024-10-06,48,DPD15-29,26,26,0
2024-10-06,48,DPD3-14,22,22,0
2024-10-06,48,DPD30-59,7,7,0
2024-10-06,48,DPD60-89,0,0,0
2024-10-06,48,DPD90+,0,0,0
2024-10-06,6,Current,0,0,0
2024-10-05,100,Current,0,0,0
2024-10-05,100,DPD3-14,0,0,0
2024-10-05,102,Current,0,0,0
2024-10-05,102,DPD15-29,0,0,0
2024-10-05,104,Current,0,0,0
2024-10-05,20,Current,0,0,0
2024-10-05,20,DPD15-29,194,194,0
2024-10-05,20,DPD3-14,400,400,0
2024-10-05,20,DPD30-59,69,69,0
2024-10-05,20,DPD60-89,0,0,0
2024-10-05,20,DPD90+,0,0,0
2024-10-05,22,Current,0,0,0
2024-10-05,22,DPD15-29,1,1,0
2024-10-05,22,DPD3-14,1,1,0
2024-10-05,22,DPD30-59,1,1,0
2024-10-05,22,DPD60-89,0,0,0
2024-10-05,24,Current,66,66,0
2024-10-05,24,DPD15-29,115,115,0
2024-10-05,24,DPD3-14,212,212,0
2024-10-05,24,DPD30-59,40,40,0
2024-10-05,24,DPD60-89,0,0,0
2024-10-05,24,DPD90+,0,0,0
2024-10-05,26,Current,0,0,0
2024-10-05,26,DPD15-29,12,12,0
2024-10-05,26,DPD3-14,28,28,0
2024-10-05,26,DPD30-59,9,9,0
2024-10-05,26,DPD60-89,0,0,0
2024-10-05,26,DPD90+,0,0,0
2024-10-05,32,Current,0,0,0
2024-10-05,32,DPD15-29,125,125,0
2024-10-05,32,DPD3-14,198,198,0
2024-10-05,32,DPD30-59,35,35,0
2024-10-05,32,DPD60-89,0,0,0
2024-10-05,32,DPD90+,0,0,0
2024-10-05,34,Current,0,0,0
2024-10-05,34,DPD15-29,61,61,0
2024-10-05,34,DPD3-14,73,73,0
2024-10-05,34,DPD30-59,13,13,0
2024-10-05,34,DPD60-89,0,0,0
2024-10-05,34,DPD90+,0,0,0
2024-10-05,36,Current,0,0,0
2024-10-05,36,DPD15-29,24,24,0
2024-10-05,36,DPD3-14,60,60,0
2024-10-05,36,DPD30-59,7,7,0
2024-10-05,36,DPD60-89,0,0,0
2024-10-05,36,DPD90+,0,0,0
2024-10-05,38,Current,20,20,0
2024-10-05,38,DPD15-29,31,31,0
2024-10-05,38,DPD3-14,77,77,0
2024-10-05,38,DPD30-59,14,14,0
2024-10-05,38,DPD60-89,0,0,0
2024-10-05,38,DPD90+,0,0,0
2024-10-05,40,Current,0,0,0
2024-10-05,40,DPD15-29,13,13,0
2024-10-05,40,DPD3-14,31,31,0
2024-10-05,40,DPD30-59,4,4,0
2024-10-05,40,DPD60-89,0,0,0
2024-10-05,40,DPD90+,0,0,0
2024-10-05,42,Current,0,0,0
2024-10-05,42,DPD15-29,10,10,0
2024-10-05,42,DPD3-14,20,20,0
2024-10-05,42,DPD30-59,3,3,0
2024-10-05,42,DPD60-89,0,0,0
2024-10-05,42,DPD90+,0,0,0
2024-10-05,44,Current,0,0,0
2024-10-05,44,DPD15-29,24,24,0
2024-10-05,44,DPD3-14,57,57,0
2024-10-05,44,DPD30-59,13,13,0
2024-10-05,44,DPD60-89,0,0,0
2024-10-05,44,DPD90+,0,0,0
2024-10-05,46,Current,0,0,0
2024-10-05,48,Current,41,41,0
2024-10-05,48,DPD15-29,30,30,0
2024-10-05,48,DPD3-14,41,41,0
2024-10-05,48,DPD30-59,8,8,0
2024-10-05,48,DPD60-89,0,0,0
2024-10-05,48,DPD90+,0,0,0
2024-10-05,6,Current,0,0,0
2024-10-04,100,Current,0,0,0
2024-10-04,100,DPD3-14,1,1,0
2024-10-04,102,Current,0,0,0
2024-10-04,102,DPD3-14,0,0,0
2024-10-04,104,Current,0,0,0
2024-10-04,20,Current,0,0,0
2024-10-04,20,DPD15-29,200,200,0
2024-10-04,20,DPD3-14,293,293,0
2024-10-04,20,DPD30-59,68,68,0
2024-10-04,20,DPD60-89,0,0,0
2024-10-04,20,DPD90+,0,0,0
2024-10-04,22,Current,0,0,0
2024-10-04,22,DPD15-29,0,0,0
2024-10-04,22,DPD3-14,2,2,0
2024-10-04,22,DPD30-59,0,0,0
2024-10-04,22,DPD60-89,0,0,0
2024-10-04,24,Current,87,87,0
2024-10-04,24,DPD15-29,113,113,0
2024-10-04,24,DPD3-14,177,177,0
2024-10-04,24,DPD30-59,37,37,0
2024-10-04,24,DPD60-89,0,0,0
2024-10-04,24,DPD90+,0,0,0
2024-10-04,26,Current,0,0,0
2024-10-04,26,DPD15-29,13,13,0
2024-10-04,26,DPD3-14,29,29,0
2024-10-04,26,DPD30-59,6,6,0
2024-10-04,26,DPD60-89,0,0,0
2024-10-04,26,DPD90+,0,0,0
2024-10-04,32,Current,0,0,0
2024-10-04,32,DPD15-29,80,80,0
2024-10-04,32,DPD3-14,161,161,0
2024-10-04,32,DPD30-59,41,41,0
2024-10-04,32,DPD60-89,0,0,0
2024-10-04,32,DPD90+,0,0,0
2024-10-04,34,Current,0,0,0
2024-10-04,34,DPD15-29,29,29,0
2024-10-04,34,DPD3-14,68,68,0
2024-10-04,34,DPD30-59,16,16,0
2024-10-04,34,DPD60-89,0,0,0
2024-10-04,34,DPD90+,0,0,0
2024-10-04,36,Current,0,0,0
2024-10-04,36,DPD15-29,23,23,0
2024-10-04,36,DPD3-14,45,45,0
2024-10-04,36,DPD30-59,3,3,0
2024-10-04,36,DPD60-89,0,0,0
2024-10-04,36,DPD90+,0,0,0
2024-10-04,38,Current,12,12,0
2024-10-04,38,DPD15-29,23,23,0
2024-10-04,38,DPD3-14,58,58,0
2024-10-04,38,DPD30-59,9,9,0
2024-10-04,38,DPD60-89,0,0,0
2024-10-04,38,DPD90+,0,0,0
2024-10-04,40,Current,0,0,0
2024-10-04,40,DPD15-29,21,21,0
2024-10-04,40,DPD3-14,22,22,0
2024-10-04,40,DPD30-59,5,5,0
2024-10-04,40,DPD60-89,0,0,0
2024-10-04,40,DPD90+,0,0,0
2024-10-04,42,Current,0,0,0
2024-10-04,42,DPD15-29,8,8,0
2024-10-04,42,DPD3-14,24,24,0
2024-10-04,42,DPD30-59,5,5,0
2024-10-04,42,DPD60-89,0,0,0
2024-10-04,42,DPD90+,0,0,0
2024-10-04,44,Current,0,0,0
2024-10-04,44,DPD15-29,25,25,0
2024-10-04,44,DPD3-14,38,38,0
2024-10-04,44,DPD30-59,10,10,0
2024-10-04,44,DPD60-89,0,0,0
2024-10-04,44,DPD90+,0,0,0
2024-10-04,46,Current,0,0,0
2024-10-04,48,Current,41,41,0
2024-10-04,48,DPD15-29,25,25,0
2024-10-04,48,DPD3-14,26,26,0
2024-10-04,48,DPD30-59,7,7,0
2024-10-04,48,DPD60-89,0,0,0
2024-10-04,48,DPD90+,0,0,0
2024-10-04,6,Current,0,0,0
2024-10-03,100,Current,0,0,0
2024-10-03,100,DPD15-29,1,1,0
2024-10-03,100,DPD3-14,0,0,0
2024-10-03,102,Current,0,0,0
2024-10-03,102,DPD3-14,0,0,0
2024-10-03,104,Current,0,0,0
2024-10-03,20,Current,0,0,0
2024-10-03,20,DPD15-29,212,212,0
2024-10-03,20,DPD3-14,281,281,0
2024-10-03,20,DPD30-59,115,115,0
2024-10-03,20,DPD60-89,0,0,0
2024-10-03,20,DPD90+,0,0,0
2024-10-03,22,Current,0,0,0
2024-10-03,22,DPD15-29,1,1,0
2024-10-03,22,DPD3-14,1,1,0
2024-10-03,22,DPD30-59,0,0,0
2024-10-03,22,DPD60-89,0,0,0
2024-10-03,24,Current,52,52,0
2024-10-03,24,DPD15-29,108,108,0
2024-10-03,24,DPD3-14,176,176,0
2024-10-03,24,DPD30-59,84,84,0
2024-10-03,24,DPD60-89,0,0,0
2024-10-03,24,DPD90+,0,0,0
2024-10-03,26,Current,0,0,0
2024-10-03,26,DPD15-29,17,17,0
2024-10-03,26,DPD3-14,23,23,0
2024-10-03,26,DPD30-59,5,5,0
2024-10-03,26,DPD60-89,0,0,0
2024-10-03,26,DPD90+,0,0,0
2024-10-03,32,Current,0,0,0
2024-10-03,32,DPD15-29,131,131,0
2024-10-03,32,DPD3-14,159,159,0
2024-10-03,32,DPD30-59,65,65,0
2024-10-03,32,DPD60-89,0,0,0
2024-10-03,32,DPD90+,0,0,0
2024-10-03,34,Current,0,0,0
2024-10-03,34,DPD15-29,60,60,0
2024-10-03,34,DPD3-14,71,71,0
2024-10-03,34,DPD30-59,26,26,0
2024-10-03,34,DPD60-89,0,0,0
2024-10-03,34,DPD90+,0,0,0
2024-10-03,36,Current,0,0,0
2024-10-03,36,DPD15-29,28,28,0
2024-10-03,36,DPD3-14,48,48,0
2024-10-03,36,DPD30-59,17,17,0
2024-10-03,36,DPD60-89,0,0,0
2024-10-03,36,DPD90+,0,0,0
2024-10-03,38,Current,18,18,0
2024-10-03,38,DPD15-29,30,30,0
2024-10-03,38,DPD3-14,63,63,0
2024-10-03,38,DPD30-59,12,12,0
2024-10-03,38,DPD60-89,0,0,0
2024-10-03,38,DPD90+,0,0,0
2024-10-03,40,Current,0,0,0
2024-10-03,40,DPD15-29,15,15,0
2024-10-03,40,DPD3-14,24,24,0
2024-10-03,40,DPD30-59,11,11,0
2024-10-03,40,DPD60-89,0,0,0
2024-10-03,40,DPD90+,0,0,0
2024-10-03,42,Current,0,0,0
2024-10-03,42,DPD15-29,12,12,0
2024-10-03,42,DPD3-14,16,16,0
2024-10-03,42,DPD30-59,5,5,0
2024-10-03,42,DPD60-89,0,0,0
2024-10-03,42,DPD90+,0,0,0
2024-10-03,44,Current,0,0,0
2024-10-03,44,DPD15-29,24,24,0
2024-10-03,44,DPD3-14,44,44,0
2024-10-03,44,DPD30-59,20,20,0
2024-10-03,44,DPD60-89,0,0,0
2024-10-03,44,DPD90+,0,0,0
2024-10-03,46,Current,0,0,0
2024-10-03,48,Current,27,27,0
2024-10-03,48,DPD15-29,33,33,0
2024-10-03,48,DPD3-14,38,38,0
2024-10-03,48,DPD30-59,12,12,0
2024-10-03,48,DPD60-89,0,0,0
2024-10-03,48,DPD90+,0,0,0
2024-10-03,6,Current,0,0,0
2024-10-02,100,Current,0,0,0
2024-10-02,100,DPD15-29,0,0,0
2024-10-02,100,DPD3-14,1,1,0
2024-10-02,102,Current,0,0,0
2024-10-02,102,DPD3-14,0,0,0
2024-10-02,104,Current,0,0,0
2024-10-02,20,Current,0,0,0
2024-10-02,20,DPD15-29,196,196,0
2024-10-02,20,DPD3-14,399,399,0
2024-10-02,20,DPD30-59,89,89,0
2024-10-02,20,DPD60-89,0,0,0
2024-10-02,20,DPD90+,0,0,0
2024-10-02,22,Current,0,0,0
2024-10-02,22,DPD15-29,0,0,0
2024-10-02,22,DPD3-14,2,2,0
2024-10-02,22,DPD30-59,0,0,0
2024-10-02,22,DPD60-89,0,0,0
2024-10-02,24,Current,46,46,0
2024-10-02,24,DPD15-29,105,105,0
2024-10-02,24,DPD3-14,229,229,0
2024-10-02,24,DPD30-59,56,56,0
2024-10-02,24,DPD60-89,0,0,0
2024-10-02,24,DPD90+,0,0,0
2024-10-02,26,Current,0,0,0
2024-10-02,26,DPD15-29,8,8,0
2024-10-02,26,DPD3-14,36,36,0
2024-10-02,26,DPD30-59,7,7,0
2024-10-02,26,DPD60-89,0,0,0
2024-10-02,26,DPD90+,0,0,0
2024-10-02,32,Current,0,0,0
2024-10-02,32,DPD15-29,76,76,0
2024-10-02,32,DPD3-14,190,190,0
2024-10-02,32,DPD30-59,69,69,0
2024-10-02,32,DPD60-89,0,0,0
2024-10-02,32,DPD90+,0,0,0
2024-10-02,34,Current,0,0,0
2024-10-02,34,DPD15-29,20,20,0
2024-10-02,34,DPD3-14,92,92,0
2024-10-02,34,DPD30-59,18,18,0
2024-10-02,34,DPD60-89,0,0,0
2024-10-02,34,DPD90+,0,0,0
2024-10-02,36,Current,0,0,0
2024-10-02,36,DPD15-29,19,19,0
2024-10-02,36,DPD3-14,62,62,0
2024-10-02,36,DPD30-59,10,10,0
2024-10-02,36,DPD60-89,0,0,0
2024-10-02,36,DPD90+,0,0,0
2024-10-02,38,Current,15,15,0
2024-10-02,38,DPD15-29,20,20,0
2024-10-02,38,DPD3-14,69,69,0
2024-10-02,38,DPD30-59,8,8,0
2024-10-02,38,DPD60-89,0,0,0
2024-10-02,38,DPD90+,0,0,0
2024-10-02,40,Current,0,0,0
2024-10-02,40,DPD15-29,20,20,0
2024-10-02,40,DPD3-14,32,32,0
2024-10-02,40,DPD30-59,2,2,0
2024-10-02,40,DPD60-89,0,0,0
2024-10-02,40,DPD90+,0,0,0
2024-10-02,42,Current,0,0,0
2024-10-02,42,DPD15-29,9,9,0
2024-10-02,42,DPD3-14,27,27,0
2024-10-02,42,DPD30-59,8,8,0
2024-10-02,42,DPD60-89,0,0,0
2024-10-02,42,DPD90+,0,0,0
2024-10-02,44,Current,0,0,0
2024-10-02,44,DPD15-29,21,21,0
2024-10-02,44,DPD3-14,47,47,0
2024-10-02,44,DPD30-59,12,12,0
2024-10-02,44,DPD60-89,0,0,0
2024-10-02,44,DPD90+,0,0,0
2024-10-02,46,Current,0,0,0
2024-10-02,46,DPD15-29,0,0,0
2024-10-02,48,Current,34,34,0
2024-10-02,48,DPD15-29,24,24,0
2024-10-02,48,DPD3-14,38,38,0
2024-10-02,48,DPD30-59,7,7,0
2024-10-02,48,DPD60-89,0,0,0
2024-10-02,48,DPD90+,0,0,0
2024-10-02,6,DPD3-14,0,0,0
2024-10-01,100,Current,0,0,0
2024-10-01,100,DPD15-29,1,1,0
2024-10-01,100,DPD3-14,0,0,0
2024-10-01,102,Current,0,0,0
2024-10-01,102,DPD3-14,0,0,0
2024-10-01,104,Current,0,0,0
2024-10-01,20,Current,4103,4103,0
2024-10-01,20,DPD15-29,303,303,0
2024-10-01,20,DPD3-14,443,443,0
2024-10-01,20,DPD30-59,157,157,0
2024-10-01,20,DPD60-89,35,35,0
2024-10-01,20,DPD90+,27,27,0
2024-10-01,22,Current,0,0,0
2024-10-01,22,DPD15-29,1,1,0
2024-10-01,22,DPD3-14,2,2,0
2024-10-01,22,DPD30-59,1,1,0
2024-10-01,22,DPD60-89,0,0,0
2024-10-01,24,Current,4449,4449,0
2024-10-01,24,DPD15-29,150,150,0
2024-10-01,24,DPD3-14,280,280,0
2024-10-01,24,DPD30-59,79,79,0
2024-10-01,24,DPD60-89,15,15,0
2024-10-01,24,DPD90+,17,17,0
2024-10-01,26,Current,0,0,0
2024-10-01,26,DPD15-29,19,19,0
2024-10-01,26,DPD3-14,29,29,0
2024-10-01,26,DPD30-59,10,10,0
2024-10-01,26,DPD60-89,0,0,0
2024-10-01,26,DPD90+,0,0,0
2024-10-01,32,Current,213,213,0
2024-10-01,32,DPD15-29,140,140,0
2024-10-01,32,DPD3-14,214,214,0
2024-10-01,32,DPD30-59,40,40,0
2024-10-01,32,DPD60-89,4,4,0
2024-10-01,32,DPD90+,2,2,0
2024-10-01,34,Current,0,0,0
2024-10-01,34,DPD15-29,56,56,0
2024-10-01,34,DPD3-14,85,85,0
2024-10-01,34,DPD30-59,14,14,0
2024-10-01,34,DPD60-89,0,0,0
2024-10-01,34,DPD90+,0,0,0
2024-10-01,36,Current,230,230,0
2024-10-01,36,DPD15-29,31,31,0
2024-10-01,36,DPD3-14,65,65,0
2024-10-01,36,DPD30-59,12,12,0
2024-10-01,36,DPD60-89,2,2,0
2024-10-01,36,DPD90+,0,0,0
2024-10-01,38,Current,119,119,0
2024-10-01,38,DPD15-29,36,36,0
2024-10-01,38,DPD3-14,68,68,0
2024-10-01,38,DPD30-59,17,17,0
2024-10-01,38,DPD60-89,0,0,0
2024-10-01,38,DPD90+,0,0,0
2024-10-01,40,Current,251,251,0
2024-10-01,40,DPD15-29,22,22,0
2024-10-01,40,DPD3-14,37,37,0
2024-10-01,40,DPD30-59,6,6,0
2024-10-01,40,DPD60-89,1,1,0
2024-10-01,40,DPD90+,2,2,0
2024-10-01,42,Current,0,0,0
2024-10-01,42,DPD15-29,13,13,0
2024-10-01,42,DPD3-14,16,16,0
2024-10-01,42,DPD30-59,7,7,0
2024-10-01,42,DPD60-89,0,0,0
2024-10-01,42,DPD90+,0,0,0
2024-10-01,44,Current,166,166,0
2024-10-01,44,DPD15-29,35,35,0
2024-10-01,44,DPD3-14,51,51,0
2024-10-01,44,DPD30-59,15,15,0
2024-10-01,44,DPD60-89,2,2,0
2024-10-01,44,DPD90+,0,0,0
2024-10-01,46,Current,4,4,0
2024-10-01,46,DPD15-29,1,1,0
2024-10-01,48,Current,4385,4385,0
2024-10-01,48,DPD15-29,65,65,0
2024-10-01,48,DPD3-14,124,124,0
2024-10-01,48,DPD30-59,30,30,0
2024-10-01,48,DPD60-89,20,20,0
2024-10-01,48,DPD90+,7,7,0
2024-10-01,6,DPD3-14,1,1,0
2024-09-30,100,Current,0,0,0
2024-09-30,100,DPD15-29,0,0,0
2024-09-30,100,DPD3-14,1,1,0
2024-09-30,102,Current,0,0,0
2024-09-30,102,DPD3-14,0,0,0
2024-09-30,104,Current,0,0,0
2024-09-30,104,DPD30-59,0,0,0
2024-09-30,20,Current,0,0,0
2024-09-30,20,DPD15-29,190,190,0
2024-09-30,20,DPD3-14,378,378,0
2024-09-30,20,DPD30-59,80,80,0
2024-09-30,20,DPD60-89,0,0,0
2024-09-30,20,DPD90+,0,0,0
2024-09-30,22,Current,0,0,0
2024-09-30,22,DPD15-29,0,0,0
2024-09-30,22,DPD3-14,1,1,0
2024-09-30,22,DPD30-59,0,0,0
2024-09-30,22,DPD60-89,0,0,0
2024-09-30,24,Current,87,87,0
2024-09-30,24,DPD15-29,105,105,0
2024-09-30,24,DPD3-14,242,242,0
2024-09-30,24,DPD30-59,35,35,0
2024-09-30,24,DPD60-89,0,0,0
2024-09-30,24,DPD90+,0,0,0
2024-09-30,26,Current,0,0,0
2024-09-30,26,DPD15-29,9,9,0
2024-09-30,26,DPD3-14,33,33,0
2024-09-30,26,DPD30-59,4,4,0
2024-09-30,26,DPD60-89,0,0,0
2024-09-30,26,DPD90+,0,0,0
2024-09-30,32,Current,0,0,0
2024-09-30,32,DPD15-29,60,60,0
2024-09-30,32,DPD3-14,183,183,0
2024-09-30,32,DPD30-59,42,42,0
2024-09-30,32,DPD60-89,0,0,0
2024-09-30,32,DPD90+,0,0,0
2024-09-30,34,Current,0,0,0
2024-09-30,34,DPD15-29,23,23,0
2024-09-30,34,DPD3-14,67,67,0
2024-09-30,34,DPD30-59,19,19,0
2024-09-30,34,DPD60-89,0,0,0
2024-09-30,34,DPD90+,0,0,0
2024-09-30,36,Current,0,0,0
2024-09-30,36,DPD15-29,18,18,0
2024-09-30,36,DPD3-14,55,55,0
2024-09-30,36,DPD30-59,4,4,0
2024-09-30,36,DPD60-89,0,0,0
2024-09-30,36,DPD90+,0,0,0
2024-09-30,38,Current,20,20,0
2024-09-30,38,DPD15-29,16,16,0
2024-09-30,38,DPD3-14,65,65,0
2024-09-30,38,DPD30-59,7,7,0
2024-09-30,38,DPD60-89,0,0,0
2024-09-30,38,DPD90+,0,0,0
2024-09-30,40,Current,0,0,0
2024-09-30,40,DPD15-29,19,19,0
2024-09-30,40,DPD3-14,41,41,0
2024-09-30,40,DPD30-59,3,3,0
2024-09-30,40,DPD60-89,0,0,0
2024-09-30,40,DPD90+,0,0,0
2024-09-30,42,Current,0,0,0
2024-09-30,42,DPD15-29,11,11,0
2024-09-30,42,DPD3-14,28,28,0
2024-09-30,42,DPD30-59,5,5,0
2024-09-30,42,DPD60-89,0,0,0
2024-09-30,42,DPD90+,0,0,0
2024-09-30,44,Current,0,0,0
2024-09-30,44,DPD15-29,27,27,0
2024-09-30,44,DPD3-14,51,51,0
2024-09-30,44,DPD30-59,11,11,0
2024-09-30,44,DPD60-89,0,0,0
2024-09-30,44,DPD90+,0,0,0
2024-09-30,46,Current,0,0,0
2024-09-30,46,DPD15-29,0,0,0
2024-09-30,48,Current,44,44,0
2024-09-30,48,DPD15-29,19,19,0
2024-09-30,48,DPD3-14,51,51,0
2024-09-30,48,DPD30-59,9,9,0
2024-09-30,48,DPD60-89,0,0,0
2024-09-30,48,DPD90+,0,0,0
2024-09-30,6,DPD3-14,0,0,0
2024-09-29,100,Current,0,0,0
2024-09-29,100,DPD3-14,1,1,0
2024-09-29,102,Current,0,0,0
2024-09-29,102,DPD3-14,0,0,0
2024-09-29,104,Current,0,0,0
2024-09-29,104,DPD30-59,0,0,0
2024-09-29,20,Current,0,0,0
2024-09-29,20,DPD15-29,145,145,0
2024-09-29,20,DPD3-14,407,407,0
2024-09-29,20,DPD30-59,133,133,0
2024-09-29,20,DPD60-89,0,0,0
2024-09-29,20,DPD90+,0,0,0
2024-09-29,22,Current,0,0,0
2024-09-29,22,DPD15-29,1,1,0
2024-09-29,22,DPD3-14,1,1,0
2024-09-29,22,DPD30-59,0,0,0
2024-09-29,22,DPD60-89,0,0,0
2024-09-29,24,Current,91,91,0
2024-09-29,24,DPD15-29,70,70,0
2024-09-29,24,DPD3-14,239,239,0
2024-09-29,24,DPD30-59,97,97,0
2024-09-29,24,DPD60-89,0,0,0
2024-09-29,24,DPD90+,0,0,0
2024-09-29,26,Current,0,0,0
2024-09-29,26,DPD15-29,8,8,0
2024-09-29,26,DPD3-14,36,36,0
2024-09-29,26,DPD30-59,8,8,0
2024-09-29,26,DPD60-89,0,0,0
2024-09-29,26,DPD90+,0,0,0
2024-09-29,32,Current,0,0,0
2024-09-29,32,DPD15-29,83,83,0
2024-09-29,32,DPD3-14,217,217,0
2024-09-29,32,DPD30-59,70,70,0
2024-09-29,32,DPD60-89,0,0,0
2024-09-29,32,DPD90+,0,0,0
2024-09-29,34,Current,0,0,0
2024-09-29,34,DPD15-29,30,30,0
2024-09-29,34,DPD3-14,87,87,0
2024-09-29,34,DPD30-59,35,35,0
2024-09-29,34,DPD60-89,0,0,0
2024-09-29,34,DPD90+,0,0,0
2024-09-29,36,Current,0,0,0
2024-09-29,36,DPD15-29,19,19,0
2024-09-29,36,DPD3-14,63,63,0
2024-09-29,36,DPD30-59,20,20,0
2024-09-29,36,DPD60-89,0,0,0
2024-09-29,36,DPD90+,0,0,0
2024-09-29,38,Current,14,14,0
2024-09-29,38,DPD15-29,24,24,0
2024-09-29,38,DPD3-14,70,70,0
2024-09-29,38,DPD30-59,18,18,0
2024-09-29,38,DPD60-89,0,0,0
2024-09-29,38,DPD90+,0,0,0
2024-09-29,40,Current,0,0,0
2024-09-29,40,DPD15-29,12,12,0
2024-09-29,40,DPD3-14,31,31,0
2024-09-29,40,DPD30-59,11,11,0
2024-09-29,40,DPD60-89,0,0,0
2024-09-29,40,DPD90+,0,0,0
2024-09-29,42,Current,0,0,0
2024-09-29,42,DPD15-29,8,8,0
2024-09-29,42,DPD3-14,17,17,0
2024-09-29,42,DPD30-59,7,7,0
2024-09-29,42,DPD60-89,0,0,0
2024-09-29,42,DPD90+,0,0,0
2024-09-29,44,Current,0,0,0
2024-09-29,44,DPD15-29,21,21,0
2024-09-29,44,DPD3-14,53,53,0
2024-09-29,44,DPD30-59,17,17,0
2024-09-29,44,DPD60-89,0,0,0
2024-09-29,44,DPD90+,0,0,0
2024-09-29,46,Current,0,0,0
2024-09-29,46,DPD15-29,1,1,0
2024-09-29,48,Current,52,52,0
2024-09-29,48,DPD15-29,20,20,0
2024-09-29,48,DPD3-14,57,57,0
2024-09-29,48,DPD30-59,13,13,0
2024-09-29,48,DPD60-89,0,0,0
2024-09-29,48,DPD90+,0,0,0
2024-09-29,6,Current,0,0,0
2024-09-28,100,Current,0,0,0
2024-09-28,100,DPD3-14,0,0,0
2024-09-28,102,Current,0,0,0
2024-09-28,102,DPD3-14,0,0,0
2024-09-28,104,Current,0,0,0
2024-09-28,104,DPD30-59,0,0,0
2024-09-28,20,Current,0,0,0
2024-09-28,20,DPD15-29,147,147,0
2024-09-28,20,DPD3-14,356,356,0
2024-09-28,20,DPD30-59,77,77,0
2024-09-28,20,DPD60-89,0,0,0
2024-09-28,20,DPD90+,0,0,0
2024-09-28,22,Current,0,0,0
2024-09-28,22,DPD15-29,0,0,0
2024-09-28,22,DPD3-14,1,1,0
2024-09-28,22,DPD30-59,0,0,0
2024-09-28,22,DPD60-89,0,0,0
2024-09-28,24,Current,82,82,0
2024-09-28,24,DPD15-29,89,89,0
2024-09-28,24,DPD3-14,206,206,0
2024-09-28,24,DPD30-59,48,48,0
2024-09-28,24,DPD60-89,0,0,0
2024-09-28,24,DPD90+,0,0,0
2024-09-28,26,Current,0,0,0
2024-09-28,26,DPD15-29,9,9,0
2024-09-28,26,DPD3-14,29,29,0
2024-09-28,26,DPD30-59,5,5,0
2024-09-28,26,DPD60-89,0,0,0
2024-09-28,26,DPD90+,0,0,0
2024-09-28,32,Current,0,0,0
2024-09-28,32,DPD15-29,54,54,0
2024-09-28,32,DPD3-14,160,160,0
2024-09-28,32,DPD30-59,66,66,0
2024-09-28,32,DPD60-89,0,0,0
2024-09-28,32,DPD90+,0,0,0
2024-09-28,34,Current,0,0,0
2024-09-28,34,DPD15-29,19,19,0
2024-09-28,34,DPD3-14,59,59,0
2024-09-28,34,DPD30-59,18,18,0
2024-09-28,34,DPD60-89,0,0,0
2024-09-28,34,DPD90+,0,0,0
2024-09-28,36,Current,0,0,0
2024-09-28,36,DPD15-29,15,15,0
2024-09-28,36,DPD3-14,46,46,0
2024-09-28,36,DPD30-59,11,11,0
2024-09-28,36,DPD60-89,0,0,0
2024-09-28,36,DPD90+,0,0,0
2024-09-28,38,Current,18,18,0
2024-09-28,38,DPD15-29,14,14,0
2024-09-28,38,DPD3-14,57,57,0
2024-09-28,38,DPD30-59,7,7,0
2024-09-28,38,DPD60-89,0,0,0
2024-09-28,38,DPD90+,0,0,0
2024-09-28,40,Current,0,0,0
2024-09-28,40,DPD15-29,14,14,0
2024-09-28,40,DPD3-14,39,39,0
2024-09-28,40,DPD30-59,3,3,0
2024-09-28,40,DPD60-89,0,0,0
2024-09-28,40,DPD90+,0,0,0
2024-09-28,42,Current,0,0,0
2024-09-28,42,DPD15-29,8,8,0
2024-09-28,42,DPD3-14,23,23,0
2024-09-28,42,DPD30-59,8,8,0
2024-09-28,42,DPD60-89,0,0,0
2024-09-28,42,DPD90+,0,0,0
2024-09-28,44,Current,0,0,0
2024-09-28,44,DPD15-29,21,21,0
2024-09-28,44,DPD3-14,44,44,0
2024-09-28,44,DPD30-59,8,8,0
2024-09-28,44,DPD60-89,0,0,0
2024-09-28,44,DPD90+,0,0,0
2024-09-28,46,Current,0,0,0
2024-09-28,46,DPD15-29,0,0,0
2024-09-28,48,Current,39,39,0
2024-09-28,48,DPD15-29,13,13,0
2024-09-28,48,DPD3-14,46,46,0
2024-09-28,48,DPD30-59,6,6,0
2024-09-28,48,DPD60-89,0,0,0
2024-09-28,48,DPD90+,0,0,0
2024-09-28,6,Current,0,0,0
2024-09-27,100,Current,0,0,0
2024-09-27,100,DPD3-14,1,1,0
2024-09-27,102,Current,0,0,0
2024-09-27,102,DPD3-14,0,0,0
2024-09-27,104,Current,0,0,0
2024-09-27,104,DPD30-59,0,0,0
2024-09-27,20,Current,1,1,0
2024-09-27,20,DPD15-29,177,177,0
2024-09-27,20,DPD3-14,376,376,0
2024-09-27,20,DPD30-59,99,99,0
2024-09-27,20,DPD60-89,0,0,0
2024-09-27,20,DPD90+,0,0,0
2024-09-27,22,Current,0,0,0
2024-09-27,22,DPD3-14,2,2,0
2024-09-27,22,DPD30-59,2,2,0
2024-09-27,22,DPD60-89,0,0,0
2024-09-27,24,Current,58,58,0
2024-09-27,24,DPD15-29,92,92,0
2024-09-27,24,DPD3-14,233,233,0
2024-09-27,24,DPD30-59,40,40,0
2024-09-27,24,DPD60-89,0,0,0
2024-09-27,24,DPD90+,0,0,0
2024-09-27,26,Current,0,0,0
2024-09-27,26,DPD15-29,14,14,0
2024-09-27,26,DPD3-14,37,37,0
2024-09-27,26,DPD30-59,9,9,0
2024-09-27,26,DPD60-89,0,0,0
2024-09-27,26,DPD90+,0,0,0
2024-09-27,32,Current,0,0,0
2024-09-27,32,DPD15-29,96,96,0
2024-09-27,32,DPD3-14,195,195,0
2024-09-27,32,DPD30-59,37,37,0
2024-09-27,32,DPD60-89,0,0,0
2024-09-27,32,DPD90+,0,0,0
2024-09-27,34,Current,0,0,0
2024-09-27,34,DPD15-29,38,38,0
2024-09-27,34,DPD3-14,91,91,0
2024-09-27,34,DPD30-59,15,15,0
2024-09-27,34,DPD60-89,0,0,0
2024-09-27,34,DPD90+,0,0,0
2024-09-27,36,Current,0,0,0
2024-09-27,36,DPD15-29,28,28,0
2024-09-27,36,DPD3-14,54,54,0
2024-09-27,36,DPD30-59,11,11,0
2024-09-27,36,DPD60-89,0,0,0
2024-09-27,36,DPD90+,0,0,0
2024-09-27,38,Current,15,15,0
2024-09-27,38,DPD15-29,28,28,0
2024-09-27,38,DPD3-14,70,70,0
2024-09-27,38,DPD30-59,16,16,0
2024-09-27,38,DPD60-89,0,0,0
2024-09-27,38,DPD90+,0,0,0
2024-09-27,40,Current,0,0,0
2024-09-27,40,DPD15-29,19,19,0
2024-09-27,40,DPD3-14,22,22,0
2024-09-27,40,DPD30-59,4,4,0
2024-09-27,40,DPD60-89,0,0,0
2024-09-27,40,DPD90+,0,0,0
2024-09-27,42,Current,0,0,0
2024-09-27,42,DPD15-29,11,11,0
2024-09-27,42,DPD3-14,18,18,0
2024-09-27,42,DPD30-59,7,7,0
2024-09-27,42,DPD60-89,0,0,0
2024-09-27,42,DPD90+,0,0,0
2024-09-27,44,Current,0,0,0
2024-09-27,44,DPD15-29,27,27,0
2024-09-27,44,DPD3-14,48,48,0
2024-09-27,44,DPD30-59,16,16,0
2024-09-27,44,DPD60-89,0,0,0
2024-09-27,44,DPD90+,0,0,0
2024-09-27,46,Current,0,0,0
2024-09-27,46,DPD15-29,1,1,0
2024-09-27,48,Current,42,42,0
2024-09-27,48,DPD15-29,21,21,0
2024-09-27,48,DPD3-14,55,55,0
2024-09-27,48,DPD30-59,8,8,0
2024-09-27,48,DPD60-89,0,0,0
2024-09-27,48,DPD90+,0,0,0
2024-09-27,6,Current,0,0,0
2024-09-26,100,Current,0,0,0
2024-09-26,100,DPD3-14,0,0,0
2024-09-26,102,Current,0,0,0
2024-09-26,102,DPD3-14,0,0,0
2024-09-26,104,Current,0,0,0
2024-09-26,104,DPD30-59,0,0,0
2024-09-26,20,Current,8,8,0
2024-09-26,20,DPD15-29,164,164,0
2024-09-26,20,DPD3-14,354,354,0
2024-09-26,20,DPD30-59,100,100,0
2024-09-26,20,DPD60-89,0,0,0
2024-09-26,20,DPD90+,0,0,0
2024-09-26,22,Current,0,0,0
2024-09-26,22,DPD15-29,0,0,0
2024-09-26,22,DPD3-14,1,1,0
2024-09-26,22,DPD30-59,0,0,0
2024-09-26,22,DPD60-89,0,0,0
2024-09-26,24,Current,56,56,0
2024-09-26,24,DPD15-29,98,98,0
2024-09-26,24,DPD3-14,225,225,0
2024-09-26,24,DPD30-59,46,46,0
2024-09-26,24,DPD60-89,0,0,0
2024-09-26,24,DPD90+,0,0,0
2024-09-26,26,Current,0,0,0
2024-09-26,26,DPD15-29,14,14,0
2024-09-26,26,DPD3-14,27,27,0
2024-09-26,26,DPD30-59,3,3,0
2024-09-26,26,DPD60-89,0,0,0
2024-09-26,26,DPD90+,0,0,0
2024-09-26,32,Current,0,0,0
2024-09-26,32,DPD15-29,68,68,0
2024-09-26,32,DPD3-14,156,156,0
2024-09-26,32,DPD30-59,51,51,0
2024-09-26,32,DPD60-89,0,0,0
2024-09-26,32,DPD90+,0,0,0
2024-09-26,34,Current,0,0,0
2024-09-26,34,DPD15-29,22,22,0
2024-09-26,34,DPD3-14,53,53,0
2024-09-26,34,DPD30-59,22,22,0
2024-09-26,34,DPD60-89,0,0,0
2024-09-26,34,DPD90+,0,0,0
2024-09-26,36,Current,0,0,0
2024-09-26,36,DPD15-29,25,25,0
2024-09-26,36,DPD3-14,44,44,0
2024-09-26,36,DPD30-59,7,7,0
2024-09-26,36,DPD60-89,0,0,0
2024-09-26,36,DPD90+,0,0,0
2024-09-26,38,Current,22,22,0
2024-09-26,38,DPD15-29,18,18,0
2024-09-26,38,DPD3-14,59,59,0
2024-09-26,38,DPD30-59,10,10,0
2024-09-26,38,DPD60-89,0,0,0
2024-09-26,38,DPD90+,0,0,0
2024-09-26,40,Current,0,0,0
2024-09-26,40,DPD15-29,16,16,0
2024-09-26,40,DPD3-14,45,45,0
2024-09-26,40,DPD30-59,2,2,0
2024-09-26,40,DPD60-89,0,0,0
2024-09-26,40,DPD90+,0,0,0
2024-09-26,42,Current,0,0,0
2024-09-26,42,DPD15-29,9,9,0
2024-09-26,42,DPD3-14,22,22,0
2024-09-26,42,DPD30-59,6,6,0
2024-09-26,42,DPD60-89,0,0,0
2024-09-26,42,DPD90+,0,0,0
2024-09-26,44,Current,0,0,0
2024-09-26,44,DPD15-29,28,28,0
2024-09-26,44,DPD3-14,49,49,0
2024-09-26,44,DPD30-59,12,12,0
2024-09-26,44,DPD60-89,0,0,0
2024-09-26,44,DPD90+,0,0,0
2024-09-26,46,Current,0,0,0
2024-09-26,46,DPD15-29,0,0,0
2024-09-26,48,Current,42,42,0
2024-09-26,48,DPD15-29,13,13,0
2024-09-26,48,DPD3-14,54,54,0
2024-09-26,48,DPD30-59,10,10,0
2024-09-26,48,DPD60-89,0,0,0
2024-09-26,48,DPD90+,0,0,0
2024-09-26,6,Current,0,0,0
2024-09-25,100,Current,0,0,0
2024-09-25,100,DPD3-14,1,1,0
2024-09-25,102,Current,0,0,0
2024-09-25,102,DPD3-14,0,0,0
2024-09-25,104,Current,0,0,0
2024-09-25,104,DPD30-59,0,0,0
2024-09-25,20,Current,0,0,0
2024-09-25,20,DPD15-29,188,188,0
2024-09-25,20,DPD3-14,370,370,0
2024-09-25,20,DPD30-59,106,106,0
2024-09-25,20,DPD60-89,0,0,0
2024-09-25,20,DPD90+,0,0,0
2024-09-25,22,Current,0,0,0
2024-09-25,22,DPD15-29,2,2,0
2024-09-25,22,DPD3-14,2,2,0
2024-09-25,22,DPD30-59,1,1,0
2024-09-25,22,DPD60-89,0,0,0
2024-09-25,24,Current,49,49,0
2024-09-25,24,DPD15-29,102,102,0
2024-09-25,24,DPD3-14,230,230,0
2024-09-25,24,DPD30-59,86,86,0
2024-09-25,24,DPD60-89,0,0,0
2024-09-25,24,DPD90+,0,0,0
2024-09-25,26,Current,0,0,0
2024-09-25,26,DPD15-29,15,15,0
2024-09-25,26,DPD3-14,33,33,0
2024-09-25,26,DPD30-59,8,8,0
2024-09-25,26,DPD60-89,0,0,0
2024-09-25,26,DPD90+,0,0,0
2024-09-25,32,Current,0,0,0
2024-09-25,32,DPD15-29,102,102,0
2024-09-25,32,DPD3-14,186,186,0
2024-09-25,32,DPD30-59,68,68,0
2024-09-25,32,DPD60-89,0,0,0
2024-09-25,32,DPD90+,0,0,0
2024-09-25,34,Current,0,0,0
2024-09-25,34,DPD15-29,35,35,0
2024-09-25,34,DPD3-14,89,89,0
2024-09-25,34,DPD30-59,30,30,0
2024-09-25,34,DPD60-89,0,0,0
2024-09-25,34,DPD90+,0,0,0
2024-09-25,36,Current,0,0,0
2024-09-25,36,DPD15-29,31,31,0
2024-09-25,36,DPD3-14,47,47,0
2024-09-25,36,DPD30-59,17,17,0
2024-09-25,36,DPD60-89,0,0,0
2024-09-25,36,DPD90+,0,0,0
2024-09-25,38,Current,11,11,0
2024-09-25,38,DPD15-29,25,25,0
2024-09-25,38,DPD3-14,62,62,0
2024-09-25,38,DPD30-59,16,16,0
2024-09-25,38,DPD60-89,0,0,0
2024-09-25,38,DPD90+,0,0,0
2024-09-25,40,Current,0,0,0
2024-09-25,40,DPD15-29,19,19,0
2024-09-25,40,DPD3-14,31,31,0
2024-09-25,40,DPD30-59,9,9,0
2024-09-25,40,DPD60-89,0,0,0
2024-09-25,40,DPD90+,0,0,0
2024-09-25,42,Current,0,0,0
2024-09-25,42,DPD15-29,12,12,0
2024-09-25,42,DPD3-14,17,17,0
2024-09-25,42,DPD30-59,4,4,0
2024-09-25,42,DPD60-89,0,0,0
2024-09-25,42,DPD90+,1,1,0
2024-09-25,44,Current,0,0,0
2024-09-25,44,DPD15-29,32,32,0
2024-09-25,44,DPD3-14,55,55,0
2024-09-25,44,DPD30-59,15,15,0
2024-09-25,44,DPD60-89,0,0,0
2024-09-25,44,DPD90+,0,0,0
2024-09-25,46,Current,0,0,0
2024-09-25,46,DPD15-29,1,1,0
2024-09-25,48,Current,32,32,0
2024-09-25,48,DPD15-29,18,18,0
2024-09-25,48,DPD3-14,60,60,0
2024-09-25,48,DPD30-59,11,11,0
2024-09-25,48,DPD60-89,0,0,0
2024-09-25,48,DPD90+,0,0,0
2024-09-25,6,Current,0,0,0
2024-09-24,100,Current,0,0,0
2024-09-24,100,DPD3-14,0,0,0
2024-09-24,102,Current,0,0,0
2024-09-24,102,DPD3-14,0,0,0
2024-09-24,104,Current,0,0,0
2024-09-24,104,DPD30-59,0,0,0
2024-09-24,20,Current,0,0,0
2024-09-24,20,DPD15-29,169,169,0
2024-09-24,20,DPD3-14,365,365,0
2024-09-24,20,DPD30-59,88,88,0
2024-09-24,20,DPD60-89,0,0,0
2024-09-24,20,DPD90+,0,0,0
2024-09-24,22,Current,0,0,0
2024-09-24,22,DPD15-29,0,0,0
2024-09-24,22,DPD3-14,0,0,0
2024-09-24,22,DPD30-59,0,0,0
2024-09-24,22,DPD60-89,0,0,0
2024-09-24,24,Current,44,44,0
2024-09-24,24,DPD15-29,97,97,0
2024-09-24,24,DPD3-14,227,227,0
2024-09-24,24,DPD30-59,48,48,0
2024-09-24,24,DPD60-89,0,0,0
2024-09-24,24,DPD90+,0,0,0
2024-09-24,26,Current,0,0,0
2024-09-24,26,DPD15-29,11,11,0
2024-09-24,26,DPD3-14,34,34,0
2024-09-24,26,DPD30-59,4,4,0
2024-09-24,26,DPD60-89,0,0,0
2024-09-24,26,DPD90+,0,0,0
2024-09-24,32,Current,0,0,0
2024-09-24,32,DPD15-29,65,65,0
2024-09-24,32,DPD3-14,160,160,0
2024-09-24,32,DPD30-59,61,61,0
2024-09-24,32,DPD60-89,0,0,0
2024-09-24,32,DPD90+,0,0,0
2024-09-24,34,Current,0,0,0
2024-09-24,34,DPD15-29,27,27,0
2024-09-24,34,DPD3-14,51,51,0
2024-09-24,34,DPD30-59,18,18,0
2024-09-24,34,DPD60-89,0,0,0
2024-09-24,34,DPD90+,0,0,0
2024-09-24,36,Current,0,0,0
2024-09-24,36,DPD15-29,24,24,0
2024-09-24,36,DPD3-14,52,52,0
2024-09-24,36,DPD30-59,8,8,0
2024-09-24,36,DPD60-89,0,0,0
2024-09-24,36,DPD90+,0,0,0
2024-09-24,38,Current,12,12,0
2024-09-24,38,DPD15-29,17,17,0
2024-09-24,38,DPD3-14,50,50,0
2024-09-24,38,DPD30-59,7,7,0
2024-09-24,38,DPD60-89,0,0,0
2024-09-24,38,DPD90+,0,0,0
2024-09-24,40,Current,0,0,0
2024-09-24,40,DPD15-29,13,13,0
2024-09-24,40,DPD3-14,50,50,0
2024-09-24,40,DPD30-59,5,5,0
2024-09-24,40,DPD60-89,0,0,0
2024-09-24,40,DPD90+,0,0,0
2024-09-24,42,Current,0,0,0
2024-09-24,42,DPD15-29,10,10,0
2024-09-24,42,DPD3-14,19,19,0
2024-09-24,42,DPD30-59,6,6,0
2024-09-24,42,DPD60-89,0,0,0
2024-09-24,42,DPD90+,0,0,0
2024-09-24,44,Current,0,0,0
2024-09-24,44,DPD15-29,26,26,0
2024-09-24,44,DPD3-14,55,55,0
2024-09-24,44,DPD30-59,6,6,0
2024-09-24,44,DPD60-89,0,0,0
2024-09-24,44,DPD90+,0,0,0
2024-09-24,46,Current,0,0,0
2024-09-24,46,DPD15-29,0,0,0
2024-09-24,48,Current,47,47,0
2024-09-24,48,DPD15-29,9,9,0
2024-09-24,48,DPD3-14,63,63,0
2024-09-24,48,DPD30-59,8,8,0
2024-09-24,48,DPD60-89,0,0,0
2024-09-24,48,DPD90+,0,0,0
2024-09-24,6,Current,0,0,0
2024-09-23,100,Current,0,0,0
2024-09-23,100,DPD3-14,1,1,0
2024-09-23,102,Current,0,0,0
2024-09-23,102,DPD3-14,0,0,0
2024-09-23,104,Current,0,0,0
2024-09-23,104,DPD30-59,0,0,0
2024-09-23,20,Current,1,1,0
2024-09-23,20,DPD15-29,218,218,0
2024-09-23,20,DPD3-14,412,412,0
2024-09-23,20,DPD30-59,105,105,0
2024-09-23,20,DPD60-89,0,0,0
2024-09-23,20,DPD90+,0,0,0
2024-09-23,22,Current,0,0,0
2024-09-23,22,DPD15-29,2,2,0
2024-09-23,22,DPD3-14,2,2,0
2024-09-23,22,DPD30-59,1,1,0
2024-09-23,22,DPD60-89,0,0,0
2024-09-23,24,Current,88,88,0
2024-09-23,24,DPD15-29,103,103,0
2024-09-23,24,DPD3-14,254,254,0
2024-09-23,24,DPD30-59,54,54,0
2024-09-23,24,DPD60-89,0,0,0
2024-09-23,24,DPD90+,0,0,0
2024-09-23,26,Current,0,0,0
2024-09-23,26,DPD15-29,20,20,0
2024-09-23,26,DPD3-14,33,33,0
2024-09-23,26,DPD30-59,9,9,0
2024-09-23,26,DPD60-89,0,0,0
2024-09-23,26,DPD90+,0,0,0
2024-09-23,32,Current,0,0,0
2024-09-23,32,DPD15-29,108,108,0
2024-09-23,32,DPD3-14,209,209,0
2024-09-23,32,DPD30-59,43,43,0
2024-09-23,32,DPD60-89,0,0,0
2024-09-23,32,DPD90+,0,0,0
2024-09-23,34,Current,0,0,0
2024-09-23,34,DPD15-29,38,38,0
2024-09-23,34,DPD3-14,94,94,0
2024-09-23,34,DPD30-59,20,20,0
2024-09-23,34,DPD60-89,0,0,0
2024-09-23,34,DPD90+,0,0,0
2024-09-23,36,Current,0,0,0
2024-09-23,36,DPD15-29,34,34,0
2024-09-23,36,DPD3-14,49,49,0
2024-09-23,36,DPD30-59,16,16,0
2024-09-23,36,DPD60-89,0,0,0
2024-09-23,36,DPD90+,0,0,0
2024-09-23,38,Current,18,18,0
2024-09-23,38,DPD15-29,34,34,0
2024-09-23,38,DPD3-14,68,68,0
2024-09-23,38,DPD30-59,14,14,0
2024-09-23,38,DPD60-89,0,0,0
2024-09-23,38,DPD90+,0,0,0
2024-09-23,40,Current,0,0,0
2024-09-23,40,DPD15-29,21,21,0
2024-09-23,40,DPD3-14,31,31,0
2024-09-23,40,DPD30-59,8,8,0
2024-09-23,40,DPD60-89,0,0,0
2024-09-23,40,DPD90+,0,0,0
2024-09-23,42,Current,0,0,0
2024-09-23,42,DPD15-29,14,14,0
2024-09-23,42,DPD3-14,23,23,0
2024-09-23,42,DPD30-59,7,7,0
2024-09-23,42,DPD60-89,0,0,0
2024-09-23,42,DPD90+,0,0,0
2024-09-23,44,Current,0,0,0
2024-09-23,44,DPD15-29,33,33,0
2024-09-23,44,DPD3-14,56,56,0
2024-09-23,44,DPD30-59,15,15,0
2024-09-23,44,DPD60-89,0,0,0
2024-09-23,44,DPD90+,0,0,0
2024-09-23,46,Current,0,0,0
2024-09-23,46,DPD15-29,1,1,0
2024-09-23,48,Current,55,55,0
2024-09-23,48,DPD15-29,18,18,0
2024-09-23,48,DPD3-14,72,72,0
2024-09-23,48,DPD30-59,8,8,0
2024-09-23,48,DPD60-89,0,0,0
2024-09-23,48,DPD90+,0,0,0
2024-09-23,6,Current,0,0,0
2024-09-22,100,Current,0,0,0
2024-09-22,100,DPD15-29,0,0,0
2024-09-22,100,DPD3-14,0,0,0
2024-09-22,102,Current,0,0,0
2024-09-22,104,Current,0,0,0
2024-09-22,104,DPD30-59,0,0,0
2024-09-22,20,Current,0,0,0
2024-09-22,20,DPD15-29,162,162,0
2024-09-22,20,DPD3-14,312,312,0
2024-09-22,20,DPD30-59,98,98,0
2024-09-22,20,DPD60-89,0,0,0
2024-09-22,20,DPD90+,0,0,0
2024-09-22,22,Current,0,0,0
2024-09-22,22,DPD15-29,0,0,0
2024-09-22,22,DPD3-14,0,0,0
2024-09-22,22,DPD30-59,0,0,0
2024-09-22,22,DPD60-89,0,0,0
2024-09-22,24,Current,74,74,0
2024-09-22,24,DPD15-29,89,89,0
2024-09-22,24,DPD3-14,203,203,0
2024-09-22,24,DPD30-59,50,50,0
2024-09-22,24,DPD60-89,0,0,0
2024-09-22,24,DPD90+,0,0,0
2024-09-22,26,Current,0,0,0
2024-09-22,26,DPD15-29,9,9,0
2024-09-22,26,DPD3-14,16,16,0
2024-09-22,26,DPD30-59,5,5,0
2024-09-22,26,DPD60-89,0,0,0
2024-09-22,26,DPD90+,0,0,0
2024-09-22,32,Current,0,0,0
2024-09-22,32,DPD15-29,72,72,0
2024-09-22,32,DPD3-14,130,130,0
2024-09-22,32,DPD30-59,47,47,0
2024-09-22,32,DPD60-89,0,0,0
2024-09-22,32,DPD90+,0,0,0
2024-09-22,34,Current,0,0,0
2024-09-22,34,DPD15-29,29,29,0
2024-09-22,34,DPD3-14,48,48,0
2024-09-22,34,DPD30-59,21,21,0
2024-09-22,34,DPD60-89,0,0,0
2024-09-22,34,DPD90+,0,0,0
2024-09-22,36,Current,0,0,0
2024-09-22,36,DPD15-29,24,24,0
2024-09-22,36,DPD3-14,36,36,0
2024-09-22,36,DPD30-59,8,8,0
2024-09-22,36,DPD60-89,0,0,0
2024-09-22,36,DPD90+,0,0,0
2024-09-22,38,Current,17,17,0
2024-09-22,38,DPD15-29,14,14,0
2024-09-22,38,DPD3-14,39,39,0
2024-09-22,38,DPD30-59,11,11,0
2024-09-22,38,DPD60-89,0,0,0
2024-09-22,38,DPD90+,0,0,0
2024-09-22,40,Current,0,0,0
2024-09-22,40,DPD15-29,11,11,0
2024-09-22,40,DPD3-14,41,41,0
2024-09-22,40,DPD30-59,3,3,0
2024-09-22,40,DPD60-89,0,0,0
2024-09-22,40,DPD90+,0,0,0
2024-09-22,42,Current,0,0,0
2024-09-22,42,DPD15-29,13,13,0
2024-09-22,42,DPD3-14,15,15,0
2024-09-22,42,DPD30-59,7,7,0
2024-09-22,42,DPD60-89,0,0,0
2024-09-22,42,DPD90+,0,0,0
2024-09-22,44,Current,0,0,0
2024-09-22,44,DPD15-29,29,29,0
2024-09-22,44,DPD3-14,53,53,0
2024-09-22,44,DPD30-59,14,14,0
2024-09-22,44,DPD60-89,0,0,0
2024-09-22,44,DPD90+,0,0,0
2024-09-22,46,Current,0,0,0
2024-09-22,46,DPD15-29,0,0,0
2024-09-22,48,Current,68,68,0
2024-09-22,48,DPD15-29,7,7,0
2024-09-22,48,DPD3-14,50,50,0
2024-09-22,48,DPD30-59,10,10,0
2024-09-22,48,DPD60-89,0,0,0
2024-09-22,48,DPD90+,0,0,0
2024-09-22,6,Current,0,0,0
2024-09-21,100,Current,0,0,0
2024-09-21,100,DPD15-29,0,0,0
2024-09-21,100,DPD3-14,1,1,0
2024-09-21,102,Current,0,0,0
2024-09-21,104,Current,0,0,0
2024-09-21,104,DPD30-59,0,0,0
2024-09-21,20,Current,0,0,0
2024-09-21,20,DPD15-29,210,210,0
2024-09-21,20,DPD3-14,367,367,0
2024-09-21,20,DPD30-59,107,107,0
2024-09-21,20,DPD60-89,0,0,0
2024-09-21,20,DPD90+,0,0,0
2024-09-21,22,Current,0,0,0
2024-09-21,22,DPD15-29,3,3,0
2024-09-21,22,DPD3-14,1,1,0
2024-09-21,22,DPD30-59,1,1,0
2024-09-21,22,DPD60-89,0,0,0
2024-09-21,24,Current,88,88,0
2024-09-21,24,DPD15-29,109,109,0
2024-09-21,24,DPD3-14,222,222,0
2024-09-21,24,DPD30-59,93,93,0
2024-09-21,24,DPD60-89,0,0,0
2024-09-21,24,DPD90+,0,0,0
2024-09-21,26,Current,0,0,0
2024-09-21,26,DPD15-29,23,23,0
2024-09-21,26,DPD3-14,32,32,0
2024-09-21,26,DPD30-59,8,8,0
2024-09-21,26,DPD60-89,0,0,0
2024-09-21,26,DPD90+,0,0,0
2024-09-21,32,Current,0,0,0
2024-09-21,32,DPD15-29,102,102,0
2024-09-21,32,DPD3-14,187,187,0
2024-09-21,32,DPD30-59,72,72,0
2024-09-21,32,DPD60-89,0,0,0
2024-09-21,32,DPD90+,0,0,0
2024-09-21,34,Current,0,0,0
2024-09-21,34,DPD15-29,38,38,0
2024-09-21,34,DPD3-14,85,85,0
2024-09-21,34,DPD30-59,34,34,0
2024-09-21,34,DPD60-89,0,0,0
2024-09-21,34,DPD90+,0,0,0
2024-09-21,36,Current,0,0,0
2024-09-21,36,DPD15-29,37,37,0
2024-09-21,36,DPD3-14,43,43,0
2024-09-21,36,DPD30-59,23,23,0
2024-09-21,36,DPD60-89,0,0,0
2024-09-21,36,DPD90+,0,0,0
2024-09-21,38,Current,21,21,0
2024-09-21,38,DPD15-29,31,31,0
2024-09-21,38,DPD3-14,59,59,0
2024-09-21,38,DPD30-59,19,19,0
2024-09-21,38,DPD60-89,0,0,0
2024-09-21,38,DPD90+,0,0,0
2024-09-21,40,Current,0,0,0
2024-09-21,40,DPD15-29,19,19,0
2024-09-21,40,DPD3-14,25,25,0
2024-09-21,40,DPD30-59,5,5,0
2024-09-21,40,DPD60-89,0,0,0
2024-09-21,40,DPD90+,0,0,0
2024-09-21,42,Current,0,0,0
2024-09-21,42,DPD15-29,13,13,0
2024-09-21,42,DPD3-14,23,23,0
2024-09-21,42,DPD30-59,5,5,0
2024-09-21,42,DPD60-89,0,0,0
2024-09-21,42,DPD90+,0,0,0
2024-09-21,44,Current,0,0,0
2024-09-21,44,DPD15-29,29,29,0
2024-09-21,44,DPD3-14,46,46,0
2024-09-21,44,DPD30-59,14,14,0
2024-09-21,44,DPD60-89,0,0,0
2024-09-21,44,DPD90+,0,0,0
2024-09-21,46,Current,0,0,0
2024-09-21,46,DPD3-14,1,1,0
2024-09-21,48,Current,59,59,0
2024-09-21,48,DPD15-29,17,17,0
2024-09-21,48,DPD3-14,59,59,0
2024-09-21,48,DPD30-59,15,15,0
2024-09-21,48,DPD60-89,0,0,0
2024-09-21,48,DPD90+,0,0,0
2024-09-21,6,Current,0,0,0
2024-09-20,100,Current,0,0,0
2024-09-20,100,DPD15-29,0,0,0
2024-09-20,100,DPD3-14,0,0,0
2024-09-20,102,Current,0,0,0
2024-09-20,104,Current,0,0,0
2024-09-20,104,DPD15-29,0,0,0
2024-09-20,20,Current,15,15,0
2024-09-20,20,DPD15-29,167,167,0
2024-09-20,20,DPD3-14,306,306,0
2024-09-20,20,DPD30-59,72,72,0
2024-09-20,20,DPD60-89,0,0,0
2024-09-20,20,DPD90+,0,0,0
2024-09-20,22,Current,0,0,0
2024-09-20,22,DPD15-29,0,0,0
2024-09-20,22,DPD3-14,0,0,0
2024-09-20,22,DPD30-59,0,0,0
2024-09-20,22,DPD60-89,0,0,0
2024-09-20,24,Current,89,89,0
2024-09-20,24,DPD15-29,84,84,0
2024-09-20,24,DPD3-14,186,186,0
2024-09-20,24,DPD30-59,39,39,0
2024-09-20,24,DPD60-89,0,0,0
2024-09-20,24,DPD90+,0,0,0
2024-09-20,26,Current,0,0,0
2024-09-20,26,DPD15-29,9,9,0
2024-09-20,26,DPD3-14,15,15,0
2024-09-20,26,DPD30-59,3,3,0
2024-09-20,26,DPD60-89,0,0,0
2024-09-20,26,DPD90+,0,0,0
2024-09-20,32,Current,0,0,0
2024-09-20,32,DPD15-29,76,76,0
2024-09-20,32,DPD3-14,118,118,0
2024-09-20,32,DPD30-59,49,49,0
2024-09-20,32,DPD60-89,0,0,0
2024-09-20,32,DPD90+,0,0,0
2024-09-20,34,Current,0,0,0
2024-09-20,34,DPD15-29,34,34,0
2024-09-20,34,DPD3-14,33,33,0
2024-09-20,34,DPD30-59,14,14,0
2024-09-20,34,DPD60-89,0,0,0
2024-09-20,34,DPD90+,0,0,0
2024-09-20,36,Current,0,0,0
2024-09-20,36,DPD15-29,23,23,0
2024-09-20,36,DPD3-14,33,33,0
2024-09-20,36,DPD30-59,6,6,0
2024-09-20,36,DPD60-89,0,0,0
2024-09-20,36,DPD90+,0,0,0
2024-09-20,38,Current,19,19,0
2024-09-20,38,DPD15-29,15,15,0
2024-09-20,38,DPD3-14,41,41,0
2024-09-20,38,DPD30-59,6,6,0
2024-09-20,38,DPD60-89,0,0,0
2024-09-20,38,DPD90+,0,0,0
2024-09-20,40,Current,0,0,0
2024-09-20,40,DPD15-29,11,11,0
2024-09-20,40,DPD3-14,36,36,0
2024-09-20,40,DPD30-59,5,5,0
2024-09-20,40,DPD60-89,0,0,0
2024-09-20,40,DPD90+,0,0,0
2024-09-20,42,Current,0,0,0
2024-09-20,42,DPD15-29,13,13,0
2024-09-20,42,DPD3-14,16,16,0
2024-09-20,42,DPD30-59,4,4,0
2024-09-20,42,DPD60-89,0,0,0
2024-09-20,42,DPD90+,0,0,0
2024-09-20,44,Current,0,0,0
2024-09-20,44,DPD15-29,32,32,0
2024-09-20,44,DPD3-14,49,49,0
2024-09-20,44,DPD30-59,5,5,0
2024-09-20,44,DPD60-89,0,0,0
2024-09-20,44,DPD90+,0,0,0
2024-09-20,46,Current,0,0,0
2024-09-20,46,DPD3-14,0,0,0
2024-09-20,48,Current,48,48,0
2024-09-20,48,DPD15-29,10,10,0
2024-09-20,48,DPD3-14,44,44,0
2024-09-20,48,DPD30-59,8,8,0
2024-09-20,48,DPD60-89,0,0,0
2024-09-20,48,DPD90+,0,0,0
2024-09-20,6,Current,0,0,0
2024-09-19,100,Current,0,0,0
2024-09-19,100,DPD15-29,0,0,0
2024-09-19,100,DPD3-14,2,2,0
2024-09-19,102,Current,0,0,0
2024-09-19,104,Current,0,0,0
2024-09-19,104,DPD15-29,0,0,0
2024-09-19,20,Current,2,2,0
2024-09-19,20,DPD15-29,194,194,0
2024-09-19,20,DPD3-14,335,335,0
2024-09-19,20,DPD30-59,130,130,0
2024-09-19,20,DPD60-89,0,0,0
2024-09-19,20,DPD90+,0,0,0
2024-09-19,22,Current,0,0,0
2024-09-19,22,DPD15-29,2,2,0
2024-09-19,22,DPD3-14,1,1,0
2024-09-19,22,DPD30-59,1,1,0
2024-09-19,22,DPD60-89,0,0,0
2024-09-19,24,Current,54,54,0
2024-09-19,24,DPD15-29,109,109,0
2024-09-19,24,DPD3-14,177,177,0
2024-09-19,24,DPD30-59,48,48,0
2024-09-19,24,DPD60-89,0,0,0
2024-09-19,24,DPD90+,0,0,0
2024-09-19,26,Current,0,0,0
2024-09-19,26,DPD15-29,20,20,0
2024-09-19,26,DPD3-14,26,26,0
2024-09-19,26,DPD30-59,8,8,0
2024-09-19,26,DPD60-89,0,0,0
2024-09-19,26,DPD90+,0,0,0
2024-09-19,32,Current,2,2,0
2024-09-19,32,DPD15-29,116,116,0
2024-09-19,32,DPD3-14,150,150,0
2024-09-19,32,DPD30-59,42,42,0
2024-09-19,32,DPD60-89,0,0,0
2024-09-19,32,DPD90+,0,0,0
2024-09-19,34,Current,0,0,0
2024-09-19,34,DPD15-29,43,43,0
2024-09-19,34,DPD3-14,66,66,0
2024-09-19,34,DPD30-59,22,22,0
2024-09-19,34,DPD60-89,0,0,0
2024-09-19,34,DPD90+,0,0,0
2024-09-19,36,Current,0,0,0
2024-09-19,36,DPD15-29,35,35,0
2024-09-19,36,DPD3-14,37,37,0
2024-09-19,36,DPD30-59,13,13,0
2024-09-19,36,DPD60-89,0,0,0
2024-09-19,36,DPD90+,0,0,0
2024-09-19,38,Current,13,13,0
2024-09-19,38,DPD15-29,32,32,0
2024-09-19,38,DPD3-14,55,55,0
2024-09-19,38,DPD30-59,11,11,0
2024-09-19,38,DPD60-89,0,0,0
2024-09-19,38,DPD90+,0,0,0
2024-09-19,40,Current,0,0,0
2024-09-19,40,DPD15-29,20,20,0
2024-09-19,40,DPD3-14,25,25,0
2024-09-19,40,DPD30-59,2,2,0
2024-09-19,40,DPD60-89,0,0,0
2024-09-19,40,DPD90+,0,0,0
2024-09-19,42,Current,0,0,0
2024-09-19,42,DPD15-29,14,14,0
2024-09-19,42,DPD3-14,18,18,0
2024-09-19,42,DPD30-59,8,8,0
2024-09-19,42,DPD60-89,0,0,0
2024-09-19,42,DPD90+,0,0,0
2024-09-19,44,Current,0,0,0
2024-09-19,44,DPD15-29,21,21,0
2024-09-19,44,DPD3-14,46,46,0
2024-09-19,44,DPD30-59,16,16,0
2024-09-19,44,DPD60-89,0,0,0
2024-09-19,44,DPD90+,0,0,0
2024-09-19,46,Current,0,0,0
2024-09-19,46,DPD3-14,1,1,0
2024-09-19,48,Current,40,40,0
2024-09-19,48,DPD15-29,18,18,0
2024-09-19,48,DPD3-14,49,49,0
2024-09-19,48,DPD30-59,9,9,0
2024-09-19,48,DPD60-89,0,0,0
2024-09-19,48,DPD90+,0,0,0
2024-09-19,6,Current,0,0,0
2024-09-18,100,Current,0,0,0
2024-09-18,100,DPD15-29,0,0,0
2024-09-18,100,DPD3-14,0,0,0
2024-09-18,102,Current,0,0,0
2024-09-18,104,Current,0,0,0
2024-09-18,104,DPD15-29,0,0,0
2024-09-18,20,Current,0,0,0
2024-09-18,20,DPD15-29,172,172,0
2024-09-18,20,DPD3-14,224,224,0
2024-09-18,20,DPD30-59,106,106,0
2024-09-18,20,DPD60-89,0,0,0
2024-09-18,20,DPD90+,0,0,0
2024-09-18,22,Current,0,0,0
2024-09-18,22,DPD15-29,0,0,0
2024-09-18,22,DPD3-14,0,0,0
2024-09-18,22,DPD30-59,0,0,0
2024-09-18,24,Current,39,39,0
2024-09-18,24,DPD15-29,86,86,0
2024-09-18,24,DPD3-14,143,143,0
2024-09-18,24,DPD30-59,57,57,0
2024-09-18,24,DPD60-89,0,0,0
2024-09-18,24,DPD90+,0,0,0
2024-09-18,26,Current,0,0,0
2024-09-18,26,DPD15-29,9,9,0
2024-09-18,26,DPD3-14,12,12,0
2024-09-18,26,DPD30-59,6,6,0
2024-09-18,26,DPD60-89,0,0,0
2024-09-18,26,DPD90+,0,0,0
2024-09-18,32,Current,0,0,0
2024-09-18,32,DPD15-29,91,91,0
2024-09-18,32,DPD3-14,84,84,0
2024-09-18,32,DPD30-59,52,52,0
2024-09-18,32,DPD60-89,0,0,0
2024-09-18,32,DPD90+,0,0,0
2024-09-18,34,Current,0,0,0
2024-09-18,34,DPD15-29,32,32,0
2024-09-18,34,DPD3-14,31,31,0
2024-09-18,34,DPD30-59,23,23,0
2024-09-18,34,DPD60-89,0,0,0
2024-09-18,34,DPD90+,0,0,0
2024-09-18,36,Current,0,0,0
2024-09-18,36,DPD15-29,27,27,0
2024-09-18,36,DPD3-14,21,21,0
2024-09-18,36,DPD30-59,7,7,0
2024-09-18,36,DPD60-89,0,0,0
2024-09-18,36,DPD90+,0,0,0
2024-09-18,38,Current,8,8,0
2024-09-18,38,DPD15-29,16,16,0
2024-09-18,38,DPD3-14,29,29,0
2024-09-18,38,DPD30-59,12,12,0
2024-09-18,38,DPD60-89,0,0,0
2024-09-18,38,DPD90+,0,0,0
2024-09-18,40,Current,0,0,0
2024-09-18,40,DPD15-29,12,12,0
2024-09-18,40,DPD3-14,30,30,0
2024-09-18,40,DPD30-59,3,3,0
2024-09-18,40,DPD60-89,0,0,0
2024-09-18,40,DPD90+,1,1,0
2024-09-18,42,Current,0,0,0
2024-09-18,42,DPD15-29,14,14,0
2024-09-18,42,DPD3-14,12,12,0
2024-09-18,42,DPD30-59,8,8,0
2024-09-18,42,DPD60-89,0,0,0
2024-09-18,42,DPD90+,0,0,0
2024-09-18,44,Current,0,0,0
2024-09-18,44,DPD15-29,31,31,0
2024-09-18,44,DPD3-14,36,36,0
2024-09-18,44,DPD30-59,13,13,0
2024-09-18,44,DPD60-89,0,0,0
2024-09-18,44,DPD90+,0,0,0
2024-09-18,46,Current,0,0,0
2024-09-18,46,DPD3-14,0,0,0
2024-09-18,46,DPD30-59,0,0,0
2024-09-18,48,Current,29,29,0
2024-09-18,48,DPD15-29,12,12,0
2024-09-18,48,DPD3-14,28,28,0
2024-09-18,48,DPD30-59,10,10,0
2024-09-18,48,DPD60-89,0,0,0
2024-09-18,48,DPD90+,0,0,0
2024-09-18,6,Current,0,0,0
2024-09-17,100,Current,0,0,0
2024-09-17,100,DPD3-14,1,1,0
2024-09-17,102,Current,0,0,0
2024-09-17,104,Current,0,0,0
2024-09-17,104,DPD15-29,0,0,0
2024-09-17,20,Current,0,0,0
2024-09-17,20,DPD15-29,223,223,0
2024-09-17,20,DPD3-14,208,208,0
2024-09-17,20,DPD30-59,97,97,0
2024-09-17,20,DPD60-89,0,0,0
2024-09-17,20,DPD90+,0,0,0
2024-09-17,22,Current,0,0,0
2024-09-17,22,DPD15-29,2,2,0
2024-09-17,22,DPD3-14,1,1,0
2024-09-17,22,DPD30-59,0,0,0
2024-09-17,22,DPD90+,0,0,0
2024-09-17,24,Current,59,59,0
2024-09-17,24,DPD15-29,120,120,0
2024-09-17,24,DPD3-14,124,124,0
2024-09-17,24,DPD30-59,65,65,0
2024-09-17,24,DPD60-89,0,0,0
2024-09-17,24,DPD90+,0,0,0
2024-09-17,26,Current,0,0,0
2024-09-17,26,DPD15-29,24,24,0
2024-09-17,26,DPD3-14,15,15,0
2024-09-17,26,DPD30-59,5,5,0
2024-09-17,26,DPD60-89,0,0,0
2024-09-17,26,DPD90+,0,0,0
2024-09-17,32,Current,0,0,0
2024-09-17,32,DPD15-29,132,132,0
2024-09-17,32,DPD3-14,104,104,0
2024-09-17,32,DPD30-59,56,56,0
2024-09-17,32,DPD60-89,0,0,0
2024-09-17,32,DPD90+,0,0,0
2024-09-17,34,Current,0,0,0
2024-09-17,34,DPD15-29,48,48,0
2024-09-17,34,DPD3-14,40,40,0
2024-09-17,34,DPD30-59,22,22,0
2024-09-17,34,DPD60-89,0,0,0
2024-09-17,34,DPD90+,0,0,0
2024-09-17,36,Current,0,0,0
2024-09-17,36,DPD15-29,35,35,0
2024-09-17,36,DPD3-14,27,27,0
2024-09-17,36,DPD30-59,13,13,0
2024-09-17,36,DPD60-89,0,0,0
2024-09-17,36,DPD90+,0,0,0
2024-09-17,38,Current,11,11,0
2024-09-17,38,DPD15-29,36,36,0
2024-09-17,38,DPD3-14,36,36,0
2024-09-17,38,DPD30-59,17,17,0
2024-09-17,38,DPD60-89,0,0,0
2024-09-17,38,DPD90+,0,0,0
2024-09-17,40,Current,0,0,0
2024-09-17,40,DPD15-29,21,21,0
2024-09-17,40,DPD3-14,14,14,0
2024-09-17,40,DPD30-59,4,4,0
2024-09-17,40,DPD60-89,0,0,0
2024-09-17,40,DPD90+,0,0,0
2024-09-17,42,Current,0,0,0
2024-09-17,42,DPD15-29,14,14,0
2024-09-17,42,DPD3-14,14,14,0
2024-09-17,42,DPD30-59,3,3,0
2024-09-17,42,DPD60-89,0,0,0
2024-09-17,42,DPD90+,0,0,0
2024-09-17,44,Current,0,0,0
2024-09-17,44,DPD15-29,28,28,0
2024-09-17,44,DPD3-14,29,29,0
2024-09-17,44,DPD30-59,13,13,0
2024-09-17,44,DPD60-89,0,0,0
2024-09-17,44,DPD90+,0,0,0
2024-09-17,46,Current,0,0,0
2024-09-17,46,DPD3-14,1,1,0
2024-09-17,46,DPD30-59,0,0,0
2024-09-17,48,Current,20,20,0
2024-09-17,48,DPD15-29,20,20,0
2024-09-17,48,DPD3-14,43,43,0
2024-09-17,48,DPD30-59,12,12,0
2024-09-17,48,DPD60-89,0,0,0
2024-09-17,48,DPD90+,0,0,0
2024-09-17,6,Current,0,0,0
2024-09-16,100,Current,0,0,0
2024-09-16,100,DPD3-14,0,0,0
2024-09-16,102,Current,0,0,0
2024-09-16,104,Current,0,0,0
2024-09-16,104,DPD15-29,0,0,0
2024-09-16,20,Current,0,0,0
2024-09-16,20,DPD15-29,165,165,0
2024-09-16,20,DPD3-14,289,289,0
2024-09-16,20,DPD30-59,90,90,0
2024-09-16,20,DPD60-89,0,0,0
2024-09-16,20,DPD90+,0,0,0
2024-09-16,22,Current,0,0,0
2024-09-16,22,DPD15-29,0,0,0
2024-09-16,22,DPD3-14,0,0,0
2024-09-16,22,DPD30-59,0,0,0
2024-09-16,22,DPD90+,0,0,0
2024-09-16,24,Current,51,51,0
2024-09-16,24,DPD15-29,96,96,0
2024-09-16,24,DPD3-14,192,192,0
2024-09-16,24,DPD30-59,53,53,0
2024-09-16,24,DPD60-89,0,0,0
2024-09-16,24,DPD90+,0,0,0
2024-09-16,26,Current,0,0,0
2024-09-16,26,DPD15-29,9,9,0
2024-09-16,26,DPD3-14,23,23,0
2024-09-16,26,DPD30-59,6,6,0
2024-09-16,26,DPD60-89,0,0,0
2024-09-16,26,DPD90+,0,0,0
2024-09-16,32,Current,0,0,0
2024-09-16,32,DPD15-29,85,85,0
2024-09-16,32,DPD3-14,101,101,0
2024-09-16,32,DPD30-59,54,54,0
2024-09-16,32,DPD60-89,0,0,0
2024-09-16,32,DPD90+,0,0,0
2024-09-16,34,Current,0,0,0
2024-09-16,34,DPD15-29,36,36,0
2024-09-16,34,DPD3-14,38,38,0
2024-09-16,34,DPD30-59,22,22,0
2024-09-16,34,DPD60-89,0,0,0
2024-09-16,34,DPD90+,0,0,0
2024-09-16,36,Current,0,0,0
2024-09-16,36,DPD15-29,23,23,0
2024-09-16,36,DPD3-14,39,39,0
2024-09-16,36,DPD30-59,7,7,0
2024-09-16,36,DPD60-89,0,0,0
2024-09-16,36,DPD90+,0,0,0
2024-09-16,38,Current,12,12,0
2024-09-16,38,DPD15-29,21,21,0
2024-09-16,38,DPD3-14,45,45,0
2024-09-16,38,DPD30-59,13,13,0
2024-09-16,38,DPD60-89,0,0,0
2024-09-16,38,DPD90+,0,0,0
2024-09-16,40,Current,0,0,0
2024-09-16,40,DPD15-29,9,9,0
2024-09-16,40,DPD3-14,32,32,0
2024-09-16,40,DPD30-59,16,16,0
2024-09-16,40,DPD60-89,0,0,0
2024-09-16,40,DPD90+,0,0,0
2024-09-16,42,Current,0,0,0
2024-09-16,42,DPD15-29,17,17,0
2024-09-16,42,DPD3-14,14,14,0
2024-09-16,42,DPD30-59,6,6,0
2024-09-16,42,DPD60-89,0,0,0
2024-09-16,42,DPD90+,0,0,0
2024-09-16,44,Current,0,0,0
2024-09-16,44,DPD15-29,32,32,0
2024-09-16,44,DPD3-14,47,47,0
2024-09-16,44,DPD30-59,7,7,0
2024-09-16,44,DPD60-89,0,0,0
2024-09-16,44,DPD90+,0,0,0
2024-09-16,46,Current,0,0,0
2024-09-16,46,DPD3-14,0,0,0
2024-09-16,46,DPD30-59,0,0,0
2024-09-16,48,Current,41,41,0
2024-09-16,48,DPD15-29,14,14,0
2024-09-16,48,DPD3-14,35,35,0
2024-09-16,48,DPD30-59,8,8,0
2024-09-16,48,DPD60-89,0,0,0
2024-09-16,48,DPD90+,0,0,0
2024-09-16,6,Current,0,0,0
2024-09-15,100,Current,0,0,0
2024-09-15,100,DPD3-14,1,1,0
2024-09-15,102,Current,0,0,0
2024-09-15,102,DPD3-14,0,0,0
2024-09-15,104,Current,0,0,0
2024-09-15,104,DPD15-29,0,0,0
2024-09-15,20,Current,4175,4175,0
2024-09-15,20,DPD15-29,303,303,0
2024-09-15,20,DPD3-14,310,310,0
2024-09-15,20,DPD30-59,192,192,0
2024-09-15,20,DPD60-89,38,38,0
2024-09-15,20,DPD90+,33,33,0
2024-09-15,22,Current,0,0,0
2024-09-15,22,DPD15-29,3,3,0
2024-09-15,22,DPD30-59,1,1,0
2024-09-15,22,DPD90+,0,0,0
2024-09-15,24,Current,4338,4338,0
2024-09-15,24,DPD15-29,162,162,0
2024-09-15,24,DPD3-14,191,191,0
2024-09-15,24,DPD30-59,82,82,0
2024-09-15,24,DPD60-89,20,20,0
2024-09-15,24,DPD90+,14,14,0
2024-09-15,26,Current,0,0,0
2024-09-15,26,DPD15-29,22,22,0
2024-09-15,26,DPD3-14,15,15,0
2024-09-15,26,DPD30-59,9,9,0
2024-09-15,26,DPD60-89,0,0,0
2024-09-15,26,DPD90+,0,0,0
2024-09-15,32,Current,220,220,0
2024-09-15,32,DPD15-29,134,134,0
2024-09-15,32,DPD3-14,116,116,0
2024-09-15,32,DPD30-59,54,54,0
2024-09-15,32,DPD60-89,2,2,0
2024-09-15,32,DPD90+,3,3,0
2024-09-15,34,Current,0,0,0
2024-09-15,34,DPD15-29,54,54,0
2024-09-15,34,DPD3-14,35,35,0
2024-09-15,34,DPD30-59,27,27,0
2024-09-15,34,DPD60-89,0,0,0
2024-09-15,34,DPD90+,0,0,0
2024-09-15,36,Current,234,234,0
2024-09-15,36,DPD15-29,40,40,0
2024-09-15,36,DPD3-14,32,32,0
2024-09-15,36,DPD30-59,13,13,0
2024-09-15,36,DPD60-89,2,2,0
2024-09-15,36,DPD90+,0,0,0
2024-09-15,38,Current,96,96,0
2024-09-15,38,DPD15-29,35,35,0
2024-09-15,38,DPD3-14,39,39,0
2024-09-15,38,DPD30-59,14,14,0
2024-09-15,38,DPD60-89,0,0,0
2024-09-15,38,DPD90+,0,0,0
2024-09-15,40,Current,255,255,0
2024-09-15,40,DPD15-29,24,24,0
2024-09-15,40,DPD3-14,31,31,0
2024-09-15,40,DPD30-59,5,5,0
2024-09-15,40,DPD60-89,2,2,0
2024-09-15,40,DPD90+,1,1,0
2024-09-15,42,Current,0,0,0
2024-09-15,42,DPD15-29,13,13,0
2024-09-15,42,DPD3-14,10,10,0
2024-09-15,42,DPD30-59,10,10,0
2024-09-15,42,DPD60-89,0,0,0
2024-09-15,42,DPD90+,0,0,0
2024-09-15,44,Current,162,162,0
2024-09-15,44,DPD15-29,29,29,0
2024-09-15,44,DPD3-14,46,46,0
2024-09-15,44,DPD30-59,23,23,0
2024-09-15,44,DPD60-89,2,2,0
2024-09-15,44,DPD90+,1,1,0
2024-09-15,46,Current,4,4,0
2024-09-15,46,DPD3-14,1,1,0
2024-09-15,46,DPD30-59,0,0,0
2024-09-15,48,Current,4393,4393,0
2024-09-15,48,DPD15-29,43,43,0
2024-09-15,48,DPD3-14,93,93,0
2024-09-15,48,DPD30-59,36,36,0
2024-09-15,48,DPD60-89,11,11,0
2024-09-15,48,DPD90+,10,10,0
2024-09-15,6,Current,0,0,0
2024-09-14,100,Current,0,0,0
2024-09-14,100,DPD3-14,0,0,0
2024-09-14,102,Current,0,0,0
2024-09-14,102,DPD3-14,0,0,0
2024-09-14,104,Current,0,0,0
2024-09-14,104,DPD15-29,0,0,0
2024-09-14,20,Current,0,0,0
2024-09-14,20,DPD15-29,195,195,0
2024-09-14,20,DPD3-14,228,228,0
2024-09-14,20,DPD30-59,104,104,0
2024-09-14,20,DPD60-89,0,0,0
2024-09-14,20,DPD90+,0,0,0
2024-09-14,22,Current,0,0,0
2024-09-14,22,DPD15-29,0,0,0
2024-09-14,22,DPD30-59,0,0,0
2024-09-14,22,DPD90+,0,0,0
2024-09-14,24,Current,64,64,0
2024-09-14,24,DPD15-29,123,123,0
2024-09-14,24,DPD3-14,157,157,0
2024-09-14,24,DPD30-59,53,53,0
2024-09-14,24,DPD60-89,0,0,0
2024-09-14,24,DPD90+,0,0,0
2024-09-14,26,Current,0,0,0
2024-09-14,26,DPD15-29,11,11,0
2024-09-14,26,DPD3-14,17,17,0
2024-09-14,26,DPD30-59,7,7,0
2024-09-14,26,DPD60-89,0,0,0
2024-09-14,26,DPD90+,0,0,0
2024-09-14,32,Current,0,0,0
2024-09-14,32,DPD15-29,106,106,0
2024-09-14,32,DPD3-14,85,85,0
2024-09-14,32,DPD30-59,49,49,0
2024-09-14,32,DPD60-89,0,0,0
2024-09-14,32,DPD90+,0,0,0
2024-09-14,34,Current,0,0,0
2024-09-14,34,DPD15-29,42,42,0
2024-09-14,34,DPD3-14,31,31,0
2024-09-14,34,DPD30-59,22,22,0
2024-09-14,34,DPD60-89,0,0,0
2024-09-14,34,DPD90+,0,0,0
2024-09-14,36,Current,0,0,0
2024-09-14,36,DPD15-29,29,29,0
2024-09-14,36,DPD3-14,31,31,0
2024-09-14,36,DPD30-59,9,9,0
2024-09-14,36,DPD60-89,0,0,0
2024-09-14,36,DPD90+,0,0,0
2024-09-14,38,Current,9,9,0
2024-09-14,38,DPD15-29,28,28,0
2024-09-14,38,DPD3-14,31,31,0
2024-09-14,38,DPD30-59,11,11,0
2024-09-14,38,DPD60-89,0,0,0
2024-09-14,38,DPD90+,0,0,0
2024-09-14,40,Current,0,0,0
2024-09-14,40,DPD15-29,11,11,0
2024-09-14,40,DPD3-14,28,28,0
2024-09-14,40,DPD30-59,2,2,0
2024-09-14,40,DPD60-89,0,0,0
2024-09-14,40,DPD90+,0,0,0
2024-09-14,42,Current,0,0,0
2024-09-14,42,DPD15-29,19,19,0
2024-09-14,42,DPD3-14,10,10,0
2024-09-14,42,DPD30-59,7,7,0
2024-09-14,42,DPD60-89,0,0,0
2024-09-14,42,DPD90+,0,0,0
2024-09-14,44,Current,0,0,0
2024-09-14,44,DPD15-29,35,35,0
2024-09-14,44,DPD3-14,38,38,0
2024-09-14,44,DPD30-59,10,10,0
2024-09-14,44,DPD60-89,0,0,0
2024-09-14,44,DPD90+,0,0,0
2024-09-14,46,Current,0,0,0
2024-09-14,46,DPD3-14,0,0,0
2024-09-14,46,DPD30-59,1,1,0
2024-09-14,48,Current,45,45,0
2024-09-14,48,DPD15-29,17,17,0
2024-09-14,48,DPD3-14,26,26,0
2024-09-14,48,DPD30-59,12,12,0
2024-09-14,48,DPD60-89,0,0,0
2024-09-14,48,DPD90+,0,0,0
2024-09-14,6,Current,0,0,0
2024-09-13,100,Current,0,0,0
2024-09-13,100,DPD3-14,1,1,0
2024-09-13,102,Current,0,0,0
2024-09-13,102,DPD3-14,0,0,0
2024-09-13,104,Current,0,0,0
2024-09-13,104,DPD15-29,0,0,0
2024-09-13,20,Current,0,0,0
2024-09-13,20,DPD15-29,288,288,0
2024-09-13,20,DPD3-14,192,192,0
2024-09-13,20,DPD30-59,79,79,0
2024-09-13,20,DPD60-89,0,0,0
2024-09-13,20,DPD90+,0,0,0
2024-09-13,22,Current,0,0,0
2024-09-13,22,DPD15-29,3,3,0
2024-09-13,22,DPD30-59,0,0,0
2024-09-13,22,DPD90+,0,0,0
2024-09-13,24,Current,65,65,0
2024-09-13,24,DPD15-29,164,164,0
2024-09-13,24,DPD3-14,123,123,0
2024-09-13,24,DPD30-59,47,47,0
2024-09-13,24,DPD60-89,0,0,0
2024-09-13,24,DPD90+,0,0,0
2024-09-13,26,Current,0,0,0
2024-09-13,26,DPD15-29,28,28,0
2024-09-13,26,DPD3-14,9,9,0
2024-09-13,26,DPD30-59,4,4,0
2024-09-13,26,DPD60-89,0,0,0
2024-09-13,26,DPD90+,0,0,0
2024-09-13,32,Current,0,0,0
2024-09-13,32,DPD15-29,156,156,0
2024-09-13,32,DPD3-14,105,105,0
2024-09-13,32,DPD30-59,42,42,0
2024-09-13,32,DPD60-89,0,0,0
2024-09-13,32,DPD90+,0,0,0
2024-09-13,34,Current,0,0,0
2024-09-13,34,DPD15-29,69,69,0
2024-09-13,34,DPD3-14,27,27,0
2024-09-13,34,DPD30-59,21,21,0
2024-09-13,34,DPD60-89,0,0,0
2024-09-13,34,DPD90+,0,0,0
2024-09-13,36,Current,0,0,0
2024-09-13,36,DPD15-29,46,46,0
2024-09-13,36,DPD3-14,27,27,0
2024-09-13,36,DPD30-59,9,9,0
2024-09-13,36,DPD60-89,0,0,0
2024-09-13,36,DPD90+,0,0,0
2024-09-13,38,Current,13,13,0
2024-09-13,38,DPD15-29,42,42,0
2024-09-13,38,DPD3-14,35,35,0
2024-09-13,38,DPD30-59,11,11,0
2024-09-13,38,DPD60-89,0,0,0
2024-09-13,38,DPD90+,0,0,0
2024-09-13,40,Current,0,0,0
2024-09-13,40,DPD15-29,24,24,0
2024-09-13,40,DPD3-14,21,21,0
2024-09-13,40,DPD30-59,3,3,0
2024-09-13,40,DPD60-89,0,0,0
2024-09-13,40,DPD90+,0,0,0
2024-09-13,42,Current,0,0,0
2024-09-13,42,DPD15-29,18,18,0
2024-09-13,42,DPD3-14,9,9,0
2024-09-13,42,DPD30-59,3,3,0
2024-09-13,42,DPD60-89,0,0,0
2024-09-13,42,DPD90+,0,0,0
2024-09-13,44,Current,0,0,0
2024-09-13,44,DPD15-29,36,36,0
2024-09-13,44,DPD3-14,39,39,0
2024-09-13,44,DPD30-59,11,11,0
2024-09-13,44,DPD60-89,0,0,0
2024-09-13,44,DPD90+,0,0,0
2024-09-13,46,Current,0,0,0
2024-09-13,46,DPD3-14,1,1,0
2024-09-13,46,DPD30-59,0,0,0
2024-09-13,48,Current,52,52,0
2024-09-13,48,DPD15-29,23,23,0
2024-09-13,48,DPD3-14,31,31,0
2024-09-13,48,DPD30-59,7,7,0
2024-09-13,48,DPD60-89,0,0,0
2024-09-13,48,DPD90+,0,0,0
2024-09-13,6,Current,0,0,0
2024-09-12,100,Current,0,0,0
2024-09-12,100,DPD3-14,0,0,0
2024-09-12,102,Current,0,0,0
2024-09-12,102,DPD3-14,0,0,0
2024-09-12,104,Current,0,0,0
2024-09-12,104,DPD15-29,0,0,0
2024-09-12,20,Current,0,0,0
2024-09-12,20,DPD15-29,232,232,0
2024-09-12,20,DPD3-14,210,210,0
2024-09-12,20,DPD30-59,64,64,0
2024-09-12,20,DPD60-89,0,0,0
2024-09-12,20,DPD90+,0,0,0
2024-09-12,22,Current,0,0,0
2024-09-12,22,DPD15-29,0,0,0
2024-09-12,22,DPD30-59,0,0,0
2024-09-12,22,DPD90+,0,0,0
2024-09-12,24,Current,32,32,0
2024-09-12,24,DPD15-29,148,148,0
2024-09-12,24,DPD3-14,150,150,0
2024-09-12,24,DPD30-59,29,29,0
2024-09-12,24,DPD60-89,0,0,0
2024-09-12,24,DPD90+,0,0,0
2024-09-12,26,Current,0,0,0
2024-09-12,26,DPD15-29,13,13,0
2024-09-12,26,DPD3-14,16,16,0
2024-09-12,26,DPD30-59,5,5,0
2024-09-12,26,DPD60-89,0,0,0
2024-09-12,26,DPD90+,0,0,0
2024-09-12,32,Current,0,0,0
2024-09-12,32,DPD15-29,141,141,0
2024-09-12,32,DPD3-14,79,79,0
2024-09-12,32,DPD30-59,40,40,0
2024-09-12,32,DPD60-89,0,0,0
2024-09-12,32,DPD90+,1,1,0
2024-09-12,34,Current,0,0,0
2024-09-12,34,DPD15-29,55,55,0
2024-09-12,34,DPD3-14,35,35,0
2024-09-12,34,DPD30-59,16,16,0
2024-09-12,34,DPD60-89,0,0,0
2024-09-12,34,DPD90+,0,0,0
2024-09-12,36,Current,0,0,0
2024-09-12,36,DPD15-29,33,33,0
2024-09-12,36,DPD3-14,25,25,0
2024-09-12,36,DPD30-59,3,3,0
2024-09-12,36,DPD60-89,0,0,0
2024-09-12,36,DPD90+,0,0,0
2024-09-12,38,Current,4,4,0
2024-09-12,38,DPD15-29,35,35,0
2024-09-12,38,DPD3-14,38,38,0
2024-09-12,38,DPD30-59,6,6,0
2024-09-12,38,DPD60-89,0,0,0
2024-09-12,38,DPD90+,0,0,0
2024-09-12,40,Current,0,0,0
2024-09-12,40,DPD15-29,12,12,0
2024-09-12,40,DPD3-14,23,23,0
2024-09-12,40,DPD30-59,3,3,0
2024-09-12,40,DPD60-89,0,0,0
2024-09-12,40,DPD90+,0,0,0
2024-09-12,42,Current,0,0,0
2024-09-12,42,DPD15-29,24,24,0
2024-09-12,42,DPD3-14,10,10,0
2024-09-12,42,DPD30-59,4,4,0
2024-09-12,42,DPD60-89,0,0,0
2024-09-12,42,DPD90+,0,0,0
2024-09-12,44,Current,0,0,0
2024-09-12,44,DPD15-29,39,39,0
2024-09-12,44,DPD3-14,47,47,0
2024-09-12,44,DPD30-59,8,8,0
2024-09-12,44,DPD60-89,0,0,0
2024-09-12,44,DPD90+,0,0,0
2024-09-12,46,Current,0,0,0
2024-09-12,46,DPD3-14,0,0,0
2024-09-12,46,DPD30-59,0,0,0
2024-09-12,48,Current,20,20,0
2024-09-12,48,DPD15-29,21,21,0
2024-09-12,48,DPD3-14,19,19,0
2024-09-12,48,DPD30-59,8,8,0
2024-09-12,48,DPD60-89,0,0,0
2024-09-12,48,DPD90+,0,0,0
2024-09-12,6,Current,0,0,0
2024-09-11,100,Current,0,0,0
2024-09-11,100,DPD3-14,1,1,0
2024-09-11,102,Current,0,0,0
2024-09-11,102,DPD15-29,0,0,0
2024-09-11,102,DPD3-14,0,0,0
2024-09-11,104,Current,0,0,0
2024-09-11,104,DPD30-59,0,0,0
2024-09-11,20,Current,0,0,0
2024-09-11,20,DPD15-29,218,218,0
2024-09-11,20,DPD3-14,281,281,0
2024-09-11,20,DPD30-59,150,150,0
2024-09-11,20,DPD60-89,0,0,0
2024-09-11,20,DPD90+,0,0,0
2024-09-11,22,Current,0,0,0
2024-09-11,22,DPD15-29,2,2,0
2024-09-11,22,DPD3-14,1,1,0
2024-09-11,22,DPD30-59,1,1,0
2024-09-11,22,DPD90+,0,0,0
2024-09-11,24,Current,41,41,0
2024-09-11,24,DPD15-29,126,126,0
2024-09-11,24,DPD3-14,151,151,0
2024-09-11,24,DPD30-59,66,66,0
2024-09-11,24,DPD60-89,0,0,0
2024-09-11,24,DPD90+,0,0,0
2024-09-11,26,Current,0,0,0
2024-09-11,26,DPD15-29,17,17,0
2024-09-11,26,DPD3-14,24,24,0
2024-09-11,26,DPD30-59,6,6,0
2024-09-11,26,DPD60-89,0,0,0
2024-09-11,26,DPD90+,0,0,0
2024-09-11,32,Current,0,0,0
2024-09-11,32,DPD15-29,120,120,0
2024-09-11,32,DPD3-14,141,141,0
2024-09-11,32,DPD30-59,57,57,0
2024-09-11,32,DPD60-89,0,0,0
2024-09-11,32,DPD90+,0,0,0
2024-09-11,34,Current,0,0,0
2024-09-11,34,DPD15-29,50,50,0
2024-09-11,34,DPD3-14,50,50,0
2024-09-11,34,DPD30-59,27,27,0
2024-09-11,34,DPD60-89,0,0,0
2024-09-11,34,DPD90+,0,0,0
2024-09-11,36,Current,0,0,0
2024-09-11,36,DPD15-29,33,33,0
2024-09-11,36,DPD3-14,41,41,0
2024-09-11,36,DPD30-59,13,13,0
2024-09-11,36,DPD60-89,0,0,0
2024-09-11,36,DPD90+,0,0,0
2024-09-11,38,Current,5,5,0
2024-09-11,38,DPD15-29,31,31,0
2024-09-11,38,DPD3-14,52,52,0
2024-09-11,38,DPD30-59,15,15,0
2024-09-11,38,DPD60-89,0,0,0
2024-09-11,38,DPD90+,0,0,0
2024-09-11,40,Current,0,0,0
2024-09-11,40,DPD15-29,17,17,0
2024-09-11,40,DPD3-14,25,25,0
2024-09-11,40,DPD30-59,19,19,0
2024-09-11,40,DPD60-89,0,0,0
2024-09-11,40,DPD90+,0,0,0
2024-09-11,42,Current,0,0,0
2024-09-11,42,DPD15-29,11,11,0
2024-09-11,42,DPD3-14,15,15,0
2024-09-11,42,DPD30-59,11,11,0
2024-09-11,42,DPD60-89,0,0,0
2024-09-11,42,DPD90+,0,0,0
2024-09-11,44,Current,0,0,0
2024-09-11,44,DPD15-29,33,33,0
2024-09-11,44,DPD3-14,41,41,0
2024-09-11,44,DPD30-59,16,16,0
2024-09-11,44,DPD60-89,0,0,0
2024-09-11,44,DPD90+,0,0,0
2024-09-11,46,Current,0,0,0
2024-09-11,46,DPD3-14,1,1,0
2024-09-11,46,DPD30-59,0,0,0
2024-09-11,48,Current,26,26,0
2024-09-11,48,DPD15-29,22,22,0
2024-09-11,48,DPD3-14,35,35,0
2024-09-11,48,DPD30-59,9,9,0
2024-09-11,48,DPD60-89,0,0,0
2024-09-11,48,DPD90+,0,0,0
2024-09-11,6,Current,0,0,0
2024-09-10,100,Current,0,0,0
2024-09-10,100,DPD3-14,0,0,0
2024-09-10,102,Current,0,0,0
2024-09-10,102,DPD15-29,0,0,0
2024-09-10,102,DPD3-14,0,0,0
2024-09-10,104,Current,0,0,0
2024-09-10,104,DPD30-59,0,0,0
2024-09-10,20,Current,0,0,0
2024-09-10,20,DPD15-29,221,221,0
2024-09-10,20,DPD3-14,213,213,0
2024-09-10,20,DPD30-59,116,116,0
2024-09-10,20,DPD60-89,0,0,0
2024-09-10,20,DPD90+,0,0,0
2024-09-10,22,Current,0,0,0
2024-09-10,22,DPD15-29,0,0,0
2024-09-10,22,DPD3-14,0,0,0
2024-09-10,22,DPD30-59,0,0,0
2024-09-10,22,DPD90+,0,0,0
2024-09-10,24,Current,58,58,0
2024-09-10,24,DPD15-29,147,147,0
2024-09-10,24,DPD3-14,155,155,0
2024-09-10,24,DPD30-59,60,60,0
2024-09-10,24,DPD60-89,0,0,0
2024-09-10,24,DPD90+,0,0,0
2024-09-10,26,Current,0,0,0
2024-09-10,26,DPD15-29,15,15,0
2024-09-10,26,DPD3-14,14,14,0
2024-09-10,26,DPD30-59,8,8,0
2024-09-10,26,DPD60-89,0,0,0
2024-09-10,26,DPD90+,0,0,0
2024-09-10,32,Current,0,0,0
2024-09-10,32,DPD15-29,126,126,0
2024-09-10,32,DPD3-14,93,93,0
2024-09-10,32,DPD30-59,61,61,0
2024-09-10,32,DPD60-89,0,0,0
2024-09-10,32,DPD90+,0,0,0
2024-09-10,34,Current,0,0,0
2024-09-10,34,DPD15-29,49,49,0
2024-09-10,34,DPD3-14,37,37,0
2024-09-10,34,DPD30-59,28,28,0
2024-09-10,34,DPD60-89,0,0,0
2024-09-10,34,DPD90+,0,0,0
2024-09-10,36,Current,0,0,0
2024-09-10,36,DPD15-29,32,32,0
2024-09-10,36,DPD3-14,28,28,0
2024-09-10,36,DPD30-59,10,10,0
2024-09-10,36,DPD60-89,0,0,0
2024-09-10,36,DPD90+,0,0,0
2024-09-10,38,Current,6,6,0
2024-09-10,38,DPD15-29,38,38,0
2024-09-10,38,DPD3-14,31,31,0
2024-09-10,38,DPD30-59,15,15,0
2024-09-10,38,DPD60-89,0,0,0
2024-09-10,38,DPD90+,0,0,0
2024-09-10,40,Current,0,0,0
2024-09-10,40,DPD15-29,11,11,0
2024-09-10,40,DPD3-14,22,22,0
2024-09-10,40,DPD30-59,2,2,0
2024-09-10,40,DPD60-89,0,0,0
2024-09-10,40,DPD90+,0,0,0
2024-09-10,42,Current,0,0,0
2024-09-10,42,DPD15-29,18,18,0
2024-09-10,42,DPD3-14,13,13,0
2024-09-10,42,DPD30-59,8,8,0
2024-09-10,42,DPD60-89,0,0,0
2024-09-10,42,DPD90+,0,0,0
2024-09-10,44,Current,0,0,0
2024-09-10,44,DPD15-29,35,35,0
2024-09-10,44,DPD3-14,43,43,0
2024-09-10,44,DPD30-59,16,16,0
2024-09-10,44,DPD60-89,0,0,0
2024-09-10,44,DPD90+,0,0,0
2024-09-10,46,Current,0,0,0
2024-09-10,46,DPD3-14,0,0,0
2024-09-10,46,DPD30-59,1,1,0
2024-09-10,48,Current,28,28,0
2024-09-10,48,DPD15-29,21,21,0
2024-09-10,48,DPD3-14,24,24,0
2024-09-10,48,DPD30-59,12,12,0
2024-09-10,48,DPD60-89,0,0,0
2024-09-10,48,DPD90+,0,0,0
2024-09-10,6,Current,0,0,0
2024-09-09,100,Current,0,0,0
2024-09-09,100,DPD3-14,1,1,0
2024-09-09,102,Current,0,0,0
2024-09-09,102,DPD15-29,0,0,0
2024-09-09,102,DPD3-14,0,0,0
2024-09-09,104,Current,0,0,0
2024-09-09,104,DPD30-59,0,0,0
2024-09-09,20,Current,0,0,0
2024-09-09,20,DPD15-29,224,224,0
2024-09-09,20,DPD3-14,332,332,0
2024-09-09,20,DPD30-59,63,63,0
2024-09-09,20,DPD60-89,0,0,0
2024-09-09,20,DPD90+,0,0,0
2024-09-09,22,Current,0,0,0
2024-09-09,22,DPD15-29,1,1,0
2024-09-09,22,DPD3-14,2,2,0
2024-09-09,22,DPD30-59,0,0,0
2024-09-09,22,DPD90+,0,0,0
2024-09-09,24,Current,77,77,0
2024-09-09,24,DPD15-29,125,125,0
2024-09-09,24,DPD3-14,210,210,0
2024-09-09,24,DPD30-59,40,40,0
2024-09-09,24,DPD60-89,0,0,0
2024-09-09,24,DPD90+,0,0,0
2024-09-09,26,Current,0,0,0
2024-09-09,26,DPD15-29,13,13,0
2024-09-09,26,DPD3-14,28,28,0
2024-09-09,26,DPD30-59,3,3,0
2024-09-09,26,DPD60-89,0,0,0
2024-09-09,26,DPD90+,0,0,0
2024-09-09,32,Current,0,0,0
2024-09-09,32,DPD15-29,120,120,0
2024-09-09,32,DPD3-14,164,164,0
2024-09-09,32,DPD30-59,36,36,0
2024-09-09,32,DPD60-89,0,0,0
2024-09-09,32,DPD90+,0,0,0
2024-09-09,34,Current,0,0,0
2024-09-09,34,DPD15-29,58,58,0
2024-09-09,34,DPD3-14,62,62,0
2024-09-09,34,DPD30-59,19,19,0
2024-09-09,34,DPD60-89,0,0,0
2024-09-09,34,DPD90+,0,0,0
2024-09-09,36,Current,0,0,0
2024-09-09,36,DPD15-29,33,33,0
2024-09-09,36,DPD3-14,48,48,0
2024-09-09,36,DPD30-59,11,11,0
2024-09-09,36,DPD60-89,0,0,0
2024-09-09,36,DPD90+,0,0,0
2024-09-09,38,Current,17,17,0
2024-09-09,38,DPD15-29,31,31,0
2024-09-09,38,DPD3-14,65,65,0
2024-09-09,38,DPD30-59,10,10,0
2024-09-09,38,DPD60-89,0,0,0
2024-09-09,38,DPD90+,0,0,0
2024-09-09,40,Current,0,0,0
2024-09-09,40,DPD15-29,17,17,0
2024-09-09,40,DPD3-14,34,34,0
2024-09-09,40,DPD30-59,2,2,0
2024-09-09,40,DPD60-89,0,0,0
2024-09-09,40,DPD90+,0,0,0
2024-09-09,42,Current,0,0,0
2024-09-09,42,DPD15-29,8,8,0
2024-09-09,42,DPD3-14,21,21,0
2024-09-09,42,DPD30-59,4,4,0
2024-09-09,42,DPD60-89,0,0,0
2024-09-09,42,DPD90+,0,0,0
2024-09-09,44,Current,0,0,0
2024-09-09,44,DPD15-29,33,33,0
2024-09-09,44,DPD3-14,50,50,0
2024-09-09,44,DPD30-59,8,8,0
2024-09-09,44,DPD60-89,0,0,0
2024-09-09,44,DPD90+,0,0,0
2024-09-09,46,Current,0,0,0
2024-09-09,46,DPD30-59,0,0,0
2024-09-09,48,Current,38,38,0
2024-09-09,48,DPD15-29,19,19,0
2024-09-09,48,DPD3-14,41,41,0
2024-09-09,48,DPD30-59,9,9,0
2024-09-09,48,DPD60-89,0,0,0
2024-09-09,48,DPD90+,0,0,0
2024-09-09,6,Current,0,0,0
2024-09-08,100,Current,0,0,0
2024-09-08,100,DPD3-14,0,0,0
2024-09-08,102,Current,0,0,0
2024-09-08,102,DPD15-29,0,0,0
2024-09-08,104,Current,0,0,0
2024-09-08,104,DPD30-59,0,0,0
2024-09-08,20,Current,0,0,0
2024-09-08,20,DPD15-29,202,202,0
2024-09-08,20,DPD3-14,219,219,0
2024-09-08,20,DPD30-59,65,65,0
2024-09-08,20,DPD60-89,8,8,0
2024-09-08,20,DPD90+,6,6,0
2024-09-08,22,Current,0,0,0
2024-09-08,22,DPD15-29,0,0,0
2024-09-08,22,DPD3-14,0,0,0
2024-09-08,22,DPD30-59,0,0,0
2024-09-08,22,DPD90+,0,0,0
2024-09-08,24,Current,75,75,0
2024-09-08,24,DPD15-29,141,141,0
2024-09-08,24,DPD3-14,145,145,0
2024-09-08,24,DPD30-59,27,27,0
2024-09-08,24,DPD60-89,0,0,0
2024-09-08,24,DPD90+,0,0,0
2024-09-08,26,Current,0,0,0
2024-09-08,26,DPD15-29,14,14,0
2024-09-08,26,DPD3-14,9,9,0
2024-09-08,26,DPD30-59,5,5,0
2024-09-08,26,DPD60-89,0,0,0
2024-09-08,26,DPD90+,0,0,0
2024-09-08,32,Current,0,0,0
2024-09-08,32,DPD15-29,128,128,0
2024-09-08,32,DPD3-14,102,102,0
2024-09-08,32,DPD30-59,41,41,0
2024-09-08,32,DPD60-89,0,0,0
2024-09-08,32,DPD90+,0,0,0
2024-09-08,34,Current,0,0,0
2024-09-08,34,DPD15-29,42,42,0
2024-09-08,34,DPD3-14,38,38,0
2024-09-08,34,DPD30-59,13,13,0
2024-09-08,34,DPD60-89,0,0,0
2024-09-08,34,DPD90+,0,0,0
2024-09-08,36,Current,0,0,0
2024-09-08,36,DPD15-29,33,33,0
2024-09-08,36,DPD3-14,34,34,0
2024-09-08,36,DPD30-59,2,2,0
2024-09-08,36,DPD60-89,0,0,0
2024-09-08,36,DPD90+,0,0,0
2024-09-08,38,Current,10,10,0
2024-09-08,38,DPD15-29,34,34,0
2024-09-08,38,DPD3-14,32,32,0
2024-09-08,38,DPD30-59,5,5,0
2024-09-08,38,DPD60-89,0,0,0
2024-09-08,38,DPD90+,0,0,0
2024-09-08,40,Current,0,0,0
2024-09-08,40,DPD15-29,11,11,0
2024-09-08,40,DPD3-14,17,17,0
2024-09-08,40,DPD30-59,7,7,0
2024-09-08,40,DPD60-89,0,0,0
2024-09-08,40,DPD90+,0,0,0
2024-09-08,42,Current,0,0,0
2024-09-08,42,DPD15-29,13,13,0
2024-09-08,42,DPD3-14,18,18,0
2024-09-08,42,DPD30-59,3,3,0
2024-09-08,42,DPD60-89,0,0,0
2024-09-08,42,DPD90+,0,0,0
2024-09-08,44,Current,0,0,0
2024-09-08,44,DPD15-29,33,33,0
2024-09-08,44,DPD3-14,46,46,0
2024-09-08,44,DPD30-59,8,8,0
2024-09-08,44,DPD60-89,0,0,0
2024-09-08,44,DPD90+,0,0,0
2024-09-08,46,Current,0,0,0
2024-09-08,46,DPD30-59,0,0,0
2024-09-08,48,Current,39,39,0
2024-09-08,48,DPD15-29,22,22,0
2024-09-08,48,DPD3-14,26,26,0
2024-09-08,48,DPD30-59,6,6,0
2024-09-08,48,DPD60-89,0,0,0
2024-09-08,48,DPD90+,0,0,0
2024-09-08,6,Current,0,0,0
2024-09-07,100,Current,0,0,0
2024-09-07,100,DPD3-14,0,0,0
2024-09-07,102,Current,0,0,0
2024-09-07,102,DPD15-29,0,0,0
2024-09-07,104,Current,0,0,0
2024-09-07,104,DPD30-59,0,0,0
2024-09-07,20,Current,0,0,0
2024-09-07,20,DPD15-29,209,209,0
2024-09-07,20,DPD3-14,300,300,0
2024-09-07,20,DPD30-59,153,153,0
2024-09-07,20,DPD60-89,62,62,0
2024-09-07,20,DPD90+,31,31,0
2024-09-07,22,Current,0,0,0
2024-09-07,22,DPD15-29,1,1,0
2024-09-07,22,DPD3-14,2,2,0
2024-09-07,22,DPD30-59,1,1,0
2024-09-07,22,DPD90+,0,0,0
2024-09-07,24,Current,59,59,0
2024-09-07,24,DPD15-29,129,129,0
2024-09-07,24,DPD3-14,176,176,0
2024-09-07,24,DPD30-59,69,69,0
2024-09-07,24,DPD60-89,0,0,0
2024-09-07,24,DPD90+,0,0,0
2024-09-07,26,Current,0,0,0
2024-09-07,26,DPD15-29,10,10,0
2024-09-07,26,DPD3-14,27,27,0
2024-09-07,26,DPD30-59,8,8,0
2024-09-07,26,DPD60-89,0,0,0
2024-09-07,26,DPD90+,0,0,0
2024-09-07,32,Current,0,0,0
2024-09-07,32,DPD15-29,112,112,0
2024-09-07,32,DPD3-14,162,162,0
2024-09-07,32,DPD30-59,56,56,0
2024-09-07,32,DPD60-89,0,0,0
2024-09-07,32,DPD90+,0,0,0
2024-09-07,34,Current,0,0,0
2024-09-07,34,DPD15-29,51,51,0
2024-09-07,34,DPD3-14,61,61,0
2024-09-07,34,DPD30-59,30,30,0
2024-09-07,34,DPD60-89,0,0,0
2024-09-07,34,DPD90+,0,0,0
2024-09-07,36,Current,0,0,0
2024-09-07,36,DPD15-29,30,30,0
2024-09-07,36,DPD3-14,44,44,0
2024-09-07,36,DPD30-59,17,17,0
2024-09-07,36,DPD60-89,0,0,0
2024-09-07,36,DPD90+,0,0,0
2024-09-07,38,Current,8,8,0
2024-09-07,38,DPD15-29,26,26,0
2024-09-07,38,DPD3-14,60,60,0
2024-09-07,38,DPD30-59,15,15,0
2024-09-07,38,DPD60-89,0,0,0
2024-09-07,38,DPD90+,0,0,0
2024-09-07,40,Current,0,0,0
2024-09-07,40,DPD15-29,16,16,0
2024-09-07,40,DPD3-14,34,34,0
2024-09-07,40,DPD30-59,9,9,0
2024-09-07,40,DPD60-89,0,0,0
2024-09-07,40,DPD90+,0,0,0
2024-09-07,42,Current,0,0,0
2024-09-07,42,DPD15-29,8,8,0
2024-09-07,42,DPD3-14,22,22,0
2024-09-07,42,DPD30-59,11,11,0
2024-09-07,42,DPD60-89,0,0,0
2024-09-07,42,DPD90+,0,0,0
2024-09-07,44,Current,0,0,0
2024-09-07,44,DPD15-29,31,31,0
2024-09-07,44,DPD3-14,45,45,0
2024-09-07,44,DPD30-59,17,17,0
2024-09-07,44,DPD60-89,0,0,0
2024-09-07,44,DPD90+,0,0,0
2024-09-07,46,Current,0,0,0
2024-09-07,46,DPD30-59,0,0,0
2024-09-07,48,Current,31,31,0
2024-09-07,48,DPD15-29,19,19,0
2024-09-07,48,DPD3-14,27,27,0
2024-09-07,48,DPD30-59,11,11,0
2024-09-07,48,DPD60-89,0,0,0
2024-09-07,48,DPD90+,0,0,0
2024-09-07,6,Current,0,0,0
2024-09-06,100,Current,0,0,0
2024-09-06,100,DPD3-14,0,0,0
2024-09-06,102,Current,0,0,0
2024-09-06,102,DPD15-29,0,0,0
2024-09-06,104,Current,0,0,0
2024-09-06,104,DPD30-59,0,0,0
2024-09-06,20,Current,0,0,0
2024-09-06,20,DPD15-29,212,212,0
2024-09-06,20,DPD3-14,233,233,0
2024-09-06,20,DPD30-59,115,115,0
2024-09-06,20,DPD60-89,36,36,0
2024-09-06,20,DPD90+,35,35,0
2024-09-06,22,Current,0,0,0
2024-09-06,22,DPD15-29,0,0,0
2024-09-06,22,DPD3-14,0,0,0
2024-09-06,22,DPD30-59,0,0,0
2024-09-06,22,DPD90+,0,0,0
2024-09-06,24,Current,64,64,0
2024-09-06,24,DPD15-29,137,137,0
2024-09-06,24,DPD3-14,155,155,0
2024-09-06,24,DPD30-59,58,58,0
2024-09-06,24,DPD60-89,0,0,0
2024-09-06,24,DPD90+,0,0,0
2024-09-06,26,Current,0,0,0
2024-09-06,26,DPD15-29,13,13,0
2024-09-06,26,DPD3-14,12,12,0
2024-09-06,26,DPD30-59,7,7,0
2024-09-06,26,DPD60-89,0,0,0
2024-09-06,26,DPD90+,0,0,0
2024-09-06,32,Current,0,0,0
2024-09-06,32,DPD15-29,124,124,0
2024-09-06,32,DPD3-14,120,120,0
2024-09-06,32,DPD30-59,51,51,0
2024-09-06,32,DPD60-89,0,0,0
2024-09-06,32,DPD90+,0,0,0
2024-09-06,34,Current,0,0,0
2024-09-06,34,DPD15-29,42,42,0
2024-09-06,34,DPD3-14,32,32,0
2024-09-06,34,DPD30-59,32,32,0
2024-09-06,34,DPD60-89,0,0,0
2024-09-06,34,DPD90+,0,0,0
2024-09-06,36,Current,0,0,0
2024-09-06,36,DPD15-29,32,32,0
2024-09-06,36,DPD3-14,38,38,0
2024-09-06,36,DPD30-59,7,7,0
2024-09-06,36,DPD60-89,0,0,0
2024-09-06,36,DPD90+,0,0,0
2024-09-06,38,Current,6,6,0
2024-09-06,38,DPD15-29,30,30,0
2024-09-06,38,DPD3-14,44,44,0
2024-09-06,38,DPD30-59,16,16,0
2024-09-06,38,DPD60-89,0,0,0
2024-09-06,38,DPD90+,0,0,0
2024-09-06,40,Current,0,0,0
2024-09-06,40,DPD15-29,15,15,0
2024-09-06,40,DPD3-14,18,18,0
2024-09-06,40,DPD30-59,12,12,0
2024-09-06,40,DPD60-89,0,0,0
2024-09-06,40,DPD90+,0,0,0
2024-09-06,42,Current,0,0,0
2024-09-06,42,DPD15-29,12,12,0
2024-09-06,42,DPD3-14,21,21,0
2024-09-06,42,DPD30-59,10,10,0
2024-09-06,42,DPD60-89,0,0,0
2024-09-06,42,DPD90+,0,0,0
2024-09-06,44,Current,0,0,0
2024-09-06,44,DPD15-29,32,32,0
2024-09-06,44,DPD3-14,48,48,0
2024-09-06,44,DPD30-59,14,14,0
2024-09-06,44,DPD60-89,0,0,0
2024-09-06,44,DPD90+,0,0,0
2024-09-06,46,Current,0,0,0
2024-09-06,46,DPD30-59,1,1,0
2024-09-06,48,Current,37,37,0
2024-09-06,48,DPD15-29,22,22,0
2024-09-06,48,DPD3-14,26,26,0
2024-09-06,48,DPD30-59,11,11,0
2024-09-06,48,DPD60-89,0,0,0
2024-09-06,48,DPD90+,0,0,0
2024-09-06,6,Current,0,0,0
2024-09-05,100,Current,0,0,0
2024-09-05,102,Current,0,0,0
2024-09-05,102,DPD15-29,0,0,0
2024-09-05,104,Current,0,0,0
2024-09-05,104,DPD30-59,0,0,0
2024-09-05,20,Current,0,0,0
2024-09-05,20,DPD15-29,222,222,0
2024-09-05,20,DPD3-14,358,358,0
2024-09-05,20,DPD30-59,48,48,0
2024-09-05,20,DPD60-89,15,15,0
2024-09-05,20,DPD90+,7,7,0
2024-09-05,22,Current,0,0,0
2024-09-05,22,DPD3-14,3,3,0
2024-09-05,22,DPD30-59,0,0,0
2024-09-05,22,DPD90+,0,0,0
2024-09-05,24,Current,33,33,0
2024-09-05,24,DPD15-29,126,126,0
2024-09-05,24,DPD3-14,199,199,0
2024-09-05,24,DPD30-59,38,38,0
2024-09-05,24,DPD60-89,0,0,0
2024-09-05,24,DPD90+,0,0,0
2024-09-05,26,Current,0,0,0
2024-09-05,26,DPD15-29,12,12,0
2024-09-05,26,DPD3-14,33,33,0
2024-09-05,26,DPD30-59,4,4,0
2024-09-05,26,DPD60-89,0,0,0
2024-09-05,26,DPD90+,0,0,0
2024-09-05,32,Current,0,0,0
2024-09-05,32,DPD15-29,114,114,0
2024-09-05,32,DPD3-14,177,177,0
2024-09-05,32,DPD30-59,29,29,0
2024-09-05,32,DPD60-89,0,0,0
2024-09-05,32,DPD90+,0,0,0
2024-09-05,34,Current,0,0,0
2024-09-05,34,DPD15-29,59,59,0
2024-09-05,34,DPD3-14,71,71,0
2024-09-05,34,DPD30-59,14,14,0
2024-09-05,34,DPD60-89,0,0,0
2024-09-05,34,DPD90+,0,0,0
2024-09-05,36,Current,0,0,0
2024-09-05,36,DPD15-29,32,32,0
2024-09-05,36,DPD3-14,50,50,0
2024-09-05,36,DPD30-59,9,9,0
2024-09-05,36,DPD60-89,0,0,0
2024-09-05,36,DPD90+,0,0,0
2024-09-05,38,Current,7,7,0
2024-09-05,38,DPD15-29,29,29,0
2024-09-05,38,DPD3-14,71,71,0
2024-09-05,38,DPD30-59,11,11,0
2024-09-05,38,DPD60-89,0,0,0
2024-09-05,38,DPD90+,0,0,0
2024-09-05,40,Current,0,0,0
2024-09-05,40,DPD15-29,16,16,0
2024-09-05,40,DPD3-14,37,37,0
2024-09-05,40,DPD30-59,0,0,0
2024-09-05,40,DPD60-89,0,0,0
2024-09-05,40,DPD90+,0,0,0
2024-09-05,42,Current,0,0,0
2024-09-05,42,DPD15-29,8,8,0
2024-09-05,42,DPD3-14,25,25,0
2024-09-05,42,DPD30-59,3,3,0
2024-09-05,42,DPD60-89,0,0,0
2024-09-05,42,DPD90+,0,0,0
2024-09-05,44,Current,0,0,0
2024-09-05,44,DPD15-29,36,36,0
2024-09-05,44,DPD3-14,51,51,0
2024-09-05,44,DPD30-59,9,9,0
2024-09-05,44,DPD60-89,0,0,0
2024-09-05,44,DPD90+,0,0,0
2024-09-05,46,Current,0,0,0
2024-09-05,46,DPD30-59,0,0,0
2024-09-05,48,Current,15,15,0
2024-09-05,48,DPD15-29,19,19,0
2024-09-05,48,DPD3-14,30,30,0
2024-09-05,48,DPD30-59,6,6,0
2024-09-05,48,DPD60-89,0,0,0
2024-09-05,48,DPD90+,0,0,0
2024-09-05,6,Current,0,0,0
2024-09-04,100,Current,0,0,0
2024-09-04,102,Current,0,0,0
2024-09-04,102,DPD15-29,0,0,0
2024-09-04,104,Current,0,0,0
2024-09-04,104,DPD30-59,0,0,0
2024-09-04,20,Current,0,0,0
2024-09-04,20,DPD15-29,225,225,0
2024-09-04,20,DPD3-14,226,226,0
2024-09-04,20,DPD30-59,57,57,0
2024-09-04,20,DPD60-89,31,31,0
2024-09-04,20,DPD90+,71,71,0
2024-09-04,22,Current,0,0,0
2024-09-04,22,DPD3-14,0,0,0
2024-09-04,22,DPD30-59,0,0,0
2024-09-04,22,DPD90+,0,0,0
2024-09-04,24,Current,41,41,0
2024-09-04,24,DPD15-29,131,131,0
2024-09-04,24,DPD3-14,140,140,0
2024-09-04,24,DPD30-59,38,38,0
2024-09-04,24,DPD60-89,0,0,0
2024-09-04,24,DPD90+,0,0,0
2024-09-04,26,Current,0,0,0
2024-09-04,26,DPD15-29,13,13,0
2024-09-04,26,DPD3-14,12,12,0
2024-09-04,26,DPD30-59,4,4,0
2024-09-04,26,DPD60-89,0,0,0
2024-09-04,26,DPD90+,0,0,0
2024-09-04,32,Current,0,0,0
2024-09-04,32,DPD15-29,119,119,0
2024-09-04,32,DPD3-14,121,121,0
2024-09-04,32,DPD30-59,40,40,0
2024-09-04,32,DPD60-89,1,1,0
2024-09-04,32,DPD90+,0,0,0
2024-09-04,34,Current,0,0,0
2024-09-04,34,DPD15-29,42,42,0
2024-09-04,34,DPD3-14,42,42,0
2024-09-04,34,DPD30-59,16,16,0
2024-09-04,34,DPD60-89,0,0,0
2024-09-04,34,DPD90+,0,0,0
2024-09-04,36,Current,0,0,0
2024-09-04,36,DPD15-29,27,27,0
2024-09-04,36,DPD3-14,44,44,0
2024-09-04,36,DPD30-59,5,5,0
2024-09-04,36,DPD60-89,0,0,0
2024-09-04,36,DPD90+,0,0,0
2024-09-04,38,Current,11,11,0
2024-09-04,38,DPD15-29,32,32,0
2024-09-04,38,DPD3-14,47,47,0
2024-09-04,38,DPD30-59,9,9,0
2024-09-04,38,DPD60-89,0,0,0
2024-09-04,38,DPD90+,0,0,0
2024-09-04,40,Current,0,0,0
2024-09-04,40,DPD15-29,14,14,0
2024-09-04,40,DPD3-14,20,20,0
2024-09-04,40,DPD30-59,3,3,0
2024-09-04,40,DPD60-89,0,0,0
2024-09-04,40,DPD90+,0,0,0
2024-09-04,42,Current,0,0,0
2024-09-04,42,DPD15-29,14,14,0
2024-09-04,42,DPD3-14,16,16,0
2024-09-04,42,DPD30-59,6,6,0
2024-09-04,42,DPD60-89,0,0,0
2024-09-04,42,DPD90+,0,0,0
2024-09-04,44,Current,0,0,0
2024-09-04,44,DPD15-29,32,32,0
2024-09-04,44,DPD3-14,36,36,0
2024-09-04,44,DPD30-59,9,9,0
2024-09-04,44,DPD60-89,0,0,0
2024-09-04,44,DPD90+,0,0,0
2024-09-04,46,Current,0,0,0
2024-09-04,46,DPD15-29,1,1,0
2024-09-04,46,DPD30-59,0,0,0
2024-09-04,48,Current,17,17,0
2024-09-04,48,DPD15-29,23,23,0
2024-09-04,48,DPD3-14,21,21,0
2024-09-04,48,DPD30-59,3,3,0
2024-09-04,48,DPD60-89,0,0,0
2024-09-04,48,DPD90+,0,0,0
2024-09-04,6,Current,0,0,0
2024-09-03,100,Current,0,0,0
2024-09-03,102,Current,0,0,0
2024-09-03,102,DPD3-14,0,0,0
2024-09-03,104,Current,0,0,0
2024-09-03,104,DPD15-29,0,0,0
2024-09-03,104,DPD30-59,0,0,0
2024-09-03,20,Current,0,0,0
2024-09-03,20,DPD15-29,213,213,0
2024-09-03,20,DPD3-14,429,429,0
2024-09-03,20,DPD30-59,170,170,0
2024-09-03,20,DPD60-89,83,83,0
2024-09-03,20,DPD90+,0,0,0
2024-09-03,22,Current,0,0,0
2024-09-03,22,DPD3-14,3,3,0
2024-09-03,22,DPD30-59,1,1,0
2024-09-03,22,DPD90+,0,0,0
2024-09-03,24,Current,51,51,0
2024-09-03,24,DPD15-29,143,143,0
2024-09-03,24,DPD3-14,265,265,0
2024-09-03,24,DPD30-59,83,83,0
2024-09-03,24,DPD60-89,0,0,0
2024-09-03,24,DPD90+,0,0,0
2024-09-03,26,Current,0,0,0
2024-09-03,26,DPD15-29,13,13,0
2024-09-03,26,DPD3-14,43,43,0
2024-09-03,26,DPD30-59,8,8,0
2024-09-03,26,DPD60-89,0,0,0
2024-09-03,26,DPD90+,0,0,0
2024-09-03,32,Current,0,0,0
2024-09-03,32,DPD15-29,100,100,0
2024-09-03,32,DPD3-14,221,221,0
2024-09-03,32,DPD30-59,61,61,0
2024-09-03,32,DPD60-89,0,0,0
2024-09-03,32,DPD90+,0,0,0
2024-09-03,34,Current,0,0,0
2024-09-03,34,DPD15-29,58,58,0
2024-09-03,34,DPD3-14,87,87,0
2024-09-03,34,DPD30-59,33,33,0
2024-09-03,34,DPD60-89,0,0,0
2024-09-03,34,DPD90+,0,0,0
2024-09-03,36,Current,0,0,0
2024-09-03,36,DPD15-29,26,26,0
2024-09-03,36,DPD3-14,65,65,0
2024-09-03,36,DPD30-59,21,21,0
2024-09-03,36,DPD60-89,0,0,0
2024-09-03,36,DPD90+,0,0,0
2024-09-03,38,Current,6,6,0
2024-09-03,38,DPD15-29,24,24,0
2024-09-03,38,DPD3-14,63,63,0
2024-09-03,38,DPD30-59,19,19,0
2024-09-03,38,DPD60-89,0,0,0
2024-09-03,38,DPD90+,0,0,0
2024-09-03,40,Current,0,0,0
2024-09-03,40,DPD15-29,18,18,0
2024-09-03,40,DPD3-14,39,39,0
2024-09-03,40,DPD30-59,12,12,0
2024-09-03,40,DPD60-89,0,0,0
2024-09-03,40,DPD90+,0,0,0
2024-09-03,42,Current,0,0,0
2024-09-03,42,DPD15-29,10,10,0
2024-09-03,42,DPD3-14,37,37,0
2024-09-03,42,DPD30-59,12,12,0
2024-09-03,42,DPD60-89,0,0,0
2024-09-03,42,DPD90+,0,0,0
2024-09-03,44,Current,0,0,0
2024-09-03,44,DPD15-29,41,41,0
2024-09-03,44,DPD3-14,51,51,0
2024-09-03,44,DPD30-59,16,16,0
2024-09-03,44,DPD60-89,0,0,0
2024-09-03,44,DPD90+,0,0,0
2024-09-03,46,Current,0,0,0
2024-09-03,46,DPD15-29,0,0,0
2024-09-03,46,DPD30-59,0,0,0
2024-09-03,48,Current,22,22,0
2024-09-03,48,DPD15-29,20,20,0
2024-09-03,48,DPD3-14,44,44,0
2024-09-03,48,DPD30-59,15,15,0
2024-09-03,48,DPD60-89,0,0,0
2024-09-03,48,DPD90+,0,0,0
2024-09-03,6,Current,0,0,0
2024-09-02,100,Current,0,0,0
2024-09-02,102,Current,0,0,0
2024-09-02,102,DPD3-14,0,0,0
2024-09-02,104,Current,0,0,0
2024-09-02,104,DPD15-29,0,0,0
2024-09-02,104,DPD30-59,0,0,0
2024-09-02,20,Current,0,0,0
2024-09-02,20,DPD15-29,212,212,0
2024-09-02,20,DPD3-14,288,288,0
2024-09-02,20,DPD30-59,134,134,0
2024-09-02,20,DPD60-89,72,72,0
2024-09-02,20,DPD90+,23,23,0
2024-09-02,22,Current,0,0,0
2024-09-02,22,DPD3-14,1,1,0
2024-09-02,22,DPD30-59,0,0,0
2024-09-02,22,DPD90+,0,0,0
2024-09-02,24,Current,64,64,0
2024-09-02,24,DPD15-29,115,115,0
2024-09-02,24,DPD3-14,192,192,0
2024-09-02,24,DPD30-59,65,65,0
2024-09-02,24,DPD60-89,0,0,0
2024-09-02,24,DPD90+,0,0,0
2024-09-02,26,Current,0,0,0
2024-09-02,26,DPD15-29,11,11,0
2024-09-02,26,DPD3-14,17,17,0
2024-09-02,26,DPD30-59,9,9,0
2024-09-02,26,DPD60-89,0,0,0
2024-09-02,26,DPD90+,0,0,0
2024-09-02,32,Current,0,0,0
2024-09-02,32,DPD15-29,126,126,0
2024-09-02,32,DPD3-14,149,149,0
2024-09-02,32,DPD30-59,57,57,0
2024-09-02,32,DPD60-89,0,0,0
2024-09-02,32,DPD90+,0,0,0
2024-09-02,34,Current,0,0,0
2024-09-02,34,DPD15-29,38,38,0
2024-09-02,34,DPD3-14,67,67,0
2024-09-02,34,DPD30-59,31,31,0
2024-09-02,34,DPD60-89,0,0,0
2024-09-02,34,DPD90+,0,0,0
2024-09-02,36,Current,0,0,0
2024-09-02,36,DPD15-29,26,26,0
2024-09-02,36,DPD3-14,49,49,0
2024-09-02,36,DPD30-59,10,10,0
2024-09-02,36,DPD60-89,0,0,0
2024-09-02,36,DPD90+,0,0,0
2024-09-02,38,Current,16,16,0
2024-09-02,38,DPD15-29,27,27,0
2024-09-02,38,DPD3-14,55,55,0
2024-09-02,38,DPD30-59,16,16,0
2024-09-02,38,DPD60-89,0,0,0
2024-09-02,38,DPD90+,0,0,0
2024-09-02,40,Current,0,0,0
2024-09-02,40,DPD15-29,15,15,0
2024-09-02,40,DPD3-14,26,26,0
2024-09-02,40,DPD30-59,8,8,0
2024-09-02,40,DPD60-89,0,0,0
2024-09-02,40,DPD90+,0,0,0
2024-09-02,42,Current,0,0,0
2024-09-02,42,DPD15-29,14,14,0
2024-09-02,42,DPD3-14,21,21,0
2024-09-02,42,DPD30-59,10,10,0
2024-09-02,42,DPD60-89,0,0,0
2024-09-02,42,DPD90+,0,0,0
2024-09-02,44,Current,0,0,0
2024-09-02,44,DPD15-29,23,23,0
2024-09-02,44,DPD3-14,51,51,0
2024-09-02,44,DPD30-59,16,16,0
2024-09-02,44,DPD60-89,0,0,0
2024-09-02,44,DPD90+,0,0,0
2024-09-02,46,Current,0,0,0
2024-09-02,46,DPD15-29,1,1,0
2024-09-02,46,DPD30-59,1,1,0
2024-09-02,48,Current,29,29,0
2024-09-02,48,DPD15-29,24,24,0
2024-09-02,48,DPD3-14,35,35,0
2024-09-02,48,DPD30-59,13,13,0
2024-09-02,48,DPD60-89,0,0,0
2024-09-02,48,DPD90+,0,0,0
2024-09-02,6,Current,0,0,0
2024-09-01,100,Current,0,0,0
2024-09-01,102,Current,0,0,0
2024-09-01,102,DPD3-14,0,0,0
2024-09-01,104,Current,0,0,0
2024-09-01,104,DPD15-29,0,0,0
2024-09-01,104,DPD30-59,0,0,0
2024-09-01,20,Current,4243,4243,0
2024-09-01,20,DPD15-29,262,262,0
2024-09-01,20,DPD3-14,568,568,0
2024-09-01,20,DPD30-59,93,93,0
2024-09-01,20,DPD60-89,50,50,0
2024-09-01,20,DPD90+,42,42,0
2024-09-01,22,Current,0,0,0
2024-09-01,22,DPD3-14,3,3,0
2024-09-01,22,DPD30-59,0,0,0
2024-09-01,22,DPD90+,0,0,0
2024-09-01,24,Current,4285,4285,0
2024-09-01,24,DPD15-29,145,145,0
2024-09-01,24,DPD3-14,351,351,0
2024-09-01,24,DPD30-59,52,52,0
2024-09-01,24,DPD60-89,22,22,0
2024-09-01,24,DPD90+,11,11,0
2024-09-01,26,Current,0,0,0
2024-09-01,26,DPD15-29,12,12,0
2024-09-01,26,DPD3-14,44,44,0
2024-09-01,26,DPD30-59,4,4,0
2024-09-01,26,DPD60-89,0,0,0
2024-09-01,26,DPD90+,0,0,0
2024-09-01,32,Current,221,221,0
2024-09-01,32,DPD15-29,86,86,0
2024-09-01,32,DPD3-14,245,245,0
2024-09-01,32,DPD30-59,33,33,0
2024-09-01,32,DPD60-89,2,2,0
2024-09-01,32,DPD90+,2,2,0
2024-09-01,34,Current,0,0,0
2024-09-01,34,DPD15-29,43,43,0
2024-09-01,34,DPD3-14,101,101,0
2024-09-01,34,DPD30-59,15,15,0
2024-09-01,34,DPD60-89,0,0,0
2024-09-01,34,DPD90+,0,0,0
2024-09-01,36,Current,238,238,0
2024-09-01,36,DPD15-29,18,18,0
2024-09-01,36,DPD3-14,77,77,0
2024-09-01,36,DPD30-59,8,8,0
2024-09-01,36,DPD60-89,1,1,0
2024-09-01,36,DPD90+,3,3,0
2024-09-01,38,Current,72,72,0
2024-09-01,38,DPD15-29,22,22,0
2024-09-01,38,DPD3-14,64,64,0
2024-09-01,38,DPD30-59,8,8,0
2024-09-01,38,DPD60-89,0,0,0
2024-09-01,38,DPD90+,0,0,0
2024-09-01,40,Current,263,263,0
2024-09-01,40,DPD15-29,16,16,0
2024-09-01,40,DPD3-14,45,45,0
2024-09-01,40,DPD30-59,6,6,0
2024-09-01,40,DPD60-89,4,4,0
2024-09-01,40,DPD90+,0,0,0
2024-09-01,42,Current,0,0,0
2024-09-01,42,DPD15-29,9,9,0
2024-09-01,42,DPD3-14,35,35,0
2024-09-01,42,DPD30-59,1,1,0
2024-09-01,42,DPD60-89,0,0,0
2024-09-01,42,DPD90+,0,0,0
2024-09-01,44,Current,167,167,0
2024-09-01,44,DPD15-29,31,31,0
2024-09-01,44,DPD3-14,61,61,0
2024-09-01,44,DPD30-59,14,14,0
2024-09-01,44,DPD60-89,0,0,0
2024-09-01,44,DPD90+,1,1,0
2024-09-01,46,Current,4,4,0
2024-09-01,46,DPD15-29,0,0,0
2024-09-01,46,DPD30-59,0,0,0
2024-09-01,48,Current,4350,4350,0
2024-09-01,48,DPD15-29,50,50,0
2024-09-01,48,DPD3-14,103,103,0
2024-09-01,48,DPD30-59,34,34,0
2024-09-01,48,DPD60-89,10,10,0
2024-09-01,48,DPD90+,9,9,0
2024-09-01,6,Current,0,0,0
2024-08-31,100,Current,0,0,0
2024-08-31,102,Current,0,0,0
2024-08-31,102,DPD3-14,0,0,0
2024-08-31,104,Current,0,0,0
2024-08-31,104,DPD15-29,0,0,0
2024-08-31,104,DPD30-59,0,0,0
2024-08-31,20,Current,0,0,0
2024-08-31,20,DPD15-29,210,210,0
2024-08-31,20,DPD3-14,314,314,0
2024-08-31,20,DPD30-59,48,48,0
2024-08-31,20,DPD60-89,6,6,0
2024-08-31,20,DPD90+,6,6,0
2024-08-31,22,Current,0,0,0
2024-08-31,22,DPD3-14,1,1,0
2024-08-31,22,DPD30-59,0,0,0
2024-08-31,22,DPD90+,0,0,0
2024-08-31,24,Current,65,65,0
2024-08-31,24,DPD15-29,109,109,0
2024-08-31,24,DPD3-14,211,211,0
2024-08-31,24,DPD30-59,19,19,0
2024-08-31,24,DPD60-89,0,0,0
2024-08-31,24,DPD90+,0,0,0
2024-08-31,26,Current,0,0,0
2024-08-31,26,DPD15-29,10,10,0
2024-08-31,26,DPD3-14,18,18,0
2024-08-31,26,DPD30-59,3,3,0
2024-08-31,26,DPD60-89,0,0,0
2024-08-31,26,DPD90+,0,0,0
2024-08-31,32,Current,0,0,0
2024-08-31,32,DPD15-29,117,117,0
2024-08-31,32,DPD3-14,165,165,0
2024-08-31,32,DPD30-59,19,19,0
2024-08-31,32,DPD60-89,0,0,0
2024-08-31,32,DPD90+,0,0,0
2024-08-31,34,Current,0,0,0
2024-08-31,34,DPD15-29,37,37,0
2024-08-31,34,DPD3-14,72,72,0
2024-08-31,34,DPD30-59,5,5,0
2024-08-31,34,DPD60-89,0,0,0
2024-08-31,34,DPD90+,0,0,0
2024-08-31,36,Current,0,0,0
2024-08-31,36,DPD15-29,26,26,0
2024-08-31,36,DPD3-14,49,49,0
2024-08-31,36,DPD30-59,2,2,0
2024-08-31,36,DPD60-89,0,0,0
2024-08-31,36,DPD90+,0,0,0
2024-08-31,38,Current,12,12,0
2024-08-31,38,DPD15-29,27,27,0
2024-08-31,38,DPD3-14,56,56,0
2024-08-31,38,DPD30-59,2,2,0
2024-08-31,38,DPD60-89,0,0,0
2024-08-31,38,DPD90+,0,0,0
2024-08-31,40,Current,0,0,0
2024-08-31,40,DPD15-29,14,14,0
2024-08-31,40,DPD3-14,28,28,0
2024-08-31,40,DPD30-59,1,1,0
2024-08-31,40,DPD60-89,0,0,0
2024-08-31,40,DPD90+,0,0,0
2024-08-31,42,Current,0,0,0
2024-08-31,42,DPD15-29,16,16,0
2024-08-31,42,DPD3-14,20,20,0
2024-08-31,42,DPD30-59,4,4,0
2024-08-31,42,DPD60-89,0,0,0
2024-08-31,42,DPD90+,0,0,0
2024-08-31,44,Current,0,0,0
2024-08-31,44,DPD15-29,20,20,0
2024-08-31,44,DPD3-14,58,58,0
2024-08-31,44,DPD30-59,4,4,0
2024-08-31,44,DPD60-89,0,0,0
2024-08-31,44,DPD90+,0,0,0
2024-08-31,46,Current,0,0,0
2024-08-31,46,DPD15-29,2,2,0
2024-08-31,46,DPD30-59,0,0,0
2024-08-31,48,Current,33,33,0
2024-08-31,48,DPD15-29,21,21,0
2024-08-31,48,DPD3-14,41,41,0
2024-08-31,48,DPD30-59,4,4,0
2024-08-31,48,DPD60-89,0,0,0
2024-08-31,48,DPD90+,0,0,0
2024-08-31,6,Current,0,0,0
2024-08-30,100,Current,0,0,0
2024-08-30,102,Current,0,0,0
2024-08-30,102,DPD3-14,0,0,0
2024-08-30,104,Current,0,0,0
2024-08-30,104,DPD15-29,0,0,0
2024-08-30,104,DPD30-59,0,0,0
2024-08-30,20,Current,0,0,0
2024-08-30,20,DPD15-29,168,168,0
2024-08-30,20,DPD3-14,353,353,0
2024-08-30,20,DPD30-59,186,186,0
2024-08-30,20,DPD60-89,70,70,0
2024-08-30,20,DPD90+,34,34,0
2024-08-30,22,Current,0,0,0
2024-08-30,22,DPD3-14,3,3,0
2024-08-30,22,DPD30-59,1,1,0
2024-08-30,22,DPD90+,0,0,0
2024-08-30,24,Current,60,60,0
2024-08-30,24,DPD15-29,109,109,0
2024-08-30,24,DPD3-14,202,202,0
2024-08-30,24,DPD30-59,92,92,0
2024-08-30,24,DPD60-89,0,0,0
2024-08-30,24,DPD90+,0,0,0
2024-08-30,26,Current,0,0,0
2024-08-30,26,DPD15-29,7,7,0
2024-08-30,26,DPD3-14,26,26,0
2024-08-30,26,DPD30-59,10,10,0
2024-08-30,26,DPD60-89,0,0,0
2024-08-30,26,DPD90+,0,0,0
2024-08-30,32,Current,0,0,0
2024-08-30,32,DPD15-29,67,67,0
2024-08-30,32,DPD3-14,176,176,0
2024-08-30,32,DPD30-59,79,79,0
2024-08-30,32,DPD60-89,0,0,0
2024-08-30,32,DPD90+,0,0,0
2024-08-30,34,Current,0,0,0
2024-08-30,34,DPD15-29,39,39,0
2024-08-30,34,DPD3-14,70,70,0
2024-08-30,34,DPD30-59,44,44,0
2024-08-30,34,DPD60-89,0,0,0
2024-08-30,34,DPD90+,0,0,0
2024-08-30,36,Current,0,0,0
2024-08-30,36,DPD15-29,20,20,0
2024-08-30,36,DPD3-14,52,52,0
2024-08-30,36,DPD30-59,25,25,0
2024-08-30,36,DPD60-89,0,0,0
2024-08-30,36,DPD90+,0,0,0
2024-08-30,38,Current,9,9,0
2024-08-30,38,DPD15-29,16,16,0
2024-08-30,38,DPD3-14,50,50,0
2024-08-30,38,DPD30-59,27,27,0
2024-08-30,38,DPD60-89,0,0,0
2024-08-30,38,DPD90+,0,0,0
2024-08-30,40,Current,0,0,0
2024-08-30,40,DPD15-29,8,8,0
2024-08-30,40,DPD3-14,32,32,0
2024-08-30,40,DPD30-59,17,17,0
2024-08-30,40,DPD60-89,0,0,0
2024-08-30,40,DPD90+,0,0,0
2024-08-30,42,Current,0,0,0
2024-08-30,42,DPD15-29,9,9,0
2024-08-30,42,DPD3-14,23,23,0
2024-08-30,42,DPD30-59,14,14,0
2024-08-30,42,DPD60-89,0,0,0
2024-08-30,42,DPD90+,0,0,0
2024-08-30,44,Current,0,0,0
2024-08-30,44,DPD15-29,25,25,0
2024-08-30,44,DPD3-14,47,47,0
2024-08-30,44,DPD30-59,23,23,0
2024-08-30,44,DPD60-89,0,0,0
2024-08-30,44,DPD90+,0,0,0
2024-08-30,46,Current,0,0,0
2024-08-30,46,DPD15-29,0,0,0
2024-08-30,48,Current,37,37,0
2024-08-30,48,DPD15-29,15,15,0
2024-08-30,48,DPD3-14,34,34,0
2024-08-30,48,DPD30-59,15,15,0
2024-08-30,48,DPD60-89,0,0,0
2024-08-30,48,DPD90+,0,0,0
2024-08-30,6,Current,0,0,0
2024-08-29,100,Current,0,0,0
2024-08-29,102,Current,0,0,0
2024-08-29,102,DPD3-14,0,0,0
2024-08-29,104,Current,0,0,0
2024-08-29,104,DPD15-29,0,0,0
2024-08-29,104,DPD30-59,0,0,0
2024-08-29,20,Current,0,0,0
2024-08-29,20,DPD15-29,168,168,0
2024-08-29,20,DPD3-14,359,359,0
2024-08-29,20,DPD30-59,140,140,0
2024-08-29,20,DPD60-89,40,40,0
2024-08-29,20,DPD90+,29,29,0
2024-08-29,22,Current,0,0,0
2024-08-29,22,DPD3-14,1,1,0
2024-08-29,22,DPD30-59,0,0,0
2024-08-29,22,DPD90+,0,0,0
2024-08-29,24,Current,45,45,0
2024-08-29,24,DPD15-29,77,77,0
2024-08-29,24,DPD3-14,238,238,0
2024-08-29,24,DPD30-59,68,68,0
2024-08-29,24,DPD60-89,0,0,0
2024-08-29,24,DPD90+,0,0,0
2024-08-29,26,Current,0,0,0
2024-08-29,26,DPD15-29,9,9,0
2024-08-29,26,DPD3-14,19,19,0
2024-08-29,26,DPD30-59,12,12,0
2024-08-29,26,DPD60-89,0,0,0
2024-08-29,26,DPD90+,0,0,0
2024-08-29,32,Current,0,0,0
2024-08-29,32,DPD15-29,96,96,0
2024-08-29,32,DPD3-14,178,178,0
2024-08-29,32,DPD30-59,49,49,0
2024-08-29,32,DPD60-89,0,0,0
2024-08-29,32,DPD90+,0,0,0
2024-08-29,34,Current,0,0,0
2024-08-29,34,DPD15-29,28,28,0
2024-08-29,34,DPD3-14,75,75,0
2024-08-29,34,DPD30-59,28,28,0
2024-08-29,34,DPD60-89,0,0,0
2024-08-29,34,DPD90+,0,0,0
2024-08-29,36,Current,0,0,0
2024-08-29,36,DPD15-29,16,16,0
2024-08-29,36,DPD3-14,55,55,0
2024-08-29,36,DPD30-59,11,11,0
2024-08-29,36,DPD60-89,0,0,0
2024-08-29,36,DPD90+,0,0,0
2024-08-29,38,Current,7,7,0
2024-08-29,38,DPD15-29,15,15,0
2024-08-29,38,DPD3-14,64,64,0
2024-08-29,38,DPD30-59,18,18,0
2024-08-29,38,DPD60-89,0,0,0
2024-08-29,38,DPD90+,0,0,0
2024-08-29,40,Current,0,0,0
2024-08-29,40,DPD15-29,10,10,0
2024-08-29,40,DPD3-14,26,26,0
2024-08-29,40,DPD30-59,8,8,0
2024-08-29,40,DPD60-89,0,0,0
2024-08-29,40,DPD90+,0,0,0
2024-08-29,42,Current,0,0,0
2024-08-29,42,DPD15-29,10,10,0
2024-08-29,42,DPD3-14,26,26,0
2024-08-29,42,DPD30-59,8,8,0
2024-08-29,42,DPD60-89,0,0,0
2024-08-29,42,DPD90+,0,0,0
2024-08-29,44,Current,0,0,0
2024-08-29,44,DPD15-29,22,22,0
2024-08-29,44,DPD3-14,64,64,0
2024-08-29,44,DPD30-59,15,15,0
2024-08-29,44,DPD60-89,0,0,0
2024-08-29,44,DPD90+,0,0,0
2024-08-29,46,Current,0,0,0
2024-08-29,46,DPD15-29,2,2,0
2024-08-29,48,Current,22,22,0
2024-08-29,48,DPD15-29,24,24,0
2024-08-29,48,DPD3-14,45,45,0
2024-08-29,48,DPD30-59,13,13,0
2024-08-29,48,DPD60-89,0,0,0
2024-08-29,48,DPD90+,0,0,0
2024-08-29,6,Current,0,0,0
2024-08-28,100,Current,0,0,0
2024-08-28,102,Current,0,0,0
2024-08-28,102,DPD3-14,0,0,0
2024-08-28,104,Current,0,0,0
2024-08-28,104,DPD15-29,0,0,0
2024-08-28,104,DPD30-59,0,0,0
2024-08-28,104,DPD90+,0,0,0
2024-08-28,20,Current,0,0,0
2024-08-28,20,DPD15-29,146,146,0
2024-08-28,20,DPD3-14,346,346,0
2024-08-28,20,DPD30-59,63,63,0
2024-08-28,20,DPD60-89,11,11,0
2024-08-28,20,DPD90+,5,5,0
2024-08-28,22,Current,0,0,0
2024-08-28,22,DPD3-14,2,2,0
2024-08-28,22,DPD30-59,0,0,0
2024-08-28,22,DPD90+,0,0,0
2024-08-28,24,Current,43,43,0
2024-08-28,24,DPD15-29,97,97,0
2024-08-28,24,DPD3-14,195,195,0
2024-08-28,24,DPD30-59,39,39,0
2024-08-28,24,DPD60-89,0,0,0
2024-08-28,24,DPD90+,0,0,0
2024-08-28,26,Current,0,0,0
2024-08-28,26,DPD15-29,5,5,0
2024-08-28,26,DPD3-14,27,27,0
2024-08-28,26,DPD30-59,5,5,0
2024-08-28,26,DPD60-89,0,0,0
2024-08-28,26,DPD90+,0,0,0
2024-08-28,32,Current,0,0,0
2024-08-28,32,DPD15-29,55,55,0
2024-08-28,32,DPD3-14,175,175,0
2024-08-28,32,DPD30-59,29,29,0
2024-08-28,32,DPD60-89,0,0,0
2024-08-28,32,DPD90+,1,1,0
2024-08-28,34,Current,0,0,0
2024-08-28,34,DPD15-29,28,28,0
2024-08-28,34,DPD3-14,73,73,0
2024-08-28,34,DPD30-59,10,10,0
2024-08-28,34,DPD60-89,0,0,0
2024-08-28,34,DPD90+,0,0,0
2024-08-28,36,Current,0,0,0
2024-08-28,36,DPD15-29,17,17,0
2024-08-28,36,DPD3-14,47,47,0
2024-08-28,36,DPD30-59,4,4,0
2024-08-28,36,DPD60-89,0,0,0
2024-08-28,36,DPD90+,0,0,0
2024-08-28,38,Current,8,8,0
2024-08-28,38,DPD15-29,14,14,0
2024-08-28,38,DPD3-14,51,51,0
2024-08-28,38,DPD30-59,5,5,0
2024-08-28,38,DPD60-89,0,0,0
2024-08-28,38,DPD90+,0,0,0
2024-08-28,40,Current,0,0,0
2024-08-28,40,DPD15-29,5,5,0
2024-08-28,40,DPD3-14,35,35,0
2024-08-28,40,DPD30-59,5,5,0
2024-08-28,40,DPD60-89,0,0,0
2024-08-28,40,DPD90+,0,0,0
2024-08-28,42,Current,0,0,0
2024-08-28,42,DPD15-29,9,9,0
2024-08-28,42,DPD3-14,14,14,0
2024-08-28,42,DPD30-59,3,3,0
2024-08-28,42,DPD60-89,0,0,0
2024-08-28,42,DPD90+,0,0,0
2024-08-28,44,Current,0,0,0
2024-08-28,44,DPD15-29,18,18,0
2024-08-28,44,DPD3-14,49,49,0
2024-08-28,44,DPD30-59,6,6,0
2024-08-28,44,DPD60-89,0,0,0
2024-08-28,44,DPD90+,0,0,0
2024-08-28,46,Current,0,0,0
2024-08-28,46,DPD15-29,0,0,0
2024-08-28,48,Current,19,19,0
2024-08-28,48,DPD15-29,11,11,0
2024-08-28,48,DPD3-14,39,39,0
2024-08-28,48,DPD30-59,4,4,0
2024-08-28,48,DPD60-89,0,0,0
2024-08-28,48,DPD90+,0,0,0
2024-08-28,6,Current,0,0,0
2024-08-27,100,Current,0,0,0
2024-08-27,102,Current,0,0,0
2024-08-27,102,DPD3-14,0,0,0
2024-08-27,104,Current,0,0,0
2024-08-27,104,DPD15-29,0,0,0
2024-08-27,104,DPD30-59,0,0,0
2024-08-27,104,DPD90+,0,0,0
2024-08-27,20,Current,0,0,0
2024-08-27,20,DPD15-29,201,201,0
2024-08-27,20,DPD3-14,354,354,0
2024-08-27,20,DPD30-59,17,17,0
2024-08-27,20,DPD60-89,44,44,0
2024-08-27,20,DPD90+,70,70,0
2024-08-27,22,Current,0,0,0
2024-08-27,22,DPD3-14,1,1,0
2024-08-27,22,DPD30-59,0,0,0
2024-08-27,22,DPD90+,0,0,0
2024-08-27,24,Current,42,42,0
2024-08-27,24,DPD15-29,88,88,0
2024-08-27,24,DPD3-14,246,246,0
2024-08-27,24,DPD30-59,17,17,0
2024-08-27,24,DPD60-89,0,0,0
2024-08-27,24,DPD90+,0,0,0
2024-08-27,26,Current,0,0,0
2024-08-27,26,DPD15-29,10,10,0
2024-08-27,26,DPD3-14,25,25,0
2024-08-27,26,DPD30-59,2,2,0
2024-08-27,26,DPD60-89,0,0,0
2024-08-27,26,DPD90+,0,0,0
2024-08-27,32,Current,0,0,0
2024-08-27,32,DPD15-29,110,110,0
2024-08-27,32,DPD3-14,170,170,0
2024-08-27,32,DPD30-59,19,19,0
2024-08-27,32,DPD60-89,0,0,0
2024-08-27,32,DPD90+,0,0,0
2024-08-27,34,Current,0,0,0
2024-08-27,34,DPD15-29,32,32,0
2024-08-27,34,DPD3-14,77,77,0
2024-08-27,34,DPD30-59,4,4,0
2024-08-27,34,DPD60-89,0,0,0
2024-08-27,34,DPD90+,0,0,0
2024-08-27,36,Current,0,0,0
2024-08-27,36,DPD15-29,21,21,0
2024-08-27,36,DPD3-14,57,57,0
2024-08-27,36,DPD30-59,4,4,0
2024-08-27,36,DPD60-89,0,0,0
2024-08-27,36,DPD90+,0,0,0
2024-08-27,38,Current,7,7,0
2024-08-27,38,DPD15-29,21,21,0
2024-08-27,38,DPD3-14,73,73,0
2024-08-27,38,DPD30-59,5,5,0
2024-08-27,38,DPD60-89,0,0,0
2024-08-27,38,DPD90+,0,0,0
2024-08-27,40,Current,0,0,0
2024-08-27,40,DPD15-29,20,20,0
2024-08-27,40,DPD3-14,23,23,0
2024-08-27,40,DPD30-59,3,3,0
2024-08-27,40,DPD60-89,0,0,0
2024-08-27,40,DPD90+,0,0,0
2024-08-27,42,Current,0,0,0
2024-08-27,42,DPD15-29,10,10,0
2024-08-27,42,DPD3-14,28,28,0
2024-08-27,42,DPD30-59,1,1,0
2024-08-27,42,DPD60-89,0,0,0
2024-08-27,42,DPD90+,0,0,0
2024-08-27,44,Current,0,0,0
2024-08-27,44,DPD15-29,26,26,0
2024-08-27,44,DPD3-14,63,63,0
2024-08-27,44,DPD30-59,1,1,0
2024-08-27,44,DPD60-89,0,0,0
2024-08-27,44,DPD90+,0,0,0
2024-08-27,46,Current,0,0,0
2024-08-27,46,DPD15-29,2,2,0
2024-08-27,48,Current,21,21,0
2024-08-27,48,DPD15-29,24,24,0
2024-08-27,48,DPD3-14,50,50,0
2024-08-27,48,DPD30-59,2,2,0
2024-08-27,48,DPD60-89,0,0,0
2024-08-27,48,DPD90+,0,0,0
2024-08-27,6,Current,0,0,0
2024-08-26,100,Current,0,0,0
2024-08-26,102,Current,0,0,0
2024-08-26,102,DPD3-14,0,0,0
2024-08-26,104,Current,0,0,0
2024-08-26,104,DPD15-29,0,0,0
2024-08-26,104,DPD30-59,0,0,0
2024-08-26,104,DPD90+,0,0,0
2024-08-26,20,Current,0,0,0
2024-08-26,20,DPD15-29,166,166,0
2024-08-26,20,DPD3-14,381,381,0
2024-08-26,20,DPD30-59,202,202,0
2024-08-26,20,DPD60-89,53,53,0
2024-08-26,20,DPD90+,0,0,0
2024-08-26,22,Current,0,0,0
2024-08-26,22,DPD15-29,0,0,0
2024-08-26,22,DPD3-14,2,2,0
2024-08-26,22,DPD30-59,1,1,0
2024-08-26,22,DPD90+,0,0,0
2024-08-26,24,Current,57,57,0
2024-08-26,24,DPD15-29,106,106,0
2024-08-26,24,DPD3-14,260,260,0
2024-08-26,24,DPD30-59,100,100,0
2024-08-26,24,DPD60-89,0,0,0
2024-08-26,24,DPD90+,0,0,0
2024-08-26,26,Current,0,0,0
2024-08-26,26,DPD15-29,5,5,0
2024-08-26,26,DPD3-14,43,43,0
2024-08-26,26,DPD30-59,10,10,0
2024-08-26,26,DPD60-89,0,0,0
2024-08-26,26,DPD90+,0,0,0
2024-08-26,32,Current,0,0,0
2024-08-26,32,DPD15-29,66,66,0
2024-08-26,32,DPD3-14,192,192,0
2024-08-26,32,DPD30-59,77,77,0
2024-08-26,32,DPD60-89,0,0,0
2024-08-26,32,DPD90+,0,0,0
2024-08-26,34,Current,0,0,0
2024-08-26,34,DPD15-29,28,28,0
2024-08-26,34,DPD3-14,85,85,0
2024-08-26,34,DPD30-59,43,43,0
2024-08-26,34,DPD60-89,0,0,0
2024-08-26,34,DPD90+,0,0,0
2024-08-26,36,Current,0,0,0
2024-08-26,36,DPD15-29,20,20,0
2024-08-26,36,DPD3-14,63,63,0
2024-08-26,36,DPD30-59,30,30,0
2024-08-26,36,DPD60-89,0,0,0
2024-08-26,36,DPD90+,0,0,0
2024-08-26,38,Current,12,12,0
2024-08-26,38,DPD15-29,20,20,0
2024-08-26,38,DPD3-14,51,51,0
2024-08-26,38,DPD30-59,22,22,0
2024-08-26,38,DPD60-89,0,0,0
2024-08-26,38,DPD90+,0,0,0
2024-08-26,40,Current,0,0,0
2024-08-26,40,DPD15-29,7,7,0
2024-08-26,40,DPD3-14,36,36,0
2024-08-26,40,DPD30-59,22,22,0
2024-08-26,40,DPD60-89,0,0,0
2024-08-26,40,DPD90+,0,0,0
2024-08-26,42,Current,0,0,0
2024-08-26,42,DPD15-29,6,6,0
2024-08-26,42,DPD3-14,15,15,0
2024-08-26,42,DPD30-59,15,15,0
2024-08-26,42,DPD60-89,0,0,0
2024-08-26,42,DPD90+,0,0,0
2024-08-26,44,Current,0,0,0
2024-08-26,44,DPD15-29,17,17,0
2024-08-26,44,DPD3-14,57,57,0
2024-08-26,44,DPD30-59,26,26,0
2024-08-26,44,DPD60-89,0,0,0
2024-08-26,44,DPD90+,0,0,0
2024-08-26,46,Current,0,0,0
2024-08-26,46,DPD15-29,0,0,0
2024-08-26,48,Current,36,36,0
2024-08-26,48,DPD15-29,11,11,0
2024-08-26,48,DPD3-14,55,55,0
2024-08-26,48,DPD30-59,18,18,0
2024-08-26,48,DPD60-89,0,0,0
2024-08-26,48,DPD90+,0,0,0
2024-08-26,6,Current,0,0,0
2024-08-25,100,Current,0,0,0
2024-08-25,102,Current,0,0,0
2024-08-25,102,DPD3-14,0,0,0
2024-08-25,104,Current,0,0,0
2024-08-25,104,DPD15-29,0,0,0
2024-08-25,104,DPD30-59,0,0,0
2024-08-25,104,DPD90+,0,0,0
2024-08-25,20,Current,0,0,0
2024-08-25,20,DPD15-29,201,201,0
2024-08-25,20,DPD3-14,340,340,0
2024-08-25,20,DPD30-59,132,132,0
2024-08-25,20,DPD60-89,51,51,0
2024-08-25,20,DPD90+,34,34,0
2024-08-25,22,Current,0,0,0
2024-08-25,22,DPD15-29,1,1,0
2024-08-25,22,DPD3-14,1,1,0
2024-08-25,22,DPD30-59,0,0,0
2024-08-25,22,DPD90+,0,0,0
2024-08-25,24,Current,69,69,0
2024-08-25,24,DPD15-29,93,93,0
2024-08-25,24,DPD3-14,232,232,0
2024-08-25,24,DPD30-59,71,71,0
2024-08-25,24,DPD60-89,0,0,0
2024-08-25,24,DPD90+,0,0,0
2024-08-25,26,Current,0,0,0
2024-08-25,26,DPD15-29,9,9,0
2024-08-25,26,DPD3-14,26,26,0
2024-08-25,26,DPD30-59,10,10,0
2024-08-25,26,DPD60-89,0,0,0
2024-08-25,26,DPD90+,0,0,0
2024-08-25,32,Current,0,0,0
2024-08-25,32,DPD15-29,119,119,0
2024-08-25,32,DPD3-14,154,154,0
2024-08-25,32,DPD30-59,53,53,0
2024-08-25,32,DPD60-89,0,0,0
2024-08-25,32,DPD90+,0,0,0
2024-08-25,34,Current,0,0,0
2024-08-25,34,DPD15-29,37,37,0
2024-08-25,34,DPD3-14,66,66,0
2024-08-25,34,DPD30-59,25,25,0
2024-08-25,34,DPD60-89,0,0,0
2024-08-25,34,DPD90+,0,0,0
2024-08-25,36,Current,0,0,0
2024-08-25,36,DPD15-29,15,15,0
2024-08-25,36,DPD3-14,55,55,0
2024-08-25,36,DPD30-59,14,14,0
2024-08-25,36,DPD60-89,0,0,0
2024-08-25,36,DPD90+,0,0,0
2024-08-25,38,Current,16,16,0
2024-08-25,38,DPD15-29,25,25,0
2024-08-25,38,DPD3-14,53,53,0
2024-08-25,38,DPD30-59,16,16,0
2024-08-25,38,DPD60-89,0,0,0
2024-08-25,38,DPD90+,0,0,0
2024-08-25,40,Current,0,0,0
2024-08-25,40,DPD15-29,22,22,0
2024-08-25,40,DPD3-14,22,22,0
2024-08-25,40,DPD30-59,5,5,0
2024-08-25,40,DPD60-89,0,0,0
2024-08-25,40,DPD90+,0,0,0
2024-08-25,42,Current,0,0,0
2024-08-25,42,DPD15-29,9,9,0
2024-08-25,42,DPD3-14,26,26,0
2024-08-25,42,DPD30-59,11,11,0
2024-08-25,42,DPD60-89,0,0,0
2024-08-25,42,DPD90+,0,0,0
2024-08-25,44,Current,0,0,0
2024-08-25,44,DPD15-29,28,28,0
2024-08-25,44,DPD3-14,47,47,0
2024-08-25,44,DPD30-59,16,16,0
2024-08-25,44,DPD60-89,0,0,0
2024-08-25,44,DPD90+,0,0,0
2024-08-25,46,Current,0,0,0
2024-08-25,46,DPD15-29,2,2,0
2024-08-25,48,Current,29,29,0
2024-08-25,48,DPD15-29,24,24,0
2024-08-25,48,DPD3-14,41,41,0
2024-08-25,48,DPD30-59,10,10,0
2024-08-25,48,DPD60-89,0,0,0
2024-08-25,48,DPD90+,0,0,0
2024-08-25,6,Current,0,0,0
2024-08-24,100,Current,0,0,0
2024-08-24,102,Current,0,0,0
2024-08-24,102,DPD3-14,0,0,0
2024-08-24,104,Current,0,0,0
2024-08-24,104,DPD15-29,0,0,0
2024-08-24,104,DPD30-59,0,0,0
2024-08-24,104,DPD90+,0,0,0
2024-08-24,20,Current,0,0,0
2024-08-24,20,DPD15-29,146,146,0
2024-08-24,20,DPD3-14,336,336,0
2024-08-24,20,DPD30-59,40,40,0
2024-08-24,20,DPD60-89,21,21,0
2024-08-24,20,DPD90+,15,15,0
2024-08-24,22,Current,0,0,0
2024-08-24,22,DPD15-29,0,0,0
2024-08-24,22,DPD3-14,0,0,0
2024-08-24,22,DPD30-59,0,0,0
2024-08-24,22,DPD90+,0,0,0
2024-08-24,24,Current,54,54,0
2024-08-24,24,DPD15-29,87,87,0
2024-08-24,24,DPD3-14,231,231,0
2024-08-24,24,DPD30-59,24,24,0
2024-08-24,24,DPD60-89,0,0,0
2024-08-24,24,DPD90+,0,0,0
2024-08-24,26,Current,0,0,0
2024-08-24,26,DPD15-29,9,9,0
2024-08-24,26,DPD3-14,36,36,0
2024-08-24,26,DPD30-59,5,5,0
2024-08-24,26,DPD60-89,0,0,0
2024-08-24,26,DPD90+,0,0,0
2024-08-24,32,Current,0,0,0
2024-08-24,32,DPD15-29,63,63,0
2024-08-24,32,DPD3-14,174,174,0
2024-08-24,32,DPD30-59,23,23,0
2024-08-24,32,DPD60-89,0,0,0
2024-08-24,32,DPD90+,0,0,0
2024-08-24,34,Current,0,0,0
2024-08-24,34,DPD15-29,23,23,0
2024-08-24,34,DPD3-14,84,84,0
2024-08-24,34,DPD30-59,8,8,0
2024-08-24,34,DPD60-89,0,0,0
2024-08-24,34,DPD90+,0,0,0
2024-08-24,36,Current,0,0,0
2024-08-24,36,DPD15-29,21,21,0
2024-08-24,36,DPD3-14,50,50,0
2024-08-24,36,DPD30-59,2,2,0
2024-08-24,36,DPD60-89,0,0,0
2024-08-24,36,DPD90+,0,0,0
2024-08-24,38,Current,15,15,0
2024-08-24,38,DPD15-29,18,18,0
2024-08-24,38,DPD3-14,41,41,0
2024-08-24,38,DPD30-59,2,2,0
2024-08-24,38,DPD60-89,0,0,0
2024-08-24,38,DPD90+,0,0,0
2024-08-24,40,Current,0,0,0
2024-08-24,40,DPD15-29,10,10,0
2024-08-24,40,DPD3-14,35,35,0
2024-08-24,40,DPD30-59,3,3,0
2024-08-24,40,DPD60-89,0,0,0
2024-08-24,40,DPD90+,0,0,0
2024-08-24,42,Current,0,0,0
2024-08-24,42,DPD15-29,7,7,0
2024-08-24,42,DPD3-14,12,12,0
2024-08-24,42,DPD30-59,3,3,0
2024-08-24,42,DPD60-89,0,0,0
2024-08-24,42,DPD90+,0,0,0
2024-08-24,44,Current,0,0,0
2024-08-24,44,DPD15-29,15,15,0
2024-08-24,44,DPD3-14,56,56,0
2024-08-24,44,DPD30-59,5,5,0
2024-08-24,44,DPD60-89,0,0,0
2024-08-24,44,DPD90+,0,0,0
2024-08-24,46,Current,0,0,0
2024-08-24,46,DPD15-29,0,0,0
2024-08-24,48,Current,27,27,0
2024-08-24,48,DPD15-29,11,11,0
2024-08-24,48,DPD3-14,48,48,0
2024-08-24,48,DPD30-59,2,2,0
2024-08-24,48,DPD60-89,0,0,0
2024-08-24,48,DPD90+,0,0,0
2024-08-24,6,Current,0,0,0
2024-08-23,100,Current,0,0,0
2024-08-23,102,Current,0,0,0
2024-08-23,102,DPD3-14,0,0,0
2024-08-23,104,Current,0,0,0
2024-08-23,104,DPD15-29,0,0,0
2024-08-23,104,DPD30-59,0,0,0
2024-08-23,104,DPD90+,0,0,0
2024-08-23,20,Current,1,1,0
2024-08-23,20,DPD15-29,227,227,0
2024-08-23,20,DPD3-14,346,346,0
2024-08-23,20,DPD30-59,65,65,0
2024-08-23,20,DPD60-89,42,42,0
2024-08-23,20,DPD90+,39,39,0
2024-08-23,22,Current,0,0,0
2024-08-23,22,DPD15-29,1,1,0
2024-08-23,22,DPD3-14,1,1,0
2024-08-23,22,DPD30-59,0,0,0
2024-08-23,22,DPD90+,0,0,0
2024-08-23,24,Current,59,59,0
2024-08-23,24,DPD15-29,108,108,0
2024-08-23,24,DPD3-14,223,223,0
2024-08-23,24,DPD30-59,34,34,0
2024-08-23,24,DPD60-89,0,0,0
2024-08-23,24,DPD90+,0,0,0
2024-08-23,26,Current,0,0,0
2024-08-23,26,DPD15-29,12,12,0
2024-08-23,26,DPD3-14,27,27,0
2024-08-23,26,DPD30-59,5,5,0
2024-08-23,26,DPD60-89,0,0,0
2024-08-23,26,DPD90+,0,0,0
2024-08-23,32,Current,0,0,0
2024-08-23,32,DPD15-29,120,120,0
2024-08-23,32,DPD3-14,156,156,0
2024-08-23,32,DPD30-59,26,26,0
2024-08-23,32,DPD60-89,0,0,0
2024-08-23,32,DPD90+,0,0,0
2024-08-23,34,Current,0,0,0
2024-08-23,34,DPD15-29,45,45,0
2024-08-23,34,DPD3-14,65,65,0
2024-08-23,34,DPD30-59,13,13,0
2024-08-23,34,DPD60-89,0,0,0
2024-08-23,34,DPD90+,0,0,0
2024-08-23,36,Current,0,0,0
2024-08-23,36,DPD15-29,23,23,0
2024-08-23,36,DPD3-14,50,50,0
2024-08-23,36,DPD30-59,8,8,0
2024-08-23,36,DPD60-89,0,0,0
2024-08-23,36,DPD90+,0,0,0
2024-08-23,38,Current,19,19,0
2024-08-23,38,DPD15-29,27,27,0
2024-08-23,38,DPD3-14,43,43,0
2024-08-23,38,DPD30-59,7,7,0
2024-08-23,38,DPD60-89,0,0,0
2024-08-23,38,DPD90+,0,0,0
2024-08-23,40,Current,0,0,0
2024-08-23,40,DPD15-29,15,15,0
2024-08-23,40,DPD3-14,25,25,0
2024-08-23,40,DPD30-59,17,17,0
2024-08-23,40,DPD60-89,0,0,0
2024-08-23,40,DPD90+,0,0,0
2024-08-23,42,Current,0,0,0
2024-08-23,42,DPD15-29,13,13,0
2024-08-23,42,DPD3-14,28,28,0
2024-08-23,42,DPD30-59,4,4,0
2024-08-23,42,DPD60-89,0,0,0
2024-08-23,42,DPD90+,0,0,0
2024-08-23,44,Current,0,0,0
2024-08-23,44,DPD15-29,28,28,0
2024-08-23,44,DPD3-14,43,43,0
2024-08-23,44,DPD30-59,8,8,0
2024-08-23,44,DPD60-89,0,0,0
2024-08-23,44,DPD90+,0,0,0
2024-08-23,46,Current,0,0,0
2024-08-23,46,DPD15-29,2,2,0
2024-08-23,48,Current,27,27,0
2024-08-23,48,DPD15-29,24,24,0
2024-08-23,48,DPD3-14,42,42,0
2024-08-23,48,DPD30-59,6,6,0
2024-08-23,48,DPD60-89,0,0,0
2024-08-23,48,DPD90+,0,0,0
2024-08-23,6,Current,0,0,0
2024-08-22,100,Current,0,0,0
2024-08-22,100,DPD15-29,0,0,0
2024-08-22,102,Current,0,0,0
2024-08-22,104,Current,0,0,0
2024-08-22,104,DPD15-29,0,0,0
2024-08-22,104,DPD30-59,0,0,0
2024-08-22,104,DPD90+,0,0,0
2024-08-22,20,Current,0,0,0
2024-08-22,20,DPD15-29,170,170,0
2024-08-22,20,DPD3-14,308,308,0
2024-08-22,20,DPD30-59,160,160,0
2024-08-22,20,DPD60-89,15,15,0
2024-08-22,20,DPD90+,6,6,0
2024-08-22,22,Current,0,0,0
2024-08-22,22,DPD15-29,0,0,0
2024-08-22,22,DPD3-14,0,0,0
2024-08-22,22,DPD30-59,1,1,0
2024-08-22,22,DPD90+,0,0,0
2024-08-22,24,Current,37,37,0
2024-08-22,24,DPD15-29,84,84,0
2024-08-22,24,DPD3-14,218,218,0
2024-08-22,24,DPD30-59,74,74,0
2024-08-22,24,DPD60-89,0,0,0
2024-08-22,24,DPD90+,0,0,0
2024-08-22,26,Current,0,0,0
2024-08-22,26,DPD15-29,13,13,0
2024-08-22,26,DPD3-14,23,23,0
2024-08-22,26,DPD30-59,5,5,0
2024-08-22,26,DPD60-89,0,0,0
2024-08-22,26,DPD90+,0,0,0
2024-08-22,32,Current,0,0,0
2024-08-22,32,DPD15-29,63,63,0
2024-08-22,32,DPD3-14,150,150,0
2024-08-22,32,DPD30-59,60,60,0
2024-08-22,32,DPD60-89,0,0,0
2024-08-22,32,DPD90+,0,0,0
2024-08-22,34,Current,0,0,0
2024-08-22,34,DPD15-29,27,27,0
2024-08-22,34,DPD3-14,70,70,0
2024-08-22,34,DPD30-59,32,32,0
2024-08-22,34,DPD60-89,0,0,0
2024-08-22,34,DPD90+,0,0,0
2024-08-22,36,Current,0,0,0
2024-08-22,36,DPD15-29,22,22,0
2024-08-22,36,DPD3-14,37,37,0
2024-08-22,36,DPD30-59,24,24,0
2024-08-22,36,DPD60-89,0,0,0
2024-08-22,36,DPD90+,0,0,0
2024-08-22,38,Current,8,8,0
2024-08-22,38,DPD15-29,22,22,0
2024-08-22,38,DPD3-14,38,38,0
2024-08-22,38,DPD30-59,19,19,0
2024-08-22,38,DPD60-89,0,0,0
2024-08-22,38,DPD90+,0,0,0
2024-08-22,40,Current,0,0,0
2024-08-22,40,DPD15-29,11,11,0
2024-08-22,40,DPD3-14,28,28,0
2024-08-22,40,DPD30-59,6,6,0
2024-08-22,40,DPD60-89,0,0,0
2024-08-22,40,DPD90+,0,0,0
2024-08-22,42,Current,0,0,0
2024-08-22,42,DPD15-29,9,9,0
2024-08-22,42,DPD3-14,14,14,0
2024-08-22,42,DPD30-59,11,11,0
2024-08-22,42,DPD60-89,0,0,0
2024-08-22,42,DPD90+,0,0,0
2024-08-22,44,Current,0,0,0
2024-08-22,44,DPD15-29,15,15,0
2024-08-22,44,DPD3-14,61,61,0
2024-08-22,44,DPD30-59,22,22,0
2024-08-22,44,DPD60-89,0,0,0
2024-08-22,44,DPD90+,0,0,0
2024-08-22,46,Current,0,0,0
2024-08-22,46,DPD15-29,0,0,0
2024-08-22,48,Current,21,21,0
2024-08-22,48,DPD15-29,10,10,0
2024-08-22,48,DPD3-14,49,49,0
2024-08-22,48,DPD30-59,11,11,0
2024-08-22,48,DPD60-89,0,0,0
2024-08-22,48,DPD90+,0,0,0
2024-08-22,6,Current,0,0,0
2024-08-21,100,Current,0,0,0
2024-08-21,100,DPD15-29,0,0,0
2024-08-21,102,Current,0,0,0
2024-08-21,104,Current,0,0,0
2024-08-21,104,DPD15-29,0,0,0
2024-08-21,104,DPD30-59,0,0,0
2024-08-21,104,DPD90+,0,0,0
2024-08-21,20,Current,0,0,0
2024-08-21,20,DPD15-29,246,246,0
2024-08-21,20,DPD3-14,353,353,0
2024-08-21,20,DPD30-59,132,132,0
2024-08-21,20,DPD60-89,40,40,0
2024-08-21,20,DPD90+,35,35,0
2024-08-21,22,Current,0,0,0
2024-08-21,22,DPD15-29,1,1,0
2024-08-21,22,DPD30-59,0,0,0
2024-08-21,22,DPD90+,0,0,0
2024-08-21,24,Current,41,41,0
2024-08-21,24,DPD15-29,119,119,0
2024-08-21,24,DPD3-14,208,208,0
2024-08-21,24,DPD30-59,68,68,0
2024-08-21,24,DPD60-89,0,0,0
2024-08-21,24,DPD90+,0,0,0
2024-08-21,26,Current,0,0,0
2024-08-21,26,DPD15-29,14,14,0
2024-08-21,26,DPD3-14,28,28,0
2024-08-21,26,DPD30-59,10,10,0
2024-08-21,26,DPD60-89,0,0,0
2024-08-21,26,DPD90+,0,0,0
2024-08-21,32,Current,0,0,0
2024-08-21,32,DPD15-29,119,119,0
2024-08-21,32,DPD3-14,156,156,0
2024-08-21,32,DPD30-59,61,61,0
2024-08-21,32,DPD60-89,0,0,0
2024-08-21,32,DPD90+,0,0,0
2024-08-21,34,Current,0,0,0
2024-08-21,34,DPD15-29,44,44,0
2024-08-21,34,DPD3-14,56,56,0
2024-08-21,34,DPD30-59,22,22,0
2024-08-21,34,DPD60-89,0,0,0
2024-08-21,34,DPD90+,0,0,0
2024-08-21,36,Current,0,0,0
2024-08-21,36,DPD15-29,26,26,0
2024-08-21,36,DPD3-14,48,48,0
2024-08-21,36,DPD30-59,19,19,0
2024-08-21,36,DPD60-89,0,0,0
2024-08-21,36,DPD90+,0,0,0
2024-08-21,38,Current,9,9,0
2024-08-21,38,DPD15-29,27,27,0
2024-08-21,38,DPD3-14,45,45,0
2024-08-21,38,DPD30-59,16,16,0
2024-08-21,38,DPD60-89,0,0,0
2024-08-21,38,DPD90+,0,0,0
2024-08-21,40,Current,0,0,0
2024-08-21,40,DPD15-29,14,14,0
2024-08-21,40,DPD3-14,24,24,0
2024-08-21,40,DPD30-59,7,7,0
2024-08-21,40,DPD60-89,0,0,0
2024-08-21,40,DPD90+,0,0,0
2024-08-21,42,Current,0,0,0
2024-08-21,42,DPD15-29,13,13,0
2024-08-21,42,DPD3-14,21,21,0
2024-08-21,42,DPD30-59,9,9,0
2024-08-21,42,DPD60-89,0,0,0
2024-08-21,42,DPD90+,0,0,0
2024-08-21,44,Current,0,0,0
2024-08-21,44,DPD15-29,23,23,0
2024-08-21,44,DPD3-14,39,39,0
2024-08-21,44,DPD30-59,19,19,0
2024-08-21,44,DPD60-89,0,0,0
2024-08-21,44,DPD90+,0,0,0
2024-08-21,46,Current,0,0,0
2024-08-21,46,DPD15-29,1,1,0
2024-08-21,46,DPD3-14,1,1,0
2024-08-21,48,Current,21,21,0
2024-08-21,48,DPD15-29,23,23,0
2024-08-21,48,DPD3-14,35,35,0
2024-08-21,48,DPD30-59,10,10,0
2024-08-21,48,DPD60-89,0,0,0
2024-08-21,48,DPD90+,0,0,0
2024-08-21,6,Current,0,0,0
2024-08-20,100,Current,0,0,0
2024-08-20,100,DPD15-29,0,0,0
2024-08-20,102,Current,0,0,0
2024-08-20,102,DPD60-89,0,0,0
2024-08-20,104,Current,0,0,0
2024-08-20,104,DPD15-29,0,0,0
2024-08-20,104,DPD90+,0,0,0
2024-08-20,20,Current,0,0,0
2024-08-20,20,DPD15-29,177,177,0
2024-08-20,20,DPD3-14,332,332,0
2024-08-20,20,DPD30-59,34,34,0
2024-08-20,20,DPD60-89,8,8,0
2024-08-20,20,DPD90+,5,5,0
2024-08-20,22,Current,0,0,0
2024-08-20,22,DPD15-29,1,1,0
2024-08-20,22,DPD30-59,0,0,0
2024-08-20,22,DPD90+,0,0,0
2024-08-20,24,Current,42,42,0
2024-08-20,24,DPD15-29,95,95,0
2024-08-20,24,DPD3-14,245,245,0
2024-08-20,24,DPD30-59,27,27,0
2024-08-20,24,DPD60-89,0,0,0
2024-08-20,24,DPD90+,0,0,0
2024-08-20,26,Current,0,0,0
2024-08-20,26,DPD15-29,15,15,0
2024-08-20,26,DPD3-14,25,25,0
2024-08-20,26,DPD30-59,4,4,0
2024-08-20,26,DPD60-89,0,0,0
2024-08-20,26,DPD90+,0,0,0
2024-08-20,32,Current,0,0,0
2024-08-20,32,DPD15-29,79,79,0
2024-08-20,32,DPD3-14,164,164,0
2024-08-20,32,DPD30-59,19,19,0
2024-08-20,32,DPD60-89,0,0,0
2024-08-20,32,DPD90+,0,0,0
2024-08-20,34,Current,0,0,0
2024-08-20,34,DPD15-29,29,29,0
2024-08-20,34,DPD3-14,62,62,0
2024-08-20,34,DPD30-59,8,8,0
2024-08-20,34,DPD60-89,0,0,0
2024-08-20,34,DPD90+,0,0,0
2024-08-20,36,Current,0,0,0
2024-08-20,36,DPD15-29,24,24,0
2024-08-20,36,DPD3-14,33,33,0
2024-08-20,36,DPD30-59,4,4,0
2024-08-20,36,DPD60-89,0,0,0
2024-08-20,36,DPD90+,0,0,0
2024-08-20,38,Current,7,7,0
2024-08-20,38,DPD15-29,17,17,0
2024-08-20,38,DPD3-14,48,48,0
2024-08-20,38,DPD30-59,3,3,0
2024-08-20,38,DPD60-89,0,0,0
2024-08-20,38,DPD90+,0,0,0
2024-08-20,40,Current,0,0,0
2024-08-20,40,DPD15-29,13,13,0
2024-08-20,40,DPD3-14,29,29,0
2024-08-20,40,DPD30-59,5,5,0
2024-08-20,40,DPD60-89,0,0,0
2024-08-20,40,DPD90+,0,0,0
2024-08-20,42,Current,0,0,0
2024-08-20,42,DPD15-29,10,10,0
2024-08-20,42,DPD3-14,15,15,0
2024-08-20,42,DPD30-59,2,2,0
2024-08-20,42,DPD60-89,0,0,0
2024-08-20,42,DPD90+,0,0,0
2024-08-20,44,Current,0,0,0
2024-08-20,44,DPD15-29,15,15,0
2024-08-20,44,DPD3-14,66,66,0
2024-08-20,44,DPD30-59,4,4,0
2024-08-20,44,DPD60-89,0,0,0
2024-08-20,44,DPD90+,0,0,0
2024-08-20,46,Current,0,0,0
2024-08-20,46,DPD15-29,0,0,0
2024-08-20,46,DPD3-14,0,0,0
2024-08-20,48,Current,22,22,0
2024-08-20,48,DPD15-29,17,17,0
2024-08-20,48,DPD3-14,46,46,0
2024-08-20,48,DPD30-59,4,4,0
2024-08-20,48,DPD60-89,0,0,0
2024-08-20,48,DPD90+,0,0,0
2024-08-20,6,Current,0,0,0
2024-08-19,100,Current,0,0,0
2024-08-19,100,DPD15-29,0,0,0
2024-08-19,102,Current,0,0,0
2024-08-19,102,DPD3-14,1,1,0
2024-08-19,102,DPD60-89,0,0,0
2024-08-19,104,Current,0,0,0
2024-08-19,104,DPD15-29,0,0,0
2024-08-19,104,DPD3-14,0,0,0
2024-08-19,104,DPD90+,0,0,0
2024-08-19,20,Current,0,0,0
2024-08-19,20,DPD15-29,260,260,0
2024-08-19,20,DPD3-14,425,425,0
2024-08-19,20,DPD30-59,62,62,0
2024-08-19,20,DPD60-89,65,65,0
2024-08-19,20,DPD90+,77,77,0
2024-08-19,22,Current,0,0,0
2024-08-19,22,DPD15-29,1,1,0
2024-08-19,22,DPD30-59,0,0,0
2024-08-19,22,DPD90+,0,0,0
2024-08-19,24,Current,111,111,0
2024-08-19,24,DPD15-29,147,147,0
2024-08-19,24,DPD3-14,229,229,0
2024-08-19,24,DPD30-59,44,44,0
2024-08-19,24,DPD60-89,0,0,0
2024-08-19,24,DPD90+,0,0,0
2024-08-19,26,Current,0,0,0
2024-08-19,26,DPD15-29,19,19,0
2024-08-19,26,DPD3-14,38,38,0
2024-08-19,26,DPD30-59,4,4,0
2024-08-19,26,DPD60-89,0,0,0
2024-08-19,26,DPD90+,0,0,0
2024-08-19,32,Current,0,0,0
2024-08-19,32,DPD15-29,138,138,0
2024-08-19,32,DPD3-14,170,170,0
2024-08-19,32,DPD30-59,26,26,0
2024-08-19,32,DPD60-89,0,0,0
2024-08-19,32,DPD90+,0,0,0
2024-08-19,34,Current,0,0,0
2024-08-19,34,DPD15-29,45,45,0
2024-08-19,34,DPD3-14,73,73,0
2024-08-19,34,DPD30-59,18,18,0
2024-08-19,34,DPD60-89,0,0,0
2024-08-19,34,DPD90+,0,0,0
2024-08-19,36,Current,0,0,0
2024-08-19,36,DPD15-29,40,40,0
2024-08-19,36,DPD3-14,54,54,0
2024-08-19,36,DPD30-59,6,6,0
2024-08-19,36,DPD60-89,0,0,0
2024-08-19,36,DPD90+,0,0,0
2024-08-19,38,Current,11,11,0
2024-08-19,38,DPD15-29,27,27,0
2024-08-19,38,DPD3-14,59,59,0
2024-08-19,38,DPD30-59,11,11,0
2024-08-19,38,DPD60-89,0,0,0
2024-08-19,38,DPD90+,0,0,0
2024-08-19,40,Current,0,0,0
2024-08-19,40,DPD15-29,17,17,0
2024-08-19,40,DPD3-14,33,33,0
2024-08-19,40,DPD30-59,19,19,0
2024-08-19,40,DPD60-89,0,0,0
2024-08-19,40,DPD90+,0,0,0
2024-08-19,42,Current,0,0,0
2024-08-19,42,DPD15-29,17,17,0
2024-08-19,42,DPD3-14,30,30,0
2024-08-19,42,DPD30-59,4,4,0
2024-08-19,42,DPD60-89,0,0,0
2024-08-19,42,DPD90+,0,0,0
2024-08-19,44,Current,0,0,0
2024-08-19,44,DPD15-29,25,25,0
2024-08-19,44,DPD3-14,51,51,0
2024-08-19,44,DPD30-59,10,10,0
2024-08-19,44,DPD60-89,0,0,0
2024-08-19,44,DPD90+,0,0,0
2024-08-19,46,Current,0,0,0
2024-08-19,46,DPD15-29,1,1,0
2024-08-19,46,DPD3-14,1,1,0
2024-08-19,48,Current,93,93,0
2024-08-19,48,DPD15-29,22,22,0
2024-08-19,48,DPD3-14,52,52,0
2024-08-19,48,DPD30-59,5,5,0
2024-08-19,48,DPD60-89,0,0,0
2024-08-19,48,DPD90+,0,0,0
2024-08-19,6,Current,0,0,0
2024-08-18,100,Current,0,0,0
2024-08-18,100,DPD15-29,0,0,0
2024-08-18,100,DPD3-14,0,0,0
2024-08-18,102,Current,0,0,0
2024-08-18,102,DPD3-14,0,0,0
2024-08-18,102,DPD60-89,0,0,0
2024-08-18,104,Current,0,0,0
2024-08-18,104,DPD15-29,0,0,0
2024-08-18,104,DPD3-14,0,0,0
2024-08-18,104,DPD90+,0,0,0
2024-08-18,20,Current,0,0,0
2024-08-18,20,DPD15-29,184,184,0
2024-08-18,20,DPD3-14,232,232,0
2024-08-18,20,DPD30-59,176,176,0
2024-08-18,20,DPD60-89,24,24,0
2024-08-18,20,DPD90+,0,0,0
2024-08-18,22,Current,0,0,0
2024-08-18,22,DPD15-29,1,1,0
2024-08-18,22,DPD30-59,0,0,0
2024-08-18,22,DPD60-89,0,0,0
2024-08-18,22,DPD90+,0,0,0
2024-08-18,24,Current,69,69,0
2024-08-18,24,DPD15-29,95,95,0
2024-08-18,24,DPD3-14,186,186,0
2024-08-18,24,DPD30-59,85,85,0
2024-08-18,24,DPD60-89,0,0,0
2024-08-18,24,DPD90+,0,0,0
2024-08-18,26,Current,0,0,0
2024-08-18,26,DPD15-29,21,21,0
2024-08-18,26,DPD3-14,15,15,0
2024-08-18,26,DPD30-59,6,6,0
2024-08-18,26,DPD60-89,0,0,0
2024-08-18,26,DPD90+,0,0,0
2024-08-18,32,Current,0,0,0
2024-08-18,32,DPD15-29,92,92,0
2024-08-18,32,DPD3-14,110,110,0
2024-08-18,32,DPD30-59,74,74,0
2024-08-18,32,DPD60-89,0,0,0
2024-08-18,32,DPD90+,0,0,0
2024-08-18,34,Current,0,0,0
2024-08-18,34,DPD15-29,25,25,0
2024-08-18,34,DPD3-14,54,54,0
2024-08-18,34,DPD30-59,38,38,0
2024-08-18,34,DPD60-89,0,0,0
2024-08-18,34,DPD90+,0,0,0
2024-08-18,36,Current,0,0,0
2024-08-18,36,DPD15-29,20,20,0
2024-08-18,36,DPD3-14,24,24,0
2024-08-18,36,DPD30-59,23,23,0
2024-08-18,36,DPD60-89,0,0,0
2024-08-18,36,DPD90+,0,0,0
2024-08-18,38,Current,23,23,0
2024-08-18,38,DPD15-29,20,20,0
2024-08-18,38,DPD3-14,29,29,0
2024-08-18,38,DPD30-59,21,21,0
2024-08-18,38,DPD60-89,0,0,0
2024-08-18,38,DPD90+,0,0,0
2024-08-18,40,Current,0,0,0
2024-08-18,40,DPD15-29,11,11,0
2024-08-18,40,DPD3-14,19,19,0
2024-08-18,40,DPD30-59,5,5,0
2024-08-18,40,DPD60-89,0,0,0
2024-08-18,40,DPD90+,0,0,0
2024-08-18,42,Current,0,0,0
2024-08-18,42,DPD15-29,10,10,0
2024-08-18,42,DPD3-14,13,13,0
2024-08-18,42,DPD30-59,12,12,0
2024-08-18,42,DPD60-89,0,0,0
2024-08-18,42,DPD90+,0,0,0
2024-08-18,44,Current,0,0,0
2024-08-18,44,DPD15-29,20,20,0
2024-08-18,44,DPD3-14,40,40,0
2024-08-18,44,DPD30-59,21,21,0
2024-08-18,44,DPD60-89,0,0,0
2024-08-18,44,DPD90+,0,0,0
2024-08-18,46,Current,0,0,0
2024-08-18,46,DPD15-29,0,0,0
2024-08-18,46,DPD3-14,0,0,0
2024-08-18,48,Current,38,38,0
2024-08-18,48,DPD15-29,13,13,0
2024-08-18,48,DPD3-14,37,37,0
2024-08-18,48,DPD30-59,13,13,0
2024-08-18,48,DPD60-89,0,0,0
2024-08-18,48,DPD90+,0,0,0
2024-08-18,6,Current,0,0,0
2024-08-17,100,Current,0,0,0
2024-08-17,100,DPD3-14,0,0,0
2024-08-17,102,Current,0,0,0
2024-08-17,102,DPD60-89,0,0,0
2024-08-17,104,Current,0,0,0
2024-08-17,104,DPD15-29,0,0,0
2024-08-17,104,DPD3-14,0,0,0
2024-08-17,104,DPD90+,0,0,0
2024-08-17,20,Current,0,0,0
2024-08-17,20,DPD15-29,254,254,0
2024-08-17,20,DPD3-14,253,253,0
2024-08-17,20,DPD30-59,126,126,0
2024-08-17,20,DPD60-89,59,59,0
2024-08-17,20,DPD90+,20,20,0
2024-08-17,22,Current,0,0,0
2024-08-17,22,DPD15-29,1,1,0
2024-08-17,22,DPD30-59,0,0,0
2024-08-17,22,DPD60-89,0,0,0
2024-08-17,22,DPD90+,0,0,0
2024-08-17,24,Current,35,35,0
2024-08-17,24,DPD15-29,138,138,0
2024-08-17,24,DPD3-14,146,146,0
2024-08-17,24,DPD30-59,63,63,0
2024-08-17,24,DPD60-89,0,0,0
2024-08-17,24,DPD90+,0,0,0
2024-08-17,26,Current,0,0,0
2024-08-17,26,DPD15-29,17,17,0
2024-08-17,26,DPD3-14,19,19,0
2024-08-17,26,DPD30-59,9,9,0
2024-08-17,26,DPD60-89,0,0,0
2024-08-17,26,DPD90+,0,0,0
2024-08-17,32,Current,0,0,0
2024-08-17,32,DPD15-29,127,127,0
2024-08-17,32,DPD3-14,114,114,0
2024-08-17,32,DPD30-59,53,53,0
2024-08-17,32,DPD60-89,0,0,0
2024-08-17,32,DPD90+,0,0,0
2024-08-17,34,Current,0,0,0
2024-08-17,34,DPD15-29,50,50,0
2024-08-17,34,DPD3-14,44,44,0
2024-08-17,34,DPD30-59,19,19,0
2024-08-17,34,DPD60-89,0,0,0
2024-08-17,34,DPD90+,0,0,0
2024-08-17,36,Current,0,0,0
2024-08-17,36,DPD15-29,40,40,0
2024-08-17,36,DPD3-14,27,27,0
2024-08-17,36,DPD30-59,17,17,0
2024-08-17,36,DPD60-89,0,0,0
2024-08-17,36,DPD90+,0,0,0
2024-08-17,38,Current,17,17,0
2024-08-17,38,DPD15-29,31,31,0
2024-08-17,38,DPD3-14,28,28,0
2024-08-17,38,DPD30-59,16,16,0
2024-08-17,38,DPD60-89,0,0,0
2024-08-17,38,DPD90+,0,0,0
2024-08-17,40,Current,0,0,0
2024-08-17,40,DPD15-29,16,16,0
2024-08-17,40,DPD3-14,20,20,0
2024-08-17,40,DPD30-59,9,9,0
2024-08-17,40,DPD60-89,0,0,0
2024-08-17,40,DPD90+,0,0,0
2024-08-17,42,Current,0,0,0
2024-08-17,42,DPD15-29,16,16,0
2024-08-17,42,DPD3-14,14,14,0
2024-08-17,42,DPD30-59,7,7,0
2024-08-17,42,DPD60-89,0,0,0
2024-08-17,42,DPD90+,0,0,0
2024-08-17,44,Current,0,0,0
2024-08-17,44,DPD15-29,28,28,0
2024-08-17,44,DPD3-14,22,22,0
2024-08-17,44,DPD30-59,17,17,0
2024-08-17,44,DPD60-89,0,0,0
2024-08-17,44,DPD90+,0,0,0
2024-08-17,46,Current,0,0,0
2024-08-17,46,DPD15-29,1,1,0
2024-08-17,46,DPD3-14,1,1,0
2024-08-17,48,Current,32,32,0
2024-08-17,48,DPD15-29,20,20,0
2024-08-17,48,DPD3-14,38,38,0
2024-08-17,48,DPD30-59,12,12,0
2024-08-17,48,DPD60-89,0,0,0
2024-08-17,48,DPD90+,0,0,0
2024-08-17,6,Current,0,0,0
2024-08-16,100,Current,0,0,0
2024-08-16,100,DPD3-14,0,0,0
2024-08-16,102,Current,0,0,0
2024-08-16,102,DPD60-89,0,0,0
2024-08-16,104,Current,0,0,0
2024-08-16,104,DPD15-29,0,0,0
2024-08-16,104,DPD3-14,0,0,0
2024-08-16,104,DPD90+,0,0,0
2024-08-16,20,Current,0,0,0
2024-08-16,20,DPD15-29,170,170,0
2024-08-16,20,DPD3-14,243,243,0
2024-08-16,20,DPD30-59,27,27,0
2024-08-16,20,DPD60-89,29,29,0
2024-08-16,20,DPD90+,11,11,0
2024-08-16,22,Current,0,0,0
2024-08-16,22,DPD15-29,1,1,0
2024-08-16,22,DPD30-59,0,0,0
2024-08-16,22,DPD60-89,0,0,0
2024-08-16,22,DPD90+,0,0,0
2024-08-16,24,Current,60,60,0
2024-08-16,24,DPD15-29,81,81,0
2024-08-16,24,DPD3-14,189,189,0
2024-08-16,24,DPD30-59,27,27,0
2024-08-16,24,DPD60-89,0,0,0
2024-08-16,24,DPD90+,0,0,0
2024-08-16,26,Current,0,0,0
2024-08-16,26,DPD15-29,19,19,0
2024-08-16,26,DPD3-14,15,15,0
2024-08-16,26,DPD30-59,2,2,0
2024-08-16,26,DPD60-89,0,0,0
2024-08-16,26,DPD90+,0,0,0
2024-08-16,32,Current,0,0,0
2024-08-16,32,DPD15-29,87,87,0
2024-08-16,32,DPD3-14,107,107,0
2024-08-16,32,DPD30-59,23,23,0
2024-08-16,32,DPD60-89,0,0,0
2024-08-16,32,DPD90+,0,0,0
2024-08-16,34,Current,0,0,0
2024-08-16,34,DPD15-29,32,32,0
2024-08-16,34,DPD3-14,45,45,0
2024-08-16,34,DPD30-59,8,8,0
2024-08-16,34,DPD60-89,0,0,0
2024-08-16,34,DPD90+,0,0,0
2024-08-16,36,Current,0,0,0
2024-08-16,36,DPD15-29,21,21,0
2024-08-16,36,DPD3-14,30,30,0
2024-08-16,36,DPD30-59,3,3,0
2024-08-16,36,DPD60-89,0,0,0
2024-08-16,36,DPD90+,0,0,0
2024-08-16,38,Current,20,20,0
2024-08-16,38,DPD15-29,21,21,0
2024-08-16,38,DPD3-14,30,30,0
2024-08-16,38,DPD30-59,2,2,0
2024-08-16,38,DPD60-89,0,0,0
2024-08-16,38,DPD90+,0,0,0
2024-08-16,40,Current,0,0,0
2024-08-16,40,DPD15-29,14,14,0
2024-08-16,40,DPD3-14,18,18,0
2024-08-16,40,DPD30-59,4,4,0
2024-08-16,40,DPD60-89,0,0,0
2024-08-16,40,DPD90+,0,0,0
2024-08-16,42,Current,0,0,0
2024-08-16,42,DPD15-29,10,10,0
2024-08-16,42,DPD3-14,16,16,0
2024-08-16,42,DPD30-59,2,2,0
2024-08-16,42,DPD60-89,0,0,0
2024-08-16,42,DPD90+,0,0,0
2024-08-16,44,Current,0,0,0
2024-08-16,44,DPD15-29,25,25,0
2024-08-16,44,DPD3-14,34,34,0
2024-08-16,44,DPD30-59,7,7,0
2024-08-16,44,DPD60-89,0,0,0
2024-08-16,44,DPD90+,0,0,0
2024-08-16,46,Current,0,0,0
2024-08-16,46,DPD15-29,0,0,0
2024-08-16,46,DPD3-14,0,0,0
2024-08-16,48,Current,29,29,0
2024-08-16,48,DPD15-29,14,14,0
2024-08-16,48,DPD3-14,35,35,0
2024-08-16,48,DPD30-59,4,4,0
2024-08-16,48,DPD60-89,0,0,0
2024-08-16,48,DPD90+,0,0,0
2024-08-16,6,Current,0,0,0
2024-08-15,100,Current,0,0,0
2024-08-15,100,DPD3-14,0,0,0
2024-08-15,102,Current,0,0,0
2024-08-15,102,DPD3-14,0,0,0
2024-08-15,102,DPD60-89,0,0,0
2024-08-15,104,Current,0,0,0
2024-08-15,104,DPD15-29,0,0,0
2024-08-15,104,DPD3-14,0,0,0
2024-08-15,104,DPD90+,0,0,0
2024-08-15,20,Current,4362,4362,0
2024-08-15,20,DPD15-29,327,327,0
2024-08-15,20,DPD3-14,362,362,0
2024-08-15,20,DPD30-59,247,247,0
2024-08-15,20,DPD60-89,89,89,0
2024-08-15,20,DPD90+,63,63,0
2024-08-15,22,Current,0,0,0
2024-08-15,22,DPD15-29,2,2,0
2024-08-15,22,DPD30-59,0,0,0
2024-08-15,22,DPD60-89,0,0,0
2024-08-15,22,DPD90+,0,0,0
2024-08-15,24,Current,4221,4221,0
2024-08-15,24,DPD15-29,182,182,0
2024-08-15,24,DPD3-14,214,214,0
2024-08-15,24,DPD30-59,114,114,0
2024-08-15,24,DPD60-89,15,15,0
2024-08-15,24,DPD90+,8,8,0
2024-08-15,26,Current,0,0,0
2024-08-15,26,DPD15-29,19,19,0
2024-08-15,26,DPD3-14,20,20,0
2024-08-15,26,DPD30-59,9,9,0
2024-08-15,26,DPD60-89,0,0,0
2024-08-15,26,DPD90+,0,0,0
2024-08-15,32,Current,229,229,0
2024-08-15,32,DPD15-29,140,140,0
2024-08-15,32,DPD3-14,145,145,0
2024-08-15,32,DPD30-59,81,81,0
2024-08-15,32,DPD60-89,4,4,0
2024-08-15,32,DPD90+,0,0,0
2024-08-15,34,Current,0,0,0
2024-08-15,34,DPD15-29,55,55,0
2024-08-15,34,DPD3-14,41,41,0
2024-08-15,34,DPD30-59,41,41,0
2024-08-15,34,DPD60-89,0,0,0
2024-08-15,34,DPD90+,0,0,0
2024-08-15,36,Current,242,242,0
2024-08-15,36,DPD15-29,44,44,0
2024-08-15,36,DPD3-14,30,30,0
2024-08-15,36,DPD30-59,26,26,0
2024-08-15,36,DPD60-89,1,1,0
2024-08-15,36,DPD90+,3,3,0
2024-08-15,38,Current,8,8,0
2024-08-15,38,DPD15-29,36,36,0
2024-08-15,38,DPD3-14,32,32,0
2024-08-15,38,DPD30-59,27,27,0
2024-08-15,38,DPD60-89,0,0,0
2024-08-15,38,DPD90+,0,0,0
2024-08-15,40,Current,268,268,0
2024-08-15,40,DPD15-29,21,21,0
2024-08-15,40,DPD3-14,29,29,0
2024-08-15,40,DPD30-59,9,9,0
2024-08-15,40,DPD60-89,2,2,0
2024-08-15,40,DPD90+,1,1,0
2024-08-15,42,Current,0,0,0
2024-08-15,42,DPD15-29,17,17,0
2024-08-15,42,DPD3-14,14,14,0
2024-08-15,42,DPD30-59,11,11,0
2024-08-15,42,DPD60-89,0,0,0
2024-08-15,42,DPD90+,0,0,0
2024-08-15,44,Current,166,166,0
2024-08-15,44,DPD15-29,27,27,0
2024-08-15,44,DPD3-14,40,40,0
2024-08-15,44,DPD30-59,25,25,0
2024-08-15,44,DPD60-89,1,1,0
2024-08-15,44,DPD90+,2,2,0
2024-08-15,46,Current,4,4,0
2024-08-15,46,DPD3-14,2,2,0
2024-08-15,48,Current,4344,4344,0
2024-08-15,48,DPD15-29,34,34,0
2024-08-15,48,DPD3-14,95,95,0
2024-08-15,48,DPD30-59,27,27,0
2024-08-15,48,DPD60-89,16,16,0
2024-08-15,48,DPD90+,8,8,0
2024-08-15,6,Current,0,0,0
2024-08-14,100,Current,0,0,0
2024-08-14,100,DPD3-14,0,0,0
2024-08-14,102,Current,0,0,0
2024-08-14,102,DPD3-14,0,0,0
2024-08-14,102,DPD60-89,0,0,0
2024-08-14,104,Current,0,0,0
2024-08-14,104,DPD15-29,0,0,0
2024-08-14,104,DPD3-14,0,0,0
2024-08-14,104,DPD90+,0,0,0
2024-08-14,20,Current,0,0,0
2024-08-14,20,DPD15-29,230,230,0
2024-08-14,20,DPD3-14,222,222,0
2024-08-14,20,DPD30-59,51,51,0
2024-08-14,20,DPD60-89,15,15,0
2024-08-14,20,DPD90+,30,30,0
2024-08-14,22,Current,0,0,0
2024-08-14,22,DPD15-29,1,1,0
2024-08-14,22,DPD60-89,0,0,0
2024-08-14,22,DPD90+,0,0,0
2024-08-14,24,Current,38,38,0
2024-08-14,24,DPD15-29,111,111,0
2024-08-14,24,DPD3-14,174,174,0
2024-08-14,24,DPD30-59,32,32,0
2024-08-14,24,DPD60-89,0,0,0
2024-08-14,24,DPD90+,0,0,0
2024-08-14,26,Current,0,0,0
2024-08-14,26,DPD15-29,22,22,0
2024-08-14,26,DPD3-14,13,13,0
2024-08-14,26,DPD30-59,3,3,0
2024-08-14,26,DPD60-89,0,0,0
2024-08-14,26,DPD90+,0,0,0
2024-08-14,32,Current,0,0,0
2024-08-14,32,DPD15-29,117,117,0
2024-08-14,32,DPD3-14,100,100,0
2024-08-14,32,DPD30-59,23,23,0
2024-08-14,32,DPD60-89,0,0,0
2024-08-14,32,DPD90+,0,0,0
2024-08-14,34,Current,0,0,0
2024-08-14,34,DPD15-29,45,45,0
2024-08-14,34,DPD3-14,38,38,0
2024-08-14,34,DPD30-59,10,10,0
2024-08-14,34,DPD60-89,0,0,0
2024-08-14,34,DPD90+,0,0,0
2024-08-14,36,Current,0,0,0
2024-08-14,36,DPD15-29,32,32,0
2024-08-14,36,DPD3-14,20,20,0
2024-08-14,36,DPD30-59,8,8,0
2024-08-14,36,DPD60-89,0,0,0
2024-08-14,36,DPD90+,0,0,0
2024-08-14,38,Current,9,9,0
2024-08-14,38,DPD15-29,29,29,0
2024-08-14,38,DPD3-14,22,22,0
2024-08-14,38,DPD30-59,4,4,0
2024-08-14,38,DPD60-89,0,0,0
2024-08-14,38,DPD90+,0,0,0
2024-08-14,40,Current,0,0,0
2024-08-14,40,DPD15-29,17,17,0
2024-08-14,40,DPD3-14,19,19,0
2024-08-14,40,DPD30-59,3,3,0
2024-08-14,40,DPD60-89,0,0,0
2024-08-14,40,DPD90+,0,0,0
2024-08-14,42,Current,0,0,0
2024-08-14,42,DPD15-29,13,13,0
2024-08-14,42,DPD3-14,16,16,0
2024-08-14,42,DPD30-59,6,6,0
2024-08-14,42,DPD60-89,0,0,0
2024-08-14,42,DPD90+,0,0,0
2024-08-14,44,Current,0,0,0
2024-08-14,44,DPD15-29,35,35,0
2024-08-14,44,DPD3-14,30,30,0
2024-08-14,44,DPD30-59,5,5,0
2024-08-14,44,DPD60-89,0,0,0
2024-08-14,44,DPD90+,0,0,0
2024-08-14,46,Current,0,0,0
2024-08-14,46,DPD3-14,0,0,0
2024-08-14,48,Current,23,23,0
2024-08-14,48,DPD15-29,17,17,0
2024-08-14,48,DPD3-14,30,30,0
2024-08-14,48,DPD30-59,4,4,0
2024-08-14,48,DPD60-89,0,0,0
2024-08-14,48,DPD90+,0,0,0
2024-08-14,6,Current,0,0,0
2024-08-13,100,Current,0,0,0
2024-08-13,100,DPD3-14,0,0,0
2024-08-13,102,Current,0,0,0
2024-08-13,102,DPD3-14,0,0,0
2024-08-13,102,DPD60-89,0,0,0
2024-08-13,104,Current,0,0,0
2024-08-13,104,DPD15-29,0,0,0
2024-08-13,104,DPD3-14,0,0,0
2024-08-13,104,DPD90+,0,0,0
2024-08-13,20,Current,0,0,0
2024-08-13,20,DPD15-29,329,329,0
2024-08-13,20,DPD3-14,267,267,0
2024-08-13,20,DPD30-59,116,116,0
2024-08-13,20,DPD60-89,41,41,0
2024-08-13,20,DPD90+,18,18,0
2024-08-13,22,Current,0,0,0
2024-08-13,22,DPD15-29,2,2,0
2024-08-13,22,DPD60-89,0,0,0
2024-08-13,22,DPD90+,0,0,0
2024-08-13,24,Current,38,38,0
2024-08-13,24,DPD15-29,186,186,0
2024-08-13,24,DPD3-14,148,148,0
2024-08-13,24,DPD30-59,67,67,0
2024-08-13,24,DPD60-89,0,0,0
2024-08-13,24,DPD90+,0,0,0
2024-08-13,26,Current,0,0,0
2024-08-13,26,DPD15-29,23,23,0
2024-08-13,26,DPD3-14,15,15,0
2024-08-13,26,DPD30-59,4,4,0
2024-08-13,26,DPD60-89,0,0,0
2024-08-13,26,DPD90+,0,0,0
2024-08-13,32,Current,0,0,0
2024-08-13,32,DPD15-29,161,161,0
2024-08-13,32,DPD3-14,119,119,0
2024-08-13,32,DPD30-59,53,53,0
2024-08-13,32,DPD60-89,0,0,0
2024-08-13,32,DPD90+,0,0,0
2024-08-13,34,Current,0,0,0
2024-08-13,34,DPD15-29,67,67,0
2024-08-13,34,DPD3-14,39,39,0
2024-08-13,34,DPD30-59,18,18,0
2024-08-13,34,DPD60-89,0,0,0
2024-08-13,34,DPD90+,0,0,0
2024-08-13,36,Current,0,0,0
2024-08-13,36,DPD15-29,49,49,0
2024-08-13,36,DPD3-14,23,23,0
2024-08-13,36,DPD30-59,17,17,0
2024-08-13,36,DPD60-89,0,0,0
2024-08-13,36,DPD90+,0,0,0
2024-08-13,38,Current,18,18,0
2024-08-13,38,DPD15-29,50,50,0
2024-08-13,38,DPD3-14,29,29,0
2024-08-13,38,DPD30-59,17,17,0
2024-08-13,38,DPD60-89,0,0,0
2024-08-13,38,DPD90+,0,0,0
2024-08-13,40,Current,0,0,0
2024-08-13,40,DPD15-29,22,22,0
2024-08-13,40,DPD3-14,31,31,0
2024-08-13,40,DPD30-59,7,7,0
2024-08-13,40,DPD60-89,0,0,0
2024-08-13,40,DPD90+,0,0,0
2024-08-13,42,Current,0,0,0
2024-08-13,42,DPD15-29,18,18,0
2024-08-13,42,DPD3-14,12,12,0
2024-08-13,42,DPD30-59,10,10,0
2024-08-13,42,DPD60-89,0,0,0
2024-08-13,42,DPD90+,0,0,0
2024-08-13,44,Current,0,0,0
2024-08-13,44,DPD15-29,34,34,0
2024-08-13,44,DPD3-14,41,41,0
2024-08-13,44,DPD30-59,11,11,0
2024-08-13,44,DPD60-89,0,0,0
2024-08-13,44,DPD90+,0,0,0
2024-08-13,46,Current,0,0,0
2024-08-13,46,DPD3-14,2,2,0
2024-08-13,48,Current,17,17,0
2024-08-13,48,DPD15-29,21,21,0
2024-08-13,48,DPD3-14,36,36,0
2024-08-13,48,DPD30-59,11,11,0
2024-08-13,48,DPD60-89,0,0,0
2024-08-13,48,DPD90+,0,0,0
2024-08-13,6,Current,0,0,0
2024-08-12,100,Current,0,0,0
2024-08-12,100,DPD3-14,0,0,0
2024-08-12,102,Current,0,0,0
2024-08-12,102,DPD3-14,1,1,0
2024-08-12,102,DPD60-89,0,0,0
2024-08-12,104,Current,0,0,0
2024-08-12,104,DPD15-29,0,0,0
2024-08-12,104,DPD3-14,0,0,0
2024-08-12,104,DPD90+,0,0,0
2024-08-12,20,Current,0,0,0
2024-08-12,20,DPD15-29,277,277,0
2024-08-12,20,DPD3-14,211,211,0
2024-08-12,20,DPD30-59,10,10,0
2024-08-12,20,DPD60-89,11,11,0
2024-08-12,20,DPD90+,9,9,0
2024-08-12,22,Current,0,0,0
2024-08-12,22,DPD15-29,1,1,0
2024-08-12,22,DPD30-59,0,0,0
2024-08-12,22,DPD60-89,0,0,0
2024-08-12,22,DPD90+,0,0,0
2024-08-12,24,Current,136,136,0
2024-08-12,24,DPD15-29,125,125,0
2024-08-12,24,DPD3-14,156,156,0
2024-08-12,24,DPD30-59,6,6,0
2024-08-12,24,DPD60-89,0,0,0
2024-08-12,24,DPD90+,0,0,0
2024-08-12,26,Current,0,0,0
2024-08-12,26,DPD15-29,23,23,0
2024-08-12,26,DPD3-14,18,18,0
2024-08-12,26,DPD30-59,0,0,0
2024-08-12,26,DPD60-89,0,0,0
2024-08-12,26,DPD90+,0,0,0
2024-08-12,32,Current,0,0,0
2024-08-12,32,DPD15-29,136,136,0
2024-08-12,32,DPD3-14,94,94,0
2024-08-12,32,DPD30-59,8,8,0
2024-08-12,32,DPD60-89,0,0,0
2024-08-12,32,DPD90+,0,0,0
2024-08-12,34,Current,0,0,0
2024-08-12,34,DPD15-29,55,55,0
2024-08-12,34,DPD3-14,40,40,0
2024-08-12,34,DPD30-59,2,2,0
2024-08-12,34,DPD60-89,0,0,0
2024-08-12,34,DPD90+,0,0,0
2024-08-12,36,Current,0,0,0
2024-08-12,36,DPD15-29,34,34,0
2024-08-12,36,DPD3-14,27,27,0
2024-08-12,36,DPD30-59,0,0,0
2024-08-12,36,DPD60-89,0,0,0
2024-08-12,36,DPD90+,0,0,0
2024-08-12,38,Current,16,16,0
2024-08-12,38,DPD15-29,35,35,0
2024-08-12,38,DPD3-14,24,24,0
2024-08-12,38,DPD30-59,1,1,0
2024-08-12,38,DPD60-89,0,0,0
2024-08-12,38,DPD90+,0,0,0
2024-08-12,40,Current,0,0,0
2024-08-12,40,DPD15-29,21,21,0
2024-08-12,40,DPD3-14,20,20,0
2024-08-12,40,DPD30-59,21,21,0
2024-08-12,40,DPD60-89,0,0,0
2024-08-12,40,DPD90+,0,0,0
2024-08-12,42,Current,0,0,0
2024-08-12,42,DPD15-29,19,19,0
2024-08-12,42,DPD3-14,11,11,0
2024-08-12,42,DPD30-59,1,1,0
2024-08-12,42,DPD60-89,0,0,0
2024-08-12,42,DPD90+,0,0,0
2024-08-12,44,Current,0,0,0
2024-08-12,44,DPD15-29,42,42,0
2024-08-12,44,DPD3-14,41,41,0
2024-08-12,44,DPD30-59,2,2,0
2024-08-12,44,DPD60-89,0,0,0
2024-08-12,44,DPD90+,0,0,0
2024-08-12,46,Current,0,0,0
2024-08-12,46,DPD3-14,0,0,0
2024-08-12,48,Current,93,93,0
2024-08-12,48,DPD15-29,22,22,0
2024-08-12,48,DPD3-14,29,29,0
2024-08-12,48,DPD30-59,3,3,0
2024-08-12,48,DPD60-89,0,0,0
2024-08-12,48,DPD90+,0,0,0
2024-08-12,6,Current,0,0,0
2024-08-11,100,Current,0,0,0
2024-08-11,100,DPD3-14,1,1,0
2024-08-11,102,Current,0,0,0
2024-08-11,102,DPD3-14,0,0,0
2024-08-11,102,DPD60-89,0,0,0
2024-08-11,104,Current,0,0,0
2024-08-11,104,DPD15-29,0,0,0
2024-08-11,104,DPD3-14,1,1,0
2024-08-11,104,DPD90+,0,0,0
2024-08-11,20,Current,0,0,0
2024-08-11,20,DPD15-29,227,227,0
2024-08-11,20,DPD3-14,363,363,0
2024-08-11,20,DPD30-59,210,210,0
2024-08-11,20,DPD60-89,81,81,0
2024-08-11,20,DPD90+,67,67,0
2024-08-11,22,Current,0,0,0
2024-08-11,22,DPD15-29,1,1,0
2024-08-11,22,DPD3-14,1,1,0
2024-08-11,22,DPD30-59,0,0,0
2024-08-11,22,DPD60-89,0,0,0
2024-08-11,22,DPD90+,0,0,0
2024-08-11,24,Current,54,54,0
2024-08-11,24,DPD15-29,132,132,0
2024-08-11,24,DPD3-14,189,189,0
2024-08-11,24,DPD30-59,101,101,0
2024-08-11,24,DPD60-89,0,0,0
2024-08-11,24,DPD90+,0,0,0
2024-08-11,26,Current,0,0,0
2024-08-11,26,DPD15-29,16,16,0
2024-08-11,26,DPD3-14,23,23,0
2024-08-11,26,DPD30-59,9,9,0
2024-08-11,26,DPD60-89,0,0,0
2024-08-11,26,DPD90+,0,0,0
2024-08-11,32,Current,0,0,0
2024-08-11,32,DPD15-29,110,110,0
2024-08-11,32,DPD3-14,156,156,0
2024-08-11,32,DPD30-59,83,83,0
2024-08-11,32,DPD60-89,0,0,0
2024-08-11,32,DPD90+,0,0,0
2024-08-11,34,Current,0,0,0
2024-08-11,34,DPD15-29,52,52,0
2024-08-11,34,DPD3-14,61,61,0
2024-08-11,34,DPD30-59,44,44,0
2024-08-11,34,DPD60-89,0,0,0
2024-08-11,34,DPD90+,0,0,0
2024-08-11,36,Current,0,0,0
2024-08-11,36,DPD15-29,36,36,0
2024-08-11,36,DPD3-14,37,37,0
2024-08-11,36,DPD30-59,23,23,0
2024-08-11,36,DPD60-89,0,0,0
2024-08-11,36,DPD90+,0,0,0
2024-08-11,38,Current,15,15,0
2024-08-11,38,DPD15-29,32,32,0
2024-08-11,38,DPD3-14,49,49,0
2024-08-11,38,DPD30-59,23,23,0
2024-08-11,38,DPD60-89,0,0,0
2024-08-11,38,DPD90+,0,0,0
2024-08-11,40,Current,0,0,0
2024-08-11,40,DPD15-29,11,11,0
2024-08-11,40,DPD3-14,32,32,0
2024-08-11,40,DPD30-59,3,3,0
2024-08-11,40,DPD60-89,0,0,0
2024-08-11,40,DPD90+,0,0,0
2024-08-11,42,Current,0,0,0
2024-08-11,42,DPD15-29,13,13,0
2024-08-11,42,DPD3-14,18,18,0
2024-08-11,42,DPD30-59,12,12,0
2024-08-11,42,DPD60-89,0,0,0
2024-08-11,42,DPD90+,0,0,0
2024-08-11,44,Current,0,0,0
2024-08-11,44,DPD15-29,27,27,0
2024-08-11,44,DPD3-14,46,46,0
2024-08-11,44,DPD30-59,24,24,0
2024-08-11,44,DPD60-89,0,0,0
2024-08-11,44,DPD90+,0,0,0
2024-08-11,46,Current,0,0,0
2024-08-11,46,DPD3-14,2,2,0
2024-08-11,48,Current,32,32,0
2024-08-11,48,DPD15-29,14,14,0
2024-08-11,48,DPD3-14,44,44,0
2024-08-11,48,DPD30-59,11,11,0
2024-08-11,48,DPD60-89,0,0,0
2024-08-11,48,DPD90+,0,0,0
2024-08-11,6,Current,0,0,0
2024-08-10,100,Current,0,0,0
2024-08-10,100,DPD3-14,0,0,0
2024-08-10,102,Current,0,0,0
2024-08-10,102,DPD3-14,1,1,0
2024-08-10,102,DPD60-89,0,0,0
2024-08-10,104,Current,0,0,0
2024-08-10,104,DPD15-29,0,0,0
2024-08-10,104,DPD3-14,0,0,0
2024-08-10,104,DPD90+,0,0,0
2024-08-10,20,Current,0,0,0
2024-08-10,20,DPD15-29,234,234,0
2024-08-10,20,DPD3-14,203,203,0
2024-08-10,20,DPD30-59,43,43,0
2024-08-10,20,DPD60-89,15,15,0
2024-08-10,20,DPD90+,7,7,0
2024-08-10,22,Current,0,0,0
2024-08-10,22,DPD15-29,1,1,0
2024-08-10,22,DPD3-14,0,0,0
2024-08-10,22,DPD30-59,0,0,0
2024-08-10,22,DPD60-89,0,0,0
2024-08-10,22,DPD90+,0,0,0
2024-08-10,24,Current,57,57,0
2024-08-10,24,DPD15-29,105,105,0
2024-08-10,24,DPD3-14,141,141,0
2024-08-10,24,DPD30-59,31,31,0
2024-08-10,24,DPD60-89,0,0,0
2024-08-10,24,DPD90+,0,0,0
2024-08-10,26,Current,0,0,0
2024-08-10,26,DPD15-29,17,17,0
2024-08-10,26,DPD3-14,20,20,0
2024-08-10,26,DPD30-59,2,2,0
2024-08-10,26,DPD60-89,0,0,0
2024-08-10,26,DPD90+,0,0,0
2024-08-10,32,Current,0,0,0
2024-08-10,32,DPD15-29,128,128,0
2024-08-10,32,DPD3-14,77,77,0
2024-08-10,32,DPD30-59,21,21,0
2024-08-10,32,DPD60-89,0,0,0
2024-08-10,32,DPD90+,0,0,0
2024-08-10,34,Current,0,0,0
2024-08-10,34,DPD15-29,46,46,0
2024-08-10,34,DPD3-14,36,36,0
2024-08-10,34,DPD30-59,8,8,0
2024-08-10,34,DPD60-89,0,0,0
2024-08-10,34,DPD90+,0,0,0
2024-08-10,36,Current,0,0,0
2024-08-10,36,DPD15-29,26,26,0
2024-08-10,36,DPD3-14,26,26,0
2024-08-10,36,DPD30-59,6,6,0
2024-08-10,36,DPD60-89,0,0,0
2024-08-10,36,DPD90+,0,0,0
2024-08-10,38,Current,10,10,0
2024-08-10,38,DPD15-29,25,25,0
2024-08-10,38,DPD3-14,26,26,0
2024-08-10,38,DPD30-59,7,7,0
2024-08-10,38,DPD60-89,0,0,0
2024-08-10,38,DPD90+,0,0,0
2024-08-10,40,Current,0,0,0
2024-08-10,40,DPD15-29,15,15,0
2024-08-10,40,DPD3-14,20,20,0
2024-08-10,40,DPD30-59,3,3,0
2024-08-10,40,DPD60-89,0,0,0
2024-08-10,40,DPD90+,0,0,0
2024-08-10,42,Current,0,0,0
2024-08-10,42,DPD15-29,18,18,0
2024-08-10,42,DPD3-14,10,10,0
2024-08-10,42,DPD30-59,4,4,0
2024-08-10,42,DPD60-89,0,0,0
2024-08-10,42,DPD90+,0,0,0
2024-08-10,44,Current,0,0,0
2024-08-10,44,DPD15-29,42,42,0
2024-08-10,44,DPD3-14,28,28,0
2024-08-10,44,DPD30-59,5,5,0
2024-08-10,44,DPD60-89,0,0,0
2024-08-10,44,DPD90+,0,0,0
2024-08-10,46,Current,0,0,0
2024-08-10,46,DPD3-14,0,0,0
2024-08-10,48,Current,30,30,0
2024-08-10,48,DPD15-29,24,24,0
2024-08-10,48,DPD3-14,20,20,0
2024-08-10,48,DPD30-59,2,2,0
2024-08-10,48,DPD60-89,0,0,0
2024-08-10,48,DPD90+,0,0,0
2024-08-10,6,Current,0,0,0
2024-08-09,100,Current,0,0,0
2024-08-09,100,DPD3-14,1,1,0
2024-08-09,102,Current,0,0,0
2024-08-09,102,DPD3-14,1,1,0
2024-08-09,102,DPD60-89,0,0,0
2024-08-09,104,Current,0,0,0
2024-08-09,104,DPD15-29,0,0,0
2024-08-09,104,DPD3-14,1,1,0
2024-08-09,104,DPD90+,0,0,0
2024-08-09,20,Current,0,0,0
2024-08-09,20,DPD15-29,221,221,0
2024-08-09,20,DPD3-14,353,353,0
2024-08-09,20,DPD30-59,107,107,0
2024-08-09,20,DPD60-89,30,30,0
2024-08-09,20,DPD90+,12,12,0
2024-08-09,22,Current,0,0,0
2024-08-09,22,DPD15-29,0,0,0
2024-08-09,22,DPD3-14,2,2,0
2024-08-09,22,DPD30-59,0,0,0
2024-08-09,22,DPD60-89,0,0,0
2024-08-09,22,DPD90+,0,0,0
2024-08-09,24,Current,55,55,0
2024-08-09,24,DPD15-29,122,122,0
2024-08-09,24,DPD3-14,202,202,0
2024-08-09,24,DPD30-59,63,63,0
2024-08-09,24,DPD60-89,0,0,0
2024-08-09,24,DPD90+,0,0,0
2024-08-09,26,Current,0,0,0
2024-08-09,26,DPD15-29,13,13,0
2024-08-09,26,DPD3-14,31,31,0
2024-08-09,26,DPD30-59,5,5,0
2024-08-09,26,DPD60-89,0,0,0
2024-08-09,26,DPD90+,0,0,0
2024-08-09,32,Current,0,0,0
2024-08-09,32,DPD15-29,100,100,0
2024-08-09,32,DPD3-14,168,168,0
2024-08-09,32,DPD30-59,49,49,0
2024-08-09,32,DPD60-89,0,0,0
2024-08-09,32,DPD90+,0,0,0
2024-08-09,34,Current,0,0,0
2024-08-09,34,DPD15-29,50,50,0
2024-08-09,34,DPD3-14,60,60,0
2024-08-09,34,DPD30-59,12,12,0
2024-08-09,34,DPD60-89,0,0,0
2024-08-09,34,DPD90+,0,0,0
2024-08-09,36,Current,0,0,0
2024-08-09,36,DPD15-29,36,36,0
2024-08-09,36,DPD3-14,37,37,0
2024-08-09,36,DPD30-59,23,23,0
2024-08-09,36,DPD60-89,0,0,0
2024-08-09,36,DPD90+,0,0,0
2024-08-09,38,Current,14,14,0
2024-08-09,38,DPD15-29,33,33,0
2024-08-09,38,DPD3-14,45,45,0
2024-08-09,38,DPD30-59,15,15,0
2024-08-09,38,DPD60-89,0,0,0
2024-08-09,38,DPD90+,0,0,0
2024-08-09,40,Current,0,0,0
2024-08-09,40,DPD15-29,14,14,0
2024-08-09,40,DPD3-14,30,30,0
2024-08-09,40,DPD30-59,6,6,0
2024-08-09,40,DPD60-89,0,0,0
2024-08-09,40,DPD90+,0,0,0
2024-08-09,42,Current,0,0,0
2024-08-09,42,DPD15-29,15,15,0
2024-08-09,42,DPD3-14,19,19,0
2024-08-09,42,DPD30-59,6,6,0
2024-08-09,42,DPD60-89,0,0,0
2024-08-09,42,DPD90+,0,0,0
2024-08-09,44,Current,0,0,0
2024-08-09,44,DPD15-29,24,24,0
2024-08-09,44,DPD3-14,44,44,0
2024-08-09,44,DPD30-59,9,9,0
2024-08-09,44,DPD60-89,0,0,0
2024-08-09,44,DPD90+,0,0,0
2024-08-09,46,Current,0,0,0
2024-08-09,46,DPD3-14,1,1,0
2024-08-09,48,Current,31,31,0
2024-08-09,48,DPD15-29,11,11,0
2024-08-09,48,DPD3-14,43,43,0
2024-08-09,48,DPD30-59,12,12,0
2024-08-09,48,DPD60-89,0,0,0
2024-08-09,48,DPD90+,0,0,0
2024-08-09,6,Current,0,0,0
2024-08-08,100,Current,0,0,0
2024-08-08,100,DPD3-14,0,0,0
2024-08-08,102,Current,0,0,0
2024-08-08,102,DPD3-14,0,0,0
2024-08-08,102,DPD60-89,0,0,0
2024-08-08,104,Current,0,0,0
2024-08-08,104,DPD15-29,0,0,0
2024-08-08,104,DPD3-14,0,0,0
2024-08-08,104,DPD90+,0,0,0
2024-08-08,20,Current,0,0,0
2024-08-08,20,DPD15-29,255,255,0
2024-08-08,20,DPD3-14,192,192,0
2024-08-08,20,DPD30-59,107,107,0
2024-08-08,20,DPD60-89,34,34,0
2024-08-08,20,DPD90+,10,10,0
2024-08-08,22,Current,0,0,0
2024-08-08,22,DPD15-29,1,1,0
2024-08-08,22,DPD3-14,0,0,0
2024-08-08,22,DPD30-59,0,0,0
2024-08-08,22,DPD60-89,0,0,0
2024-08-08,22,DPD90+,0,0,0
2024-08-08,24,Current,34,34,0
2024-08-08,24,DPD15-29,118,118,0
2024-08-08,24,DPD3-14,135,135,0
2024-08-08,24,DPD30-59,52,52,0
2024-08-08,24,DPD60-89,0,0,0
2024-08-08,24,DPD90+,0,0,0
2024-08-08,26,Current,0,0,0
2024-08-08,26,DPD15-29,17,17,0
2024-08-08,26,DPD3-14,19,19,0
2024-08-08,26,DPD30-59,5,5,0
2024-08-08,26,DPD60-89,0,0,0
2024-08-08,26,DPD90+,0,0,0
2024-08-08,32,Current,0,0,0
2024-08-08,32,DPD15-29,140,140,0
2024-08-08,32,DPD3-14,85,85,0
2024-08-08,32,DPD30-59,51,51,0
2024-08-08,32,DPD60-89,0,0,0
2024-08-08,32,DPD90+,0,0,0
2024-08-08,34,Current,0,0,0
2024-08-08,34,DPD15-29,46,46,0
2024-08-08,34,DPD3-14,34,34,0
2024-08-08,34,DPD30-59,26,26,0
2024-08-08,34,DPD60-89,0,0,0
2024-08-08,34,DPD90+,0,0,0
2024-08-08,36,Current,0,0,0
2024-08-08,36,DPD15-29,28,28,0
2024-08-08,36,DPD3-14,30,30,0
2024-08-08,36,DPD30-59,9,9,0
2024-08-08,36,DPD60-89,0,0,0
2024-08-08,36,DPD90+,0,0,0
2024-08-08,38,Current,9,9,0
2024-08-08,38,DPD15-29,30,30,0
2024-08-08,38,DPD3-14,33,33,0
2024-08-08,38,DPD30-59,11,11,0
2024-08-08,38,DPD60-89,0,0,0
2024-08-08,38,DPD90+,0,0,0
2024-08-08,40,Current,0,0,0
2024-08-08,40,DPD15-29,14,14,0
2024-08-08,40,DPD3-14,20,20,0
2024-08-08,40,DPD30-59,2,2,0
2024-08-08,40,DPD60-89,0,0,0
2024-08-08,40,DPD90+,0,0,0
2024-08-08,42,Current,0,0,0
2024-08-08,42,DPD15-29,18,18,0
2024-08-08,42,DPD3-14,10,10,0
2024-08-08,42,DPD30-59,6,6,0
2024-08-08,42,DPD60-89,0,0,0
2024-08-08,42,DPD90+,0,0,0
2024-08-08,44,Current,0,0,0
2024-08-08,44,DPD15-29,39,39,0
2024-08-08,44,DPD3-14,25,25,0
2024-08-08,44,DPD30-59,18,18,0
2024-08-08,44,DPD60-89,0,0,0
2024-08-08,44,DPD90+,0,0,0
2024-08-08,46,Current,0,0,0
2024-08-08,46,DPD3-14,0,0,0
2024-08-08,48,Current,21,21,0
2024-08-08,48,DPD15-29,17,17,0
2024-08-08,48,DPD3-14,28,28,0
2024-08-08,48,DPD30-59,7,7,0
2024-08-08,48,DPD60-89,0,0,0
2024-08-08,48,DPD90+,0,0,0
2024-08-08,6,Current,0,0,0
2024-08-07,100,Current,0,0,0
2024-08-07,100,DPD3-14,1,1,0
2024-08-07,102,Current,0,0,0
2024-08-07,102,DPD3-14,1,1,0
2024-08-07,102,DPD60-89,0,0,0
2024-08-07,104,Current,0,0,0
2024-08-07,104,DPD15-29,0,0,0
2024-08-07,104,DPD90+,0,0,0
2024-08-07,20,Current,0,0,0
2024-08-07,20,DPD15-29,214,214,0
2024-08-07,20,DPD3-14,371,371,0
2024-08-07,20,DPD30-59,112,112,0
2024-08-07,20,DPD60-89,33,33,0
2024-08-07,20,DPD90+,48,48,0
2024-08-07,22,Current,0,0,0
2024-08-07,22,DPD15-29,1,1,0
2024-08-07,22,DPD3-14,2,2,0
2024-08-07,22,DPD30-59,0,0,0
2024-08-07,22,DPD60-89,0,0,0
2024-08-07,22,DPD90+,0,0,0
2024-08-07,24,Current,48,48,0
2024-08-07,24,DPD15-29,128,128,0
2024-08-07,24,DPD3-14,228,228,0
2024-08-07,24,DPD30-59,61,61,0
2024-08-07,24,DPD60-89,0,0,0
2024-08-07,24,DPD90+,0,0,0
2024-08-07,26,Current,0,0,0
2024-08-07,26,DPD15-29,16,16,0
2024-08-07,26,DPD3-14,35,35,0
2024-08-07,26,DPD30-59,5,5,0
2024-08-07,26,DPD60-89,0,0,0
2024-08-07,26,DPD90+,0,0,0
2024-08-07,32,Current,0,0,0
2024-08-07,32,DPD15-29,93,93,0
2024-08-07,32,DPD3-14,190,190,0
2024-08-07,32,DPD30-59,45,45,0
2024-08-07,32,DPD60-89,0,0,0
2024-08-07,32,DPD90+,0,0,0
2024-08-07,34,Current,0,0,0
2024-08-07,34,DPD15-29,51,51,0
2024-08-07,34,DPD3-14,63,63,0
2024-08-07,34,DPD30-59,23,23,0
2024-08-07,34,DPD60-89,0,0,0
2024-08-07,34,DPD90+,0,0,0
2024-08-07,36,Current,0,0,0
2024-08-07,36,DPD15-29,33,33,0
2024-08-07,36,DPD3-14,46,46,0
2024-08-07,36,DPD30-59,16,16,0
2024-08-07,36,DPD60-89,0,0,0
2024-08-07,36,DPD90+,0,0,0
2024-08-07,38,Current,20,20,0
2024-08-07,38,DPD15-29,27,27,0
2024-08-07,38,DPD3-14,49,49,0
2024-08-07,38,DPD30-59,16,16,0
2024-08-07,38,DPD60-89,0,0,0
2024-08-07,38,DPD90+,0,0,0
2024-08-07,40,Current,0,0,0
2024-08-07,40,DPD15-29,15,15,0
2024-08-07,40,DPD3-14,30,30,0
2024-08-07,40,DPD30-59,1,1,0
2024-08-07,40,DPD60-89,0,0,0
2024-08-07,40,DPD90+,0,0,0
2024-08-07,42,Current,0,0,0
2024-08-07,42,DPD15-29,13,13,0
2024-08-07,42,DPD3-14,20,20,0
2024-08-07,42,DPD30-59,9,9,0
2024-08-07,42,DPD60-89,0,0,0
2024-08-07,42,DPD90+,0,0,0
2024-08-07,44,Current,0,0,0
2024-08-07,44,DPD15-29,27,27,0
2024-08-07,44,DPD3-14,51,51,0
2024-08-07,44,DPD30-59,12,12,0
2024-08-07,44,DPD60-89,0,0,0
2024-08-07,44,DPD90+,0,0,0
2024-08-07,46,Current,0,0,0
2024-08-07,46,DPD3-14,1,1,0
2024-08-07,48,Current,20,20,0
2024-08-07,48,DPD15-29,12,12,0
2024-08-07,48,DPD3-14,42,42,0
2024-08-07,48,DPD30-59,8,8,0
2024-08-07,48,DPD60-89,0,0,0
2024-08-07,48,DPD90+,0,0,0
2024-08-07,6,Current,0,0,0
2024-08-06,100,Current,0,0,0
2024-08-06,100,DPD3-14,0,0,0
2024-08-06,102,Current,0,0,0
2024-08-06,102,DPD3-14,0,0,0
2024-08-06,102,DPD60-89,0,0,0
2024-08-06,104,Current,0,0,0
2024-08-06,104,DPD15-29,0,0,0
2024-08-06,104,DPD90+,0,0,0
2024-08-06,20,Current,0,0,0
2024-08-06,20,DPD15-29,252,252,0
2024-08-06,20,DPD3-14,223,223,0
2024-08-06,20,DPD30-59,37,37,0
2024-08-06,20,DPD60-89,22,22,0
2024-08-06,20,DPD90+,36,36,0
2024-08-06,22,Current,0,0,0
2024-08-06,22,DPD15-29,1,1,0
2024-08-06,22,DPD3-14,0,0,0
2024-08-06,22,DPD30-59,0,0,0
2024-08-06,22,DPD60-89,0,0,0
2024-08-06,24,Current,41,41,0
2024-08-06,24,DPD15-29,131,131,0
2024-08-06,24,DPD3-14,132,132,0
2024-08-06,24,DPD30-59,30,30,0
2024-08-06,24,DPD60-89,0,0,0
2024-08-06,24,DPD90+,0,0,0
2024-08-06,26,Current,0,0,0
2024-08-06,26,DPD15-29,13,13,0
2024-08-06,26,DPD3-14,21,21,0
2024-08-06,26,DPD30-59,1,1,0
2024-08-06,26,DPD60-89,0,0,0
2024-08-06,26,DPD90+,0,0,0
2024-08-06,32,Current,0,0,0
2024-08-06,32,DPD15-29,136,136,0
2024-08-06,32,DPD3-14,113,113,0
2024-08-06,32,DPD30-59,22,22,0
2024-08-06,32,DPD60-89,0,0,0
2024-08-06,32,DPD90+,0,0,0
2024-08-06,34,Current,0,0,0
2024-08-06,34,DPD15-29,46,46,0
2024-08-06,34,DPD3-14,35,35,0
2024-08-06,34,DPD30-59,5,5,0
2024-08-06,34,DPD60-89,0,0,0
2024-08-06,34,DPD90+,0,0,0
2024-08-06,36,Current,0,0,0
2024-08-06,36,DPD15-29,27,27,0
2024-08-06,36,DPD3-14,35,35,0
2024-08-06,36,DPD30-59,5,5,0
2024-08-06,36,DPD60-89,0,0,0
2024-08-06,36,DPD90+,0,0,0
2024-08-06,38,Current,10,10,0
2024-08-06,38,DPD15-29,28,28,0
2024-08-06,38,DPD3-14,40,40,0
2024-08-06,38,DPD30-59,8,8,0
2024-08-06,38,DPD60-89,0,0,0
2024-08-06,38,DPD90+,0,0,0
2024-08-06,40,Current,0,0,0
2024-08-06,40,DPD15-29,15,15,0
2024-08-06,40,DPD3-14,21,21,0
2024-08-06,40,DPD30-59,4,4,0
2024-08-06,40,DPD60-89,0,0,0
2024-08-06,40,DPD90+,0,0,0
2024-08-06,42,Current,0,0,0
2024-08-06,42,DPD15-29,15,15,0
2024-08-06,42,DPD3-14,15,15,0
2024-08-06,42,DPD30-59,5,5,0
2024-08-06,42,DPD60-89,0,0,0
2024-08-06,42,DPD90+,0,0,0
2024-08-06,44,Current,0,0,0
2024-08-06,44,DPD15-29,37,37,0
2024-08-06,44,DPD3-14,27,27,0
2024-08-06,44,DPD30-59,4,4,0
2024-08-06,44,DPD60-89,0,0,0
2024-08-06,44,DPD90+,0,0,0
2024-08-06,46,Current,0,0,0
2024-08-06,46,DPD3-14,0,0,0
2024-08-06,48,Current,24,24,0
2024-08-06,48,DPD15-29,22,22,0
2024-08-06,48,DPD3-14,27,27,0
2024-08-06,48,DPD30-59,4,4,0
2024-08-06,48,DPD60-89,0,0,0
2024-08-06,48,DPD90+,0,0,0
2024-08-06,6,Current,0,0,0
2024-08-05,100,Current,0,0,0
2024-08-05,100,DPD3-14,1,1,0
2024-08-05,102,Current,0,0,0
2024-08-05,102,DPD3-14,1,1,0
2024-08-05,102,DPD60-89,0,0,0
2024-08-05,102,DPD90+,0,0,0
2024-08-05,104,Current,0,0,0
2024-08-05,104,DPD3-14,0,0,0
2024-08-05,104,DPD90+,0,0,0
2024-08-05,20,Current,3,3,0
2024-08-05,20,DPD15-29,222,222,0
2024-08-05,20,DPD3-14,470,470,0
2024-08-05,20,DPD30-59,128,128,0
2024-08-05,20,DPD60-89,36,36,0
2024-08-05,20,DPD90+,23,23,0
2024-08-05,22,Current,0,0,0
2024-08-05,22,DPD15-29,0,0,0
2024-08-05,22,DPD3-14,3,3,0
2024-08-05,22,DPD30-59,0,0,0
2024-08-05,22,DPD60-89,0,0,0
2024-08-05,24,Current,238,238,0
2024-08-05,24,DPD15-29,136,136,0
2024-08-05,24,DPD3-14,255,255,0
2024-08-05,24,DPD30-59,72,72,0
2024-08-05,24,DPD60-89,0,0,0
2024-08-05,24,DPD90+,0,0,0
2024-08-05,26,Current,0,0,0
2024-08-05,26,DPD15-29,18,18,0
2024-08-05,26,DPD3-14,42,42,0
2024-08-05,26,DPD30-59,5,5,0
2024-08-05,26,DPD60-89,0,0,0
2024-08-05,26,DPD90+,0,0,0
2024-08-05,32,Current,0,0,0
2024-08-05,32,DPD15-29,98,98,0
2024-08-05,32,DPD3-14,233,233,0
2024-08-05,32,DPD30-59,59,59,0
2024-08-05,32,DPD60-89,0,0,0
2024-08-05,32,DPD90+,0,0,0
2024-08-05,34,Current,0,0,0
2024-08-05,34,DPD15-29,45,45,0
2024-08-05,34,DPD3-14,87,87,0
2024-08-05,34,DPD30-59,18,18,0
2024-08-05,34,DPD60-89,0,0,0
2024-08-05,34,DPD90+,0,0,0
2024-08-05,36,Current,0,0,0
2024-08-05,36,DPD15-29,35,35,0
2024-08-05,36,DPD3-14,61,61,0
2024-08-05,36,DPD30-59,26,26,0
2024-08-05,36,DPD60-89,0,0,0
2024-08-05,36,DPD90+,0,0,0
2024-08-05,38,Current,18,18,0
2024-08-05,38,DPD15-29,38,38,0
2024-08-05,38,DPD3-14,72,72,0
2024-08-05,38,DPD30-59,18,18,0
2024-08-05,38,DPD60-89,0,0,0
2024-08-05,38,DPD90+,0,0,0
2024-08-05,40,Current,0,0,0
2024-08-05,40,DPD15-29,25,25,0
2024-08-05,40,DPD3-14,49,49,0
2024-08-05,40,DPD30-59,29,29,0
2024-08-05,40,DPD60-89,0,0,0
2024-08-05,40,DPD90+,0,0,0
2024-08-05,42,Current,0,0,0
2024-08-05,42,DPD15-29,15,15,0
2024-08-05,42,DPD3-14,25,25,0
2024-08-05,42,DPD30-59,8,8,0
2024-08-05,42,DPD60-89,0,0,0
2024-08-05,42,DPD90+,0,0,0
2024-08-05,44,Current,0,0,0
2024-08-05,44,DPD15-29,32,32,0
2024-08-05,44,DPD3-14,63,63,0
2024-08-05,44,DPD30-59,11,11,0
2024-08-05,44,DPD60-89,0,0,0
2024-08-05,44,DPD90+,0,0,0
2024-08-05,46,Current,0,0,0
2024-08-05,46,DPD3-14,1,1,0
2024-08-05,48,Current,200,200,0
2024-08-05,48,DPD15-29,13,13,0
2024-08-05,48,DPD3-14,40,40,0
2024-08-05,48,DPD30-59,13,13,0
2024-08-05,48,DPD60-89,0,0,0
2024-08-05,48,DPD90+,0,0,0
2024-08-05,6,Current,0,0,0
2024-08-04,100,Current,0,0,0
2024-08-04,100,DPD3-14,0,0,0
2024-08-04,102,Current,0,0,0
2024-08-04,102,DPD3-14,0,0,0
2024-08-04,102,DPD30-59,0,0,0
2024-08-04,102,DPD90+,0,0,0
2024-08-04,104,Current,0,0,0
2024-08-04,104,DPD3-14,0,0,0
2024-08-04,104,DPD90+,0,0,0
2024-08-04,20,Current,0,0,0
2024-08-04,20,DPD15-29,212,212,0
2024-08-04,20,DPD3-14,205,205,0
2024-08-04,20,DPD30-59,122,122,0
2024-08-04,20,DPD60-89,34,34,0
2024-08-04,20,DPD90+,26,26,0
2024-08-04,22,Current,0,0,0
2024-08-04,22,DPD3-14,1,1,0
2024-08-04,22,DPD30-59,0,0,0
2024-08-04,22,DPD60-89,0,0,0
2024-08-04,22,DPD90+,0,0,0
2024-08-04,24,Current,70,70,0
2024-08-04,24,DPD15-29,125,125,0
2024-08-04,24,DPD3-14,116,116,0
2024-08-04,24,DPD30-59,59,59,0
2024-08-04,24,DPD60-89,0,0,0
2024-08-04,24,DPD90+,0,0,0
2024-08-04,26,Current,0,0,0
2024-08-04,26,DPD15-29,12,12,0
2024-08-04,26,DPD3-14,19,19,0
2024-08-04,26,DPD30-59,5,5,0
2024-08-04,26,DPD60-89,0,0,0
2024-08-04,26,DPD90+,0,0,0
2024-08-04,32,Current,0,0,0
2024-08-04,32,DPD15-29,112,112,0
2024-08-04,32,DPD3-14,104,104,0
2024-08-04,32,DPD30-59,48,48,0
2024-08-04,32,DPD60-89,0,0,0
2024-08-04,32,DPD90+,0,0,0
2024-08-04,34,Current,0,0,0
2024-08-04,34,DPD15-29,40,40,0
2024-08-04,34,DPD3-14,36,36,0
2024-08-04,34,DPD30-59,27,27,0
2024-08-04,34,DPD60-89,0,0,0
2024-08-04,34,DPD90+,0,0,0
2024-08-04,36,Current,0,0,0
2024-08-04,36,DPD15-29,28,28,0
2024-08-04,36,DPD3-14,27,27,0
2024-08-04,36,DPD30-59,12,12,0
2024-08-04,36,DPD60-89,0,0,0
2024-08-04,36,DPD90+,0,0,0
2024-08-04,38,Current,12,12,0
2024-08-04,38,DPD15-29,26,26,0
2024-08-04,38,DPD3-14,33,33,0
2024-08-04,38,DPD30-59,14,14,0
2024-08-04,38,DPD60-89,0,0,0
2024-08-04,38,DPD90+,0,0,0
2024-08-04,40,Current,0,0,0
2024-08-04,40,DPD15-29,17,17,0
2024-08-04,40,DPD3-14,15,15,0
2024-08-04,40,DPD30-59,0,0,0
2024-08-04,40,DPD60-89,0,0,0
2024-08-04,40,DPD90+,0,0,0
2024-08-04,42,Current,0,0,0
2024-08-04,42,DPD15-29,16,16,0
2024-08-04,42,DPD3-14,11,11,0
2024-08-04,42,DPD30-59,5,5,0
2024-08-04,42,DPD60-89,0,0,0
2024-08-04,42,DPD90+,0,0,0
2024-08-04,44,Current,0,0,0
2024-08-04,44,DPD15-29,32,32,0
2024-08-04,44,DPD3-14,24,24,0
2024-08-04,44,DPD30-59,12,12,0
2024-08-04,44,DPD60-89,0,0,0
2024-08-04,44,DPD90+,0,0,0
2024-08-04,46,Current,0,0,0
2024-08-04,46,DPD15-29,1,1,0
2024-08-04,46,DPD3-14,0,0,0
2024-08-04,48,Current,37,37,0
2024-08-04,48,DPD15-29,20,20,0
2024-08-04,48,DPD3-14,21,21,0
2024-08-04,48,DPD30-59,10,10,0
2024-08-04,48,DPD60-89,0,0,0
2024-08-04,48,DPD90+,0,0,0
2024-08-04,6,Current,0,0,0
2024-08-03,100,Current,0,0,0
2024-08-03,102,Current,0,0,0
2024-08-03,102,DPD30-59,0,0,0
2024-08-03,102,DPD90+,0,0,0
2024-08-03,104,Current,0,0,0
2024-08-03,104,DPD3-14,0,0,0
2024-08-03,104,DPD90+,0,0,0
2024-08-03,20,Current,0,0,0
2024-08-03,20,DPD15-29,189,189,0
2024-08-03,20,DPD3-14,376,376,0
2024-08-03,20,DPD30-59,101,101,0
2024-08-03,20,DPD60-89,57,57,0
2024-08-03,20,DPD90+,63,63,0
2024-08-03,22,Current,0,0,0
2024-08-03,22,DPD3-14,3,3,0
2024-08-03,22,DPD30-59,0,0,0
2024-08-03,22,DPD60-89,0,0,0
2024-08-03,22,DPD90+,0,0,0
2024-08-03,24,Current,44,44,0
2024-08-03,24,DPD15-29,113,113,0
2024-08-03,24,DPD3-14,210,210,0
2024-08-03,24,DPD30-59,52,52,0
2024-08-03,24,DPD60-89,0,0,0
2024-08-03,24,DPD90+,0,0,0
2024-08-03,26,Current,0,0,0
2024-08-03,26,DPD15-29,13,13,0
2024-08-03,26,DPD3-14,36,36,0
2024-08-03,26,DPD30-59,5,5,0
2024-08-03,26,DPD60-89,0,0,0
2024-08-03,26,DPD90+,0,0,0
2024-08-03,32,Current,0,0,0
2024-08-03,32,DPD15-29,72,72,0
2024-08-03,32,DPD3-14,205,205,0
2024-08-03,32,DPD30-59,44,44,0
2024-08-03,32,DPD60-89,0,0,0
2024-08-03,32,DPD90+,0,0,0
2024-08-03,34,Current,0,0,0
2024-08-03,34,DPD15-29,41,41,0
2024-08-03,34,DPD3-14,69,69,0
2024-08-03,34,DPD30-59,20,20,0
2024-08-03,34,DPD60-89,0,0,0
2024-08-03,34,DPD90+,0,0,0
2024-08-03,36,Current,0,0,0
2024-08-03,36,DPD15-29,24,24,0
2024-08-03,36,DPD3-14,55,55,0
2024-08-03,36,DPD30-59,13,13,0
2024-08-03,36,DPD60-89,0,0,0
2024-08-03,36,DPD90+,0,0,0
2024-08-03,38,Current,14,14,0
2024-08-03,38,DPD15-29,30,30,0
2024-08-03,38,DPD3-14,58,58,0
2024-08-03,38,DPD30-59,12,12,0
2024-08-03,38,DPD60-89,0,0,0
2024-08-03,38,DPD90+,0,0,0
2024-08-03,40,Current,0,0,0
2024-08-03,40,DPD15-29,25,25,0
2024-08-03,40,DPD3-14,37,37,0
2024-08-03,40,DPD30-59,0,0,0
2024-08-03,40,DPD60-89,0,0,0
2024-08-03,40,DPD90+,0,0,0
2024-08-03,42,Current,0,0,0
2024-08-03,42,DPD15-29,13,13,0
2024-08-03,42,DPD3-14,19,19,0
2024-08-03,42,DPD30-59,9,9,0
2024-08-03,42,DPD60-89,0,0,0
2024-08-03,42,DPD90+,0,0,0
2024-08-03,44,Current,0,0,0
2024-08-03,44,DPD15-29,24,24,0
2024-08-03,44,DPD3-14,39,39,0
2024-08-03,44,DPD30-59,10,10,0
2024-08-03,44,DPD60-89,0,0,0
2024-08-03,44,DPD90+,0,0,0
2024-08-03,46,Current,0,0,0
2024-08-03,46,DPD15-29,0,0,0
2024-08-03,48,Current,30,30,0
2024-08-03,48,DPD15-29,15,15,0
2024-08-03,48,DPD3-14,23,23,0
2024-08-03,48,DPD30-59,7,7,0
2024-08-03,48,DPD60-89,0,0,0
2024-08-03,48,DPD90+,0,0,0
2024-08-03,6,Current,0,0,0
2024-08-02,100,Current,0,0,0
2024-08-02,102,Current,0,0,0
2024-08-02,102,DPD30-59,0,0,0
2024-08-02,102,DPD90+,0,0,0
2024-08-02,104,Current,0,0,0
2024-08-02,104,DPD3-14,0,0,0
2024-08-02,104,DPD90+,0,0,0
2024-08-02,20,Current,0,0,0
2024-08-02,20,DPD15-29,202,202,0
2024-08-02,20,DPD3-14,275,275,0
2024-08-02,20,DPD30-59,81,81,0
2024-08-02,20,DPD60-89,16,16,0
2024-08-02,20,DPD90+,6,6,0
2024-08-02,22,Current,0,0,0
2024-08-02,22,DPD3-14,1,1,0
2024-08-02,22,DPD30-59,0,0,0
2024-08-02,22,DPD60-89,0,0,0
2024-08-02,22,DPD90+,0,0,0
2024-08-02,24,Current,56,56,0
2024-08-02,24,DPD15-29,118,118,0
2024-08-02,24,DPD3-14,158,158,0
2024-08-02,24,DPD30-59,47,47,0
2024-08-02,24,DPD60-89,0,0,0
2024-08-02,24,DPD90+,0,0,0
2024-08-02,26,Current,0,0,0
2024-08-02,26,DPD15-29,8,8,0
2024-08-02,26,DPD3-14,25,25,0
2024-08-02,26,DPD30-59,2,2,0
2024-08-02,26,DPD60-89,0,0,0
2024-08-02,26,DPD90+,0,0,0
2024-08-02,32,Current,0,0,0
2024-08-02,32,DPD15-29,119,119,0
2024-08-02,32,DPD3-14,130,130,0
2024-08-02,32,DPD30-59,42,42,0
2024-08-02,32,DPD60-89,0,0,0
2024-08-02,32,DPD90+,0,0,0
2024-08-02,34,Current,0,0,0
2024-08-02,34,DPD15-29,40,40,0
2024-08-02,34,DPD3-14,47,47,0
2024-08-02,34,DPD30-59,9,9,0
2024-08-02,34,DPD60-89,0,0,0
2024-08-02,34,DPD90+,0,0,0
2024-08-02,36,Current,0,0,0
2024-08-02,36,DPD15-29,23,23,0
2024-08-02,36,DPD3-14,39,39,0
2024-08-02,36,DPD30-59,11,11,0
2024-08-02,36,DPD60-89,0,0,0
2024-08-02,36,DPD90+,0,0,0
2024-08-02,38,Current,26,26,0
2024-08-02,38,DPD15-29,24,24,0
2024-08-02,38,DPD3-14,44,44,0
2024-08-02,38,DPD30-59,14,14,0
2024-08-02,38,DPD60-89,0,0,0
2024-08-02,38,DPD90+,0,0,0
2024-08-02,40,Current,0,0,0
2024-08-02,40,DPD15-29,16,16,0
2024-08-02,40,DPD3-14,22,22,0
2024-08-02,40,DPD30-59,3,3,0
2024-08-02,40,DPD60-89,0,0,0
2024-08-02,40,DPD90+,0,0,0
2024-08-02,42,Current,0,0,0
2024-08-02,42,DPD15-29,16,16,0
2024-08-02,42,DPD3-14,15,15,0
2024-08-02,42,DPD30-59,6,6,0
2024-08-02,42,DPD60-89,0,0,0
2024-08-02,42,DPD90+,0,0,0
2024-08-02,44,Current,0,0,0
2024-08-02,44,DPD15-29,25,25,0
2024-08-02,44,DPD3-14,38,38,0
2024-08-02,44,DPD30-59,11,11,0
2024-08-02,44,DPD60-89,0,0,0
2024-08-02,44,DPD90+,0,0,0
2024-08-02,46,Current,0,0,0
2024-08-02,46,DPD15-29,1,1,0
2024-08-02,48,Current,34,34,0
2024-08-02,48,DPD15-29,20,20,0
2024-08-02,48,DPD3-14,25,25,0
2024-08-02,48,DPD30-59,12,12,0
2024-08-02,48,DPD60-89,0,0,0
2024-08-02,48,DPD90+,0,0,0
2024-08-02,6,Current,0,0,0
2024-08-01,100,Current,0,0,0
2024-08-01,102,Current,0,0,0
2024-08-01,102,DPD30-59,0,0,0
2024-08-01,102,DPD90+,0,0,0
2024-08-01,104,Current,0,0,0
2024-08-01,104,DPD3-14,0,0,0
2024-08-01,104,DPD90+,0,0,0
2024-08-01,20,Current,4404,4404,0
2024-08-01,20,DPD15-29,276,276,0
2024-08-01,20,DPD3-14,605,605,0
2024-08-01,20,DPD30-59,168,168,0
2024-08-01,20,DPD60-89,51,51,0
2024-08-01,20,DPD90+,40,40,0
2024-08-01,22,Current,0,0,0
2024-08-01,22,DPD3-14,3,3,0
2024-08-01,22,DPD30-59,0,0,0
2024-08-01,22,DPD60-89,0,0,0
2024-08-01,24,Current,4130,4130,0
2024-08-01,24,DPD15-29,139,139,0
2024-08-01,24,DPD3-14,349,349,0
2024-08-01,24,DPD30-59,94,94,0
2024-08-01,24,DPD60-89,14,14,0
2024-08-01,24,DPD90+,8,8,0
2024-08-01,26,Current,0,0,0
2024-08-01,26,DPD15-29,15,15,0
2024-08-01,26,DPD3-14,51,51,0
2024-08-01,26,DPD30-59,6,6,0
2024-08-01,26,DPD60-89,0,0,0
2024-08-01,26,DPD90+,0,0,0
2024-08-01,32,Current,236,236,0
2024-08-01,32,DPD15-29,79,79,0
2024-08-01,32,DPD3-14,259,259,0
2024-08-01,32,DPD30-59,47,47,0
2024-08-01,32,DPD60-89,3,3,0
2024-08-01,32,DPD90+,1,1,0
2024-08-01,34,Current,0,0,0
2024-08-01,34,DPD15-29,39,39,0
2024-08-01,34,DPD3-14,104,104,0
2024-08-01,34,DPD30-59,13,13,0
2024-08-01,34,DPD60-89,0,0,0
2024-08-01,34,DPD90+,0,0,0
2024-08-01,36,Current,246,246,0
2024-08-01,36,DPD15-29,27,27,0
2024-08-01,36,DPD3-14,64,64,0
2024-08-01,36,DPD30-59,19,19,0
2024-08-01,36,DPD60-89,4,4,0
2024-08-01,36,DPD90+,1,1,0
2024-08-01,38,Current,15,15,0
2024-08-01,38,DPD15-29,28,28,0
2024-08-01,38,DPD3-14,78,78,0
2024-08-01,38,DPD30-59,16,16,0
2024-08-01,38,DPD60-89,1,1,0
2024-08-01,38,DPD90+,0,0,0
2024-08-01,40,Current,266,266,0
2024-08-01,40,DPD15-29,30,30,0
2024-08-01,40,DPD3-14,51,51,0
2024-08-01,40,DPD30-59,17,17,0
2024-08-01,40,DPD60-89,0,0,0
2024-08-01,40,DPD90+,1,1,0
2024-08-01,42,Current,0,0,0
2024-08-01,42,DPD15-29,12,12,0
2024-08-01,42,DPD3-14,28,28,0
2024-08-01,42,DPD30-59,6,6,0
2024-08-01,42,DPD60-89,0,0,0
2024-08-01,42,DPD90+,0,0,0
2024-08-01,44,Current,171,171,0
2024-08-01,44,DPD15-29,25,25,0
2024-08-01,44,DPD3-14,53,53,0
2024-08-01,44,DPD30-59,11,11,0
2024-08-01,44,DPD60-89,2,2,0
2024-08-01,44,DPD90+,2,2,0
2024-08-01,46,Current,4,4,0
2024-08-01,46,DPD15-29,0,0,0
2024-08-01,48,Current,4327,4327,0
2024-08-01,48,DPD15-29,48,48,0
2024-08-01,48,DPD3-14,85,85,0
2024-08-01,48,DPD30-59,17,17,0
2024-08-01,48,DPD60-89,17,17,0
2024-08-01,48,DPD90+,9,9,0
2024-08-01,6,Current,0,0,0
2024-07-31,100,Current,0,0,0
2024-07-31,100,DPD3-14,0,0,0
2024-07-31,102,Current,0,0,0
2024-07-31,102,DPD30-59,0,0,0
2024-07-31,102,DPD90+,0,0,0
2024-07-31,104,Current,0,0,0
2024-07-31,104,DPD3-14,0,0,0
2024-07-31,104,DPD90+,0,0,0
2024-07-31,20,Current,0,0,0
2024-07-31,20,DPD15-29,258,258,0
2024-07-31,20,DPD3-14,359,359,0
2024-07-31,20,DPD30-59,85,85,0
2024-07-31,20,DPD60-89,23,23,0
2024-07-31,20,DPD90+,15,15,0
2024-07-31,22,Current,0,0,0
2024-07-31,22,DPD3-14,1,1,0
2024-07-31,22,DPD30-59,0,0,0
2024-07-31,22,DPD60-89,0,0,0
2024-07-31,24,Current,31,31,0
2024-07-31,24,DPD15-29,123,123,0
2024-07-31,24,DPD3-14,203,203,0
2024-07-31,24,DPD30-59,37,37,0
2024-07-31,24,DPD60-89,0,0,0
2024-07-31,24,DPD90+,0,0,0
2024-07-31,26,Current,0,0,0
2024-07-31,26,DPD15-29,11,11,0
2024-07-31,26,DPD3-14,28,28,0
2024-07-31,26,DPD30-59,3,3,0
2024-07-31,26,DPD60-89,0,0,0
2024-07-31,26,DPD90+,0,0,0
2024-07-31,32,Current,0,0,0
2024-07-31,32,DPD15-29,115,115,0
2024-07-31,32,DPD3-14,176,176,0
2024-07-31,32,DPD30-59,38,38,0
2024-07-31,32,DPD60-89,0,0,0
2024-07-31,32,DPD90+,0,0,0
2024-07-31,34,Current,0,0,0
2024-07-31,34,DPD15-29,39,39,0
2024-07-31,34,DPD3-14,64,64,0
2024-07-31,34,DPD30-59,22,22,0
2024-07-31,34,DPD60-89,0,0,0
2024-07-31,34,DPD90+,0,0,0
2024-07-31,36,Current,0,0,0
2024-07-31,36,DPD15-29,29,29,0
2024-07-31,36,DPD3-14,43,43,0
2024-07-31,36,DPD30-59,9,9,0
2024-07-31,36,DPD60-89,0,0,0
2024-07-31,36,DPD90+,0,0,0
2024-07-31,38,Current,15,15,0
2024-07-31,38,DPD15-29,25,25,0
2024-07-31,38,DPD3-14,58,58,0
2024-07-31,38,DPD30-59,10,10,0
2024-07-31,38,DPD60-89,0,0,0
2024-07-31,38,DPD90+,0,0,0
2024-07-31,40,Current,0,0,0
2024-07-31,40,DPD15-29,19,19,0
2024-07-31,40,DPD3-14,30,30,0
2024-07-31,40,DPD30-59,8,8,0
2024-07-31,40,DPD60-89,0,0,0
2024-07-31,40,DPD90+,0,0,0
2024-07-31,42,Current,0,0,0
2024-07-31,42,DPD15-29,17,17,0
2024-07-31,42,DPD3-14,18,18,0
2024-07-31,42,DPD30-59,6,6,0
2024-07-31,42,DPD60-89,0,0,0
2024-07-31,42,DPD90+,0,0,0
2024-07-31,44,Current,0,0,0
2024-07-31,44,DPD15-29,32,32,0
2024-07-31,44,DPD3-14,51,51,0
2024-07-31,44,DPD30-59,11,11,0
2024-07-31,44,DPD60-89,0,0,0
2024-07-31,44,DPD90+,0,0,0
2024-07-31,46,Current,0,0,0
2024-07-31,46,DPD15-29,1,1,0
2024-07-31,48,Current,14,14,0
2024-07-31,48,DPD15-29,23,23,0
2024-07-31,48,DPD3-14,40,40,0
2024-07-31,48,DPD30-59,9,9,0
2024-07-31,48,DPD60-89,0,0,0
2024-07-31,48,DPD90+,0,0,0
2024-07-31,6,Current,0,0,0
2024-07-30,100,Current,0,0,0
2024-07-30,100,DPD3-14,1,1,0
2024-07-30,102,Current,0,0,0
2024-07-30,102,DPD3-14,1,1,0
2024-07-30,102,DPD30-59,0,0,0
2024-07-30,102,DPD90+,0,0,0
2024-07-30,104,Current,0,0,0
2024-07-30,104,DPD3-14,0,0,0
2024-07-30,104,DPD90+,0,0,0
2024-07-30,20,Current,0,0,0
2024-07-30,20,DPD15-29,173,173,0
2024-07-30,20,DPD3-14,371,371,0
2024-07-30,20,DPD30-59,112,112,0
2024-07-30,20,DPD60-89,59,59,0
2024-07-30,20,DPD90+,73,73,0
2024-07-30,22,Current,0,0,0
2024-07-30,22,DPD3-14,2,2,0
2024-07-30,22,DPD30-59,0,0,0
2024-07-30,22,DPD60-89,0,0,0
2024-07-30,24,Current,31,31,0
2024-07-30,24,DPD15-29,101,101,0
2024-07-30,24,DPD3-14,231,231,0
2024-07-30,24,DPD30-59,64,64,0
2024-07-30,24,DPD60-89,0,0,0
2024-07-30,24,DPD90+,0,0,0
2024-07-30,26,Current,0,0,0
2024-07-30,26,DPD15-29,14,14,0
2024-07-30,26,DPD3-14,27,27,0
2024-07-30,26,DPD30-59,7,7,0
2024-07-30,26,DPD60-89,0,0,0
2024-07-30,26,DPD90+,0,0,0
2024-07-30,32,Current,0,0,0
2024-07-30,32,DPD15-29,62,62,0
2024-07-30,32,DPD3-14,164,164,0
2024-07-30,32,DPD30-59,64,64,0
2024-07-30,32,DPD60-89,0,0,0
2024-07-30,32,DPD90+,0,0,0
2024-07-30,34,Current,0,0,0
2024-07-30,34,DPD15-29,39,39,0
2024-07-30,34,DPD3-14,68,68,0
2024-07-30,34,DPD30-59,21,21,0
2024-07-30,34,DPD60-89,0,0,0
2024-07-30,34,DPD90+,0,0,0
2024-07-30,36,Current,0,0,0
2024-07-30,36,DPD15-29,16,16,0
2024-07-30,36,DPD3-14,54,54,0
2024-07-30,36,DPD30-59,15,15,0
2024-07-30,36,DPD60-89,0,0,0
2024-07-30,36,DPD90+,0,0,0
2024-07-30,38,Current,10,10,0
2024-07-30,38,DPD15-29,20,20,0
2024-07-30,38,DPD3-14,61,61,0
2024-07-30,38,DPD30-59,13,13,0
2024-07-30,38,DPD60-89,0,0,0
2024-07-30,38,DPD90+,0,0,0
2024-07-30,40,Current,0,0,0
2024-07-30,40,DPD15-29,20,20,0
2024-07-30,40,DPD3-14,25,25,0
2024-07-30,40,DPD30-59,4,4,0
2024-07-30,40,DPD60-89,0,0,0
2024-07-30,40,DPD90+,0,0,0
2024-07-30,42,Current,0,0,0
2024-07-30,42,DPD15-29,13,13,0
2024-07-30,42,DPD3-14,25,25,0
2024-07-30,42,DPD30-59,13,13,0
2024-07-30,42,DPD60-89,0,0,0
2024-07-30,42,DPD90+,0,0,0
2024-07-30,44,Current,0,0,0
2024-07-30,44,DPD15-29,19,19,0
2024-07-30,44,DPD3-14,50,50,0
2024-07-30,44,DPD30-59,11,11,0
2024-07-30,44,DPD60-89,0,0,0
2024-07-30,44,DPD90+,0,0,0
2024-07-30,46,Current,0,0,0
2024-07-30,46,DPD15-29,0,0,0
2024-07-30,48,Current,24,24,0
2024-07-30,48,DPD15-29,16,16,0
2024-07-30,48,DPD3-14,28,28,0
2024-07-30,48,DPD30-59,9,9,0
2024-07-30,48,DPD60-89,0,0,0
2024-07-30,48,DPD90+,0,0,0
2024-07-30,6,Current,0,0,0
2024-07-29,100,Current,0,0,0
2024-07-29,100,DPD3-14,0,0,0
2024-07-29,102,Current,0,0,0
2024-07-29,102,DPD3-14,0,0,0
2024-07-29,102,DPD30-59,0,0,0
2024-07-29,102,DPD90+,0,0,0
2024-07-29,104,Current,0,0,0
2024-07-29,104,DPD3-14,0,0,0
2024-07-29,104,DPD60-89,0,0,0
2024-07-29,20,Current,0,0,0
2024-07-29,20,DPD15-29,171,171,0
2024-07-29,20,DPD3-14,469,469,0
2024-07-29,20,DPD30-59,70,70,0
2024-07-29,20,DPD60-89,14,14,0
2024-07-29,20,DPD90+,17,17,0
2024-07-29,22,Current,0,0,0
2024-07-29,22,DPD3-14,2,2,0
2024-07-29,22,DPD30-59,0,0,0
2024-07-29,22,DPD60-89,0,0,0
2024-07-29,24,Current,30,30,0
2024-07-29,24,DPD15-29,94,94,0
2024-07-29,24,DPD3-14,267,267,0
2024-07-29,24,DPD30-59,40,40,0
2024-07-29,24,DPD60-89,0,0,0
2024-07-29,24,DPD90+,0,0,0
2024-07-29,26,Current,0,0,0
2024-07-29,26,DPD15-29,7,7,0
2024-07-29,26,DPD3-14,30,30,0
2024-07-29,26,DPD30-59,2,2,0
2024-07-29,26,DPD60-89,0,0,0
2024-07-29,26,DPD90+,0,0,0
2024-07-29,32,Current,0,0,0
2024-07-29,32,DPD15-29,83,83,0
2024-07-29,32,DPD3-14,226,226,0
2024-07-29,32,DPD30-59,38,38,0
2024-07-29,32,DPD60-89,0,0,0
2024-07-29,32,DPD90+,0,0,0
2024-07-29,34,Current,0,0,0
2024-07-29,34,DPD15-29,28,28,0
2024-07-29,34,DPD3-14,81,81,0
2024-07-29,34,DPD30-59,8,8,0
2024-07-29,34,DPD60-89,0,0,0
2024-07-29,34,DPD90+,0,0,0
2024-07-29,36,Current,0,0,0
2024-07-29,36,DPD15-29,20,20,0
2024-07-29,36,DPD3-14,59,59,0
2024-07-29,36,DPD30-59,14,14,0
2024-07-29,36,DPD60-89,0,0,0
2024-07-29,36,DPD90+,0,0,0
2024-07-29,38,Current,14,14,0
2024-07-29,38,DPD15-29,18,18,0
2024-07-29,38,DPD3-14,66,66,0
2024-07-29,38,DPD30-59,14,14,0
2024-07-29,38,DPD60-89,0,0,0
2024-07-29,38,DPD90+,0,0,0
2024-07-29,40,Current,0,0,0
2024-07-29,40,DPD15-29,12,12,0
2024-07-29,40,DPD3-14,37,37,0
2024-07-29,40,DPD30-59,7,7,0
2024-07-29,40,DPD60-89,0,0,0
2024-07-29,40,DPD90+,0,0,0
2024-07-29,42,Current,0,0,0
2024-07-29,42,DPD15-29,8,8,0
2024-07-29,42,DPD3-14,29,29,0
2024-07-29,42,DPD30-59,4,4,0
2024-07-29,42,DPD60-89,0,0,0
2024-07-29,42,DPD90+,0,0,0
2024-07-29,44,Current,0,0,0
2024-07-29,44,DPD15-29,27,27,0
2024-07-29,44,DPD3-14,65,65,0
2024-07-29,44,DPD30-59,3,3,0
2024-07-29,44,DPD60-89,0,0,0
2024-07-29,44,DPD90+,0,0,0
2024-07-29,46,Current,0,0,0
2024-07-29,46,DPD15-29,1,1,0
2024-07-29,48,Current,21,21,0
2024-07-29,48,DPD15-29,20,20,0
2024-07-29,48,DPD3-14,51,51,0
2024-07-29,48,DPD30-59,7,7,0
2024-07-29,48,DPD60-89,0,0,0
2024-07-29,48,DPD90+,0,0,0
2024-07-29,6,Current,0,0,0
2024-07-28,100,Current,0,0,0
2024-07-28,102,Current,0,0,0
2024-07-28,102,DPD3-14,1,1,0
2024-07-28,102,DPD30-59,0,0,0
2024-07-28,102,DPD90+,0,0,0
2024-07-28,104,Current,0,0,0
2024-07-28,104,DPD3-14,0,0,0
2024-07-28,104,DPD60-89,0,0,0
2024-07-28,20,Current,0,0,0
2024-07-28,20,DPD15-29,183,183,0
2024-07-28,20,DPD3-14,352,352,0
2024-07-28,20,DPD30-59,126,126,0
2024-07-28,20,DPD60-89,37,37,0
2024-07-28,20,DPD90+,20,20,0
2024-07-28,22,Current,0,0,0
2024-07-28,22,DPD3-14,1,1,0
2024-07-28,22,DPD30-59,0,0,0
2024-07-28,22,DPD60-89,0,0,0
2024-07-28,24,Current,88,88,0
2024-07-28,24,DPD15-29,94,94,0
2024-07-28,24,DPD3-14,220,220,0
2024-07-28,24,DPD30-59,70,70,0
2024-07-28,24,DPD60-89,0,0,0
2024-07-28,24,DPD90+,0,0,0
2024-07-28,26,Current,0,0,0
2024-07-28,26,DPD15-29,12,12,0
2024-07-28,26,DPD3-14,22,22,0
2024-07-28,26,DPD30-59,6,6,0
2024-07-28,26,DPD60-89,0,0,0
2024-07-28,26,DPD90+,0,0,0
2024-07-28,32,Current,0,0,0
2024-07-28,32,DPD15-29,61,61,0
2024-07-28,32,DPD3-14,161,161,0
2024-07-28,32,DPD30-59,47,47,0
2024-07-28,32,DPD60-89,0,0,0
2024-07-28,32,DPD90+,0,0,0
2024-07-28,34,Current,0,0,0
2024-07-28,34,DPD15-29,34,34,0
2024-07-28,34,DPD3-14,77,77,0
2024-07-28,34,DPD30-59,12,12,0
2024-07-28,34,DPD60-89,0,0,0
2024-07-28,34,DPD90+,0,0,0
2024-07-28,36,Current,0,0,0
2024-07-28,36,DPD15-29,17,17,0
2024-07-28,36,DPD3-14,47,47,0
2024-07-28,36,DPD30-59,24,24,0
2024-07-28,36,DPD60-89,0,0,0
2024-07-28,36,DPD90+,0,0,0
2024-07-28,38,Current,18,18,0
2024-07-28,38,DPD15-29,15,15,0
2024-07-28,38,DPD3-14,67,67,0
2024-07-28,38,DPD30-59,19,19,0
2024-07-28,38,DPD60-89,0,0,0
2024-07-28,38,DPD90+,0,0,0
2024-07-28,40,Current,0,0,0
2024-07-28,40,DPD15-29,21,21,0
2024-07-28,40,DPD3-14,28,28,0
2024-07-28,40,DPD30-59,11,11,0
2024-07-28,40,DPD60-89,0,0,0
2024-07-28,40,DPD90+,0,0,0
2024-07-28,42,Current,0,0,0
2024-07-28,42,DPD15-29,13,13,0
2024-07-28,42,DPD3-14,20,20,0
2024-07-28,42,DPD30-59,7,7,0
2024-07-28,42,DPD60-89,0,0,0
2024-07-28,42,DPD90+,0,0,0
2024-07-28,44,Current,0,0,0
2024-07-28,44,DPD15-29,18,18,0
2024-07-28,44,DPD3-14,45,45,0
2024-07-28,44,DPD30-59,15,15,0
2024-07-28,44,DPD60-89,0,0,0
2024-07-28,44,DPD90+,0,0,0
2024-07-28,46,Current,0,0,0
2024-07-28,46,DPD15-29,0,0,0
2024-07-28,48,Current,49,49,0
2024-07-28,48,DPD15-29,14,14,0
2024-07-28,48,DPD3-14,25,25,0
2024-07-28,48,DPD30-59,6,6,0
2024-07-28,48,DPD60-89,0,0,0
2024-07-28,48,DPD90+,0,0,0
2024-07-28,6,Current,0,0,0
2024-07-27,100,Current,0,0,0
2024-07-27,102,Current,0,0,0
2024-07-27,102,DPD3-14,0,0,0
2024-07-27,102,DPD30-59,0,0,0
2024-07-27,102,DPD90+,0,0,0
2024-07-27,104,Current,0,0,0
2024-07-27,104,DPD3-14,0,0,0
2024-07-27,104,DPD60-89,0,0,0
2024-07-27,20,Current,0,0,0
2024-07-27,20,DPD15-29,157,157,0
2024-07-27,20,DPD3-14,411,411,0
2024-07-27,20,DPD30-59,81,81,0
2024-07-27,20,DPD60-89,36,36,0
2024-07-27,20,DPD90+,42,42,0
2024-07-27,22,Current,0,0,0
2024-07-27,22,DPD3-14,2,2,0
2024-07-27,22,DPD30-59,0,0,0
2024-07-27,22,DPD60-89,0,0,0
2024-07-27,24,Current,64,64,0
2024-07-27,24,DPD15-29,96,96,0
2024-07-27,24,DPD3-14,237,237,0
2024-07-27,24,DPD30-59,34,34,0
2024-07-27,24,DPD60-89,0,0,0
2024-07-27,24,DPD90+,0,0,0
2024-07-27,26,Current,0,0,0
2024-07-27,26,DPD15-29,7,7,0
2024-07-27,26,DPD3-14,27,27,0
2024-07-27,26,DPD30-59,3,3,0
2024-07-27,26,DPD60-89,0,0,0
2024-07-27,26,DPD90+,0,0,0
2024-07-27,32,Current,0,0,0
2024-07-27,32,DPD15-29,86,86,0
2024-07-27,32,DPD3-14,195,195,0
2024-07-27,32,DPD30-59,38,38,0
2024-07-27,32,DPD60-89,0,0,0
2024-07-27,32,DPD90+,0,0,0
2024-07-27,34,Current,0,0,0
2024-07-27,34,DPD15-29,24,24,0
2024-07-27,34,DPD3-14,73,73,0
2024-07-27,34,DPD30-59,21,21,0
2024-07-27,34,DPD60-89,0,0,0
2024-07-27,34,DPD90+,0,0,0
2024-07-27,36,Current,0,0,0
2024-07-27,36,DPD15-29,21,21,0
2024-07-27,36,DPD3-14,51,51,0
2024-07-27,36,DPD30-59,7,7,0
2024-07-27,36,DPD60-89,0,0,0
2024-07-27,36,DPD90+,0,0,0
2024-07-27,38,Current,10,10,0
2024-07-27,38,DPD15-29,18,18,0
2024-07-27,38,DPD3-14,54,54,0
2024-07-27,38,DPD30-59,10,10,0
2024-07-27,38,DPD60-89,0,0,0
2024-07-27,38,DPD90+,0,0,0
2024-07-27,40,Current,0,0,0
2024-07-27,40,DPD15-29,11,11,0
2024-07-27,40,DPD3-14,29,29,0
2024-07-27,40,DPD30-59,7,7,0
2024-07-27,40,DPD60-89,0,0,0
2024-07-27,40,DPD90+,0,0,0
2024-07-27,42,Current,0,0,0
2024-07-27,42,DPD15-29,6,6,0
2024-07-27,42,DPD3-14,27,27,0
2024-07-27,42,DPD30-59,8,8,0
2024-07-27,42,DPD60-89,0,0,0
2024-07-27,42,DPD90+,0,0,0
2024-07-27,44,Current,0,0,0
2024-07-27,44,DPD15-29,22,22,0
2024-07-27,44,DPD3-14,57,57,0
2024-07-27,44,DPD30-59,10,10,0
2024-07-27,44,DPD60-89,0,0,0
2024-07-27,44,DPD90+,0,0,0
2024-07-27,46,Current,0,0,0
2024-07-27,46,DPD15-29,1,1,0
2024-07-27,48,Current,34,34,0
2024-07-27,48,DPD15-29,14,14,0
2024-07-27,48,DPD3-14,44,44,0
2024-07-27,48,DPD30-59,10,10,0
2024-07-27,48,DPD60-89,0,0,0
2024-07-27,48,DPD90+,0,0,0
2024-07-27,6,Current,0,0,0
2024-07-26,100,Current,0,0,0
2024-07-26,102,Current,0,0,0
2024-07-26,102,DPD30-59,0,0,0
2024-07-26,102,DPD90+,0,0,0
2024-07-26,104,Current,0,0,0
2024-07-26,104,DPD3-14,0,0,0
2024-07-26,104,DPD60-89,0,0,0
2024-07-26,20,Current,0,0,0
2024-07-26,20,DPD15-29,189,189,0
2024-07-26,20,DPD3-14,335,335,0
2024-07-26,20,DPD30-59,98,98,0
2024-07-26,20,DPD60-89,61,61,0
2024-07-26,20,DPD90+,39,39,0
2024-07-26,22,Current,0,0,0
2024-07-26,22,DPD15-29,0,0,0
2024-07-26,22,DPD3-14,1,1,0
2024-07-26,22,DPD30-59,0,0,0
2024-07-26,22,DPD60-89,0,0,0
2024-07-26,24,Current,79,79,0
2024-07-26,24,DPD15-29,110,110,0
2024-07-26,24,DPD3-14,210,210,0
2024-07-26,24,DPD30-59,48,48,0
2024-07-26,24,DPD60-89,0,0,0
2024-07-26,24,DPD90+,0,0,0
2024-07-26,26,Current,0,0,0
2024-07-26,26,DPD15-29,11,11,0
2024-07-26,26,DPD3-14,21,21,0
2024-07-26,26,DPD30-59,7,7,0
2024-07-26,26,DPD60-89,0,0,0
2024-07-26,26,DPD90+,0,0,0
2024-07-26,32,Current,0,0,0
2024-07-26,32,DPD15-29,74,74,0
2024-07-26,32,DPD3-14,146,146,0
2024-07-26,32,DPD30-59,55,55,0
2024-07-26,32,DPD60-89,0,0,0
2024-07-26,32,DPD90+,0,0,0
2024-07-26,34,Current,0,0,0
2024-07-26,34,DPD15-29,33,33,0
2024-07-26,34,DPD3-14,76,76,0
2024-07-26,34,DPD30-59,13,13,0
2024-07-26,34,DPD60-89,0,0,0
2024-07-26,34,DPD90+,0,0,0
2024-07-26,36,Current,0,0,0
2024-07-26,36,DPD15-29,21,21,0
2024-07-26,36,DPD3-14,52,52,0
2024-07-26,36,DPD30-59,12,12,0
2024-07-26,36,DPD60-89,0,0,0
2024-07-26,36,DPD90+,0,0,0
2024-07-26,38,Current,10,10,0
2024-07-26,38,DPD15-29,21,21,0
2024-07-26,38,DPD3-14,64,64,0
2024-07-26,38,DPD30-59,15,15,0
2024-07-26,38,DPD60-89,0,0,0
2024-07-26,38,DPD90+,0,0,0
2024-07-26,40,Current,0,0,0
2024-07-26,40,DPD15-29,26,26,0
2024-07-26,40,DPD3-14,29,29,0
2024-07-26,40,DPD30-59,6,6,0
2024-07-26,40,DPD60-89,0,0,0
2024-07-26,40,DPD90+,0,0,0
2024-07-26,42,Current,0,0,0
2024-07-26,42,DPD15-29,10,10,0
2024-07-26,42,DPD3-14,20,20,0
2024-07-26,42,DPD30-59,8,8,0
2024-07-26,42,DPD60-89,0,0,0
2024-07-26,42,DPD90+,0,0,0
2024-07-26,44,Current,0,0,0
2024-07-26,44,DPD15-29,18,18,0
2024-07-26,44,DPD3-14,47,47,0
2024-07-26,44,DPD30-59,9,9,0
2024-07-26,44,DPD60-89,0,0,0
2024-07-26,44,DPD90+,0,0,0
2024-07-26,46,Current,0,0,0
2024-07-26,46,DPD15-29,0,0,0
2024-07-26,48,Current,43,43,0
2024-07-26,48,DPD15-29,15,15,0
2024-07-26,48,DPD3-14,29,29,0
2024-07-26,48,DPD30-59,12,12,0
2024-07-26,48,DPD60-89,0,0,0
2024-07-26,48,DPD90+,0,0,0
2024-07-26,6,Current,0,0,0
2024-07-25,100,Current,0,0,0
2024-07-25,100,DPD15-29,0,0,0
2024-07-25,102,Current,0,0,0
2024-07-25,102,DPD60-89,0,0,0
2024-07-25,102,DPD90+,0,0,0
2024-07-25,104,Current,0,0,0
2024-07-25,104,DPD3-14,0,0,0
2024-07-25,104,DPD60-89,0,0,0
2024-07-25,20,Current,0,0,0
2024-07-25,20,DPD15-29,172,172,0
2024-07-25,20,DPD3-14,372,372,0
2024-07-25,20,DPD30-59,76,76,0
2024-07-25,20,DPD60-89,19,19,0
2024-07-25,20,DPD90+,3,3,0
2024-07-25,22,Current,0,0,0
2024-07-25,22,DPD15-29,0,0,0
2024-07-25,22,DPD3-14,2,2,0
2024-07-25,22,DPD30-59,0,0,0
2024-07-25,22,DPD60-89,0,0,0
2024-07-25,24,Current,31,31,0
2024-07-25,24,DPD15-29,92,92,0
2024-07-25,24,DPD3-14,237,237,0
2024-07-25,24,DPD30-59,44,44,0
2024-07-25,24,DPD60-89,0,0,0
2024-07-25,24,DPD90+,0,0,0
2024-07-25,26,Current,0,0,0
2024-07-25,26,DPD15-29,10,10,0
2024-07-25,26,DPD3-14,28,28,0
2024-07-25,26,DPD30-59,5,5,0
2024-07-25,26,DPD60-89,0,0,0
2024-07-25,26,DPD90+,0,0,0
2024-07-25,32,Current,0,0,0
2024-07-25,32,DPD15-29,81,81,0
2024-07-25,32,DPD3-14,173,173,0
2024-07-25,32,DPD30-59,38,38,0
2024-07-25,32,DPD60-89,0,0,0
2024-07-25,32,DPD90+,0,0,0
2024-07-25,34,Current,0,0,0
2024-07-25,34,DPD15-29,28,28,0
2024-07-25,34,DPD3-14,70,70,0
2024-07-25,34,DPD30-59,12,12,0
2024-07-25,34,DPD60-89,0,0,0
2024-07-25,34,DPD90+,0,0,0
2024-07-25,36,Current,0,0,0
2024-07-25,36,DPD15-29,21,21,0
2024-07-25,36,DPD3-14,43,43,0
2024-07-25,36,DPD30-59,10,10,0
2024-07-25,36,DPD60-89,0,0,0
2024-07-25,36,DPD90+,0,0,0
2024-07-25,38,Current,8,8,0
2024-07-25,38,DPD15-29,19,19,0
2024-07-25,38,DPD3-14,51,51,0
2024-07-25,38,DPD30-59,17,17,0
2024-07-25,38,DPD60-89,0,0,0
2024-07-25,38,DPD90+,0,0,0
2024-07-25,40,Current,0,0,0
2024-07-25,40,DPD15-29,10,10,0
2024-07-25,40,DPD3-14,38,38,0
2024-07-25,40,DPD30-59,9,9,0
2024-07-25,40,DPD60-89,0,0,0
2024-07-25,40,DPD90+,0,0,0
2024-07-25,42,Current,0,0,0
2024-07-25,42,DPD15-29,10,10,0
2024-07-25,42,DPD3-14,23,23,0
2024-07-25,42,DPD30-59,6,6,0
2024-07-25,42,DPD60-89,0,0,0
2024-07-25,42,DPD90+,0,0,0
2024-07-25,44,Current,0,0,0
2024-07-25,44,DPD15-29,24,24,0
2024-07-25,44,DPD3-14,52,52,0
2024-07-25,44,DPD30-59,9,9,0
2024-07-25,44,DPD60-89,0,0,0
2024-07-25,44,DPD90+,0,0,0
2024-07-25,46,Current,0,0,0
2024-07-25,46,DPD15-29,1,1,0
2024-07-25,48,Current,20,20,0
2024-07-25,48,DPD15-29,12,12,0
2024-07-25,48,DPD3-14,43,43,0
2024-07-25,48,DPD30-59,10,10,0
2024-07-25,48,DPD60-89,0,0,0
2024-07-25,48,DPD90+,0,0,0
2024-07-25,6,Current,0,0,0
2024-07-24,100,Current,0,0,0
2024-07-24,100,DPD15-29,0,0,0
2024-07-24,102,Current,0,0,0
2024-07-24,102,DPD60-89,0,0,0
2024-07-24,102,DPD90+,0,0,0
2024-07-24,104,Current,0,0,0
2024-07-24,104,DPD60-89,0,0,0
2024-07-24,20,Current,0,0,0
2024-07-24,20,DPD15-29,198,198,0
2024-07-24,20,DPD3-14,345,345,0
2024-07-24,20,DPD30-59,100,100,0
2024-07-24,20,DPD60-89,19,19,0
2024-07-24,20,DPD90+,5,5,0
2024-07-24,22,Current,0,0,0
2024-07-24,22,DPD15-29,1,1,0
2024-07-24,22,DPD3-14,0,0,0
2024-07-24,22,DPD30-59,0,0,0
2024-07-24,22,DPD60-89,0,0,0
2024-07-24,24,Current,44,44,0
2024-07-24,24,DPD15-29,104,104,0
2024-07-24,24,DPD3-14,204,204,0
2024-07-24,24,DPD30-59,49,49,0
2024-07-24,24,DPD60-89,0,0,0
2024-07-24,24,DPD90+,0,0,0
2024-07-24,26,Current,0,0,0
2024-07-24,26,DPD15-29,12,12,0
2024-07-24,26,DPD3-14,23,23,0
2024-07-24,26,DPD30-59,4,4,0
2024-07-24,26,DPD60-89,0,0,0
2024-07-24,26,DPD90+,0,0,0
2024-07-24,32,Current,0,0,0
2024-07-24,32,DPD15-29,86,86,0
2024-07-24,32,DPD3-14,138,138,0
2024-07-24,32,DPD30-59,41,41,0
2024-07-24,32,DPD60-89,0,0,0
2024-07-24,32,DPD90+,0,0,0
2024-07-24,34,Current,0,0,0
2024-07-24,34,DPD15-29,32,32,0
2024-07-24,34,DPD3-14,68,68,0
2024-07-24,34,DPD30-59,15,15,0
2024-07-24,34,DPD60-89,0,0,0
2024-07-24,34,DPD90+,0,0,0
2024-07-24,36,Current,0,0,0
2024-07-24,36,DPD15-29,18,18,0
2024-07-24,36,DPD3-14,50,50,0
2024-07-24,36,DPD30-59,20,20,0
2024-07-24,36,DPD60-89,0,0,0
2024-07-24,36,DPD90+,0,0,0
2024-07-24,38,Current,5,5,0
2024-07-24,38,DPD15-29,24,24,0
2024-07-24,38,DPD3-14,59,59,0
2024-07-24,38,DPD30-59,10,10,0
2024-07-24,38,DPD60-89,0,0,0
2024-07-24,38,DPD90+,0,0,0
2024-07-24,40,Current,0,0,0
2024-07-24,40,DPD15-29,22,22,0
2024-07-24,40,DPD3-14,40,40,0
2024-07-24,40,DPD30-59,9,9,0
2024-07-24,40,DPD60-89,0,0,0
2024-07-24,40,DPD90+,0,0,0
2024-07-24,42,Current,0,0,0
2024-07-24,42,DPD15-29,14,14,0
2024-07-24,42,DPD3-14,20,20,0
2024-07-24,42,DPD30-59,5,5,0
2024-07-24,42,DPD60-89,0,0,0
2024-07-24,42,DPD90+,0,0,0
2024-07-24,44,Current,0,0,0
2024-07-24,44,DPD15-29,17,17,0
2024-07-24,44,DPD3-14,58,58,0
2024-07-24,44,DPD30-59,15,15,0
2024-07-24,44,DPD60-89,0,0,0
2024-07-24,44,DPD90+,0,0,0
2024-07-24,46,Current,0,0,0
2024-07-24,46,DPD15-29,0,0,0
2024-07-24,48,Current,14,14,0
2024-07-24,48,DPD15-29,15,15,0
2024-07-24,48,DPD3-14,27,27,0
2024-07-24,48,DPD30-59,6,6,0
2024-07-24,48,DPD60-89,0,0,0
2024-07-24,48,DPD90+,0,0,0
2024-07-24,6,Current,0,0,0
2024-07-23,100,Current,0,0,0
2024-07-23,100,DPD15-29,0,0,0
2024-07-23,102,Current,0,0,0
2024-07-23,102,DPD60-89,0,0,0
2024-07-23,102,DPD90+,0,0,0
2024-07-23,104,Current,0,0,0
2024-07-23,104,DPD60-89,0,0,0
2024-07-23,20,Current,0,0,0
2024-07-23,20,DPD15-29,204,204,0
2024-07-23,20,DPD3-14,378,378,0
2024-07-23,20,DPD30-59,95,95,0
2024-07-23,20,DPD60-89,18,18,0
2024-07-23,20,DPD90+,12,12,0
2024-07-23,22,Current,0,0,0
2024-07-23,22,DPD15-29,0,0,0
2024-07-23,22,DPD3-14,1,1,0
2024-07-23,22,DPD30-59,0,0,0
2024-07-23,22,DPD60-89,0,0,0
2024-07-23,24,Current,39,39,0
2024-07-23,24,DPD15-29,99,99,0
2024-07-23,24,DPD3-14,246,246,0
2024-07-23,24,DPD30-59,47,47,0
2024-07-23,24,DPD60-89,0,0,0
2024-07-23,24,DPD90+,0,0,0
2024-07-23,26,Current,0,0,0
2024-07-23,26,DPD15-29,11,11,0
2024-07-23,26,DPD3-14,30,30,0
2024-07-23,26,DPD30-59,4,4,0
2024-07-23,26,DPD60-89,0,0,0
2024-07-23,26,DPD90+,0,0,0
2024-07-23,32,Current,0,0,0
2024-07-23,32,DPD15-29,91,91,0
2024-07-23,32,DPD3-14,169,169,0
2024-07-23,32,DPD30-59,50,50,0
2024-07-23,32,DPD60-89,0,0,0
2024-07-23,32,DPD90+,0,0,0
2024-07-23,34,Current,0,0,0
2024-07-23,34,DPD15-29,40,40,0
2024-07-23,34,DPD3-14,71,71,0
2024-07-23,34,DPD30-59,19,19,0
2024-07-23,34,DPD60-89,0,0,0
2024-07-23,34,DPD90+,0,0,0
2024-07-23,36,Current,0,0,0
2024-07-23,36,DPD15-29,26,26,0
2024-07-23,36,DPD3-14,47,47,0
2024-07-23,36,DPD30-59,12,12,0
2024-07-23,36,DPD60-89,0,0,0
2024-07-23,36,DPD90+,0,0,0
2024-07-23,38,Current,7,7,0
2024-07-23,38,DPD15-29,26,26,0
2024-07-23,38,DPD3-14,55,55,0
2024-07-23,38,DPD30-59,14,14,0
2024-07-23,38,DPD60-89,0,0,0
2024-07-23,38,DPD90+,0,0,0
2024-07-23,40,Current,0,0,0
2024-07-23,40,DPD15-29,18,18,0
2024-07-23,40,DPD3-14,33,33,0
2024-07-23,40,DPD30-59,4,4,0
2024-07-23,40,DPD60-89,0,0,0
2024-07-23,40,DPD90+,0,0,0
2024-07-23,42,Current,0,0,0
2024-07-23,42,DPD15-29,11,11,0
2024-07-23,42,DPD3-14,28,28,0
2024-07-23,42,DPD30-59,7,7,0
2024-07-23,42,DPD60-89,0,0,0
2024-07-23,42,DPD90+,0,0,0
2024-07-23,44,Current,0,0,0
2024-07-23,44,DPD15-29,30,30,0
2024-07-23,44,DPD3-14,51,51,0
2024-07-23,44,DPD30-59,10,10,0
2024-07-23,44,DPD60-89,0,0,0
2024-07-23,44,DPD90+,0,0,0
2024-07-23,46,Current,0,0,0
2024-07-23,46,DPD15-29,1,1,0
2024-07-23,48,Current,23,23,0
2024-07-23,48,DPD15-29,15,15,0
2024-07-23,48,DPD3-14,42,42,0
2024-07-23,48,DPD30-59,15,15,0
2024-07-23,48,DPD60-89,0,0,0
2024-07-23,48,DPD90+,0,0,0
2024-07-23,6,Current,0,0,0
2024-07-22,100,Current,0,0,0
2024-07-22,100,DPD15-29,0,0,0
2024-07-22,102,Current,0,0,0
2024-07-22,102,DPD60-89,0,0,0
2024-07-22,102,DPD90+,0,0,0
2024-07-22,104,Current,0,0,0
2024-07-22,104,DPD60-89,0,0,0
2024-07-22,20,Current,0,0,0
2024-07-22,20,DPD15-29,207,207,0
2024-07-22,20,DPD3-14,349,349,0
2024-07-22,20,DPD30-59,114,114,0
2024-07-22,20,DPD60-89,76,76,0
2024-07-22,20,DPD90+,75,75,0
2024-07-22,22,Current,0,0,0
2024-07-22,22,DPD15-29,1,1,0
2024-07-22,22,DPD3-14,0,0,0
2024-07-22,22,DPD30-59,0,0,0
2024-07-22,22,DPD60-89,0,0,0
2024-07-22,24,Current,45,45,0
2024-07-22,24,DPD15-29,122,122,0
2024-07-22,24,DPD3-14,220,220,0
2024-07-22,24,DPD30-59,55,55,0
2024-07-22,24,DPD60-89,0,0,0
2024-07-22,24,DPD90+,0,0,0
2024-07-22,26,Current,0,0,0
2024-07-22,26,DPD15-29,14,14,0
2024-07-22,26,DPD3-14,21,21,0
2024-07-22,26,DPD30-59,9,9,0
2024-07-22,26,DPD60-89,0,0,0
2024-07-22,26,DPD90+,0,0,0
2024-07-22,32,Current,0,0,0
2024-07-22,32,DPD15-29,87,87,0
2024-07-22,32,DPD3-14,144,144,0
2024-07-22,32,DPD30-59,68,68,0
2024-07-22,32,DPD60-89,0,0,0
2024-07-22,32,DPD90+,0,0,0
2024-07-22,34,Current,0,0,0
2024-07-22,34,DPD15-29,35,35,0
2024-07-22,34,DPD3-14,69,69,0
2024-07-22,34,DPD30-59,19,19,0
2024-07-22,34,DPD60-89,0,0,0
2024-07-22,34,DPD90+,0,0,0
2024-07-22,36,Current,0,0,0
2024-07-22,36,DPD15-29,23,23,0
2024-07-22,36,DPD3-14,44,44,0
2024-07-22,36,DPD30-59,13,13,0
2024-07-22,36,DPD60-89,0,0,0
2024-07-22,36,DPD90+,0,0,0
2024-07-22,38,Current,2,2,0
2024-07-22,38,DPD15-29,23,23,0
2024-07-22,38,DPD3-14,60,60,0
2024-07-22,38,DPD30-59,16,16,0
2024-07-22,38,DPD60-89,0,0,0
2024-07-22,38,DPD90+,0,0,0
2024-07-22,40,Current,0,0,0
2024-07-22,40,DPD15-29,19,19,0
2024-07-22,40,DPD3-14,43,43,0
2024-07-22,40,DPD30-59,10,10,0
2024-07-22,40,DPD60-89,0,0,0
2024-07-22,40,DPD90+,0,0,0
2024-07-22,42,Current,0,0,0
2024-07-22,42,DPD15-29,14,14,0
2024-07-22,42,DPD3-14,20,20,0
2024-07-22,42,DPD30-59,6,6,0
2024-07-22,42,DPD60-89,0,0,0
2024-07-22,42,DPD90+,0,0,0
2024-07-22,44,Current,0,0,0
2024-07-22,44,DPD15-29,20,20,0
2024-07-22,44,DPD3-14,56,56,0
2024-07-22,44,DPD30-59,11,11,0
2024-07-22,44,DPD60-89,0,0,0
2024-07-22,44,DPD90+,0,0,0
2024-07-22,46,Current,0,0,0
2024-07-22,46,DPD15-29,0,0,0
2024-07-22,48,Current,23,23,0
2024-07-22,48,DPD15-29,14,14,0
2024-07-22,48,DPD3-14,47,47,0
2024-07-22,48,DPD30-59,14,14,0
2024-07-22,48,DPD60-89,0,0,0
2024-07-22,48,DPD90+,0,0,0
2024-07-22,6,Current,0,0,0
2024-07-21,100,Current,0,0,0
2024-07-21,100,DPD15-29,0,0,0
2024-07-21,102,Current,0,0,0
2024-07-21,102,DPD3-14,1,1,0
2024-07-21,102,DPD60-89,0,0,0
2024-07-21,102,DPD90+,0,0,0
2024-07-21,104,Current,0,0,0
2024-07-21,104,DPD15-29,0,0,0
2024-07-21,104,DPD60-89,0,0,0
2024-07-21,20,Current,0,0,0
2024-07-21,20,DPD15-29,210,210,0
2024-07-21,20,DPD3-14,367,367,0
2024-07-21,20,DPD30-59,77,77,0
2024-07-21,20,DPD60-89,33,33,0
2024-07-21,20,DPD90+,39,39,0
2024-07-21,22,Current,0,0,0
2024-07-21,22,DPD15-29,0,0,0
2024-07-21,22,DPD3-14,1,1,0
2024-07-21,22,DPD30-59,0,0,0
2024-07-21,22,DPD60-89,0,0,0
2024-07-21,24,Current,42,42,0
2024-07-21,24,DPD15-29,93,93,0
2024-07-21,24,DPD3-14,231,231,0
2024-07-21,24,DPD30-59,42,42,0
2024-07-21,24,DPD60-89,0,0,0
2024-07-21,24,DPD90+,0,0,0
2024-07-21,26,Current,0,0,0
2024-07-21,26,DPD15-29,15,15,0
2024-07-21,26,DPD3-14,27,27,0
2024-07-21,26,DPD30-59,3,3,0
2024-07-21,26,DPD60-89,0,0,0
2024-07-21,26,DPD90+,0,0,0
2024-07-21,32,Current,0,0,0
2024-07-21,32,DPD15-29,93,93,0
2024-07-21,32,DPD3-14,173,173,0
2024-07-21,32,DPD30-59,37,37,0
2024-07-21,32,DPD60-89,0,0,0
2024-07-21,32,DPD90+,0,0,0
2024-07-21,34,Current,0,0,0
2024-07-21,34,DPD15-29,37,37,0
2024-07-21,34,DPD3-14,76,76,0
2024-07-21,34,DPD30-59,15,15,0
2024-07-21,34,DPD60-89,0,0,0
2024-07-21,34,DPD90+,0,0,0
2024-07-21,36,Current,0,0,0
2024-07-21,36,DPD15-29,28,28,0
2024-07-21,36,DPD3-14,47,47,0
2024-07-21,36,DPD30-59,8,8,0
2024-07-21,36,DPD60-89,0,0,0
2024-07-21,36,DPD90+,0,0,0
2024-07-21,38,Current,11,11,0
2024-07-21,38,DPD15-29,30,30,0
2024-07-21,38,DPD3-14,59,59,0
2024-07-21,38,DPD30-59,13,13,0
2024-07-21,38,DPD60-89,0,0,0
2024-07-21,38,DPD90+,0,0,0
2024-07-21,40,Current,0,0,0
2024-07-21,40,DPD15-29,16,16,0
2024-07-21,40,DPD3-14,36,36,0
2024-07-21,40,DPD30-59,7,7,0
2024-07-21,40,DPD60-89,0,0,0
2024-07-21,40,DPD90+,0,0,0
2024-07-21,42,Current,0,0,0
2024-07-21,42,DPD15-29,11,11,0
2024-07-21,42,DPD3-14,29,29,0
2024-07-21,42,DPD30-59,6,6,0
2024-07-21,42,DPD60-89,0,0,0
2024-07-21,42,DPD90+,0,0,0
2024-07-21,44,Current,0,0,0
2024-07-21,44,DPD15-29,23,23,0
2024-07-21,44,DPD3-14,55,55,0
2024-07-21,44,DPD30-59,5,5,0
2024-07-21,44,DPD60-89,0,0,0
2024-07-21,44,DPD90+,0,0,0
2024-07-21,46,Current,0,0,0
2024-07-21,46,DPD3-14,1,1,0
2024-07-21,48,Current,22,22,0
2024-07-21,48,DPD15-29,14,14,0
2024-07-21,48,DPD3-14,45,45,0
2024-07-21,48,DPD30-59,10,10,0
2024-07-21,48,DPD60-89,0,0,0
2024-07-21,48,DPD90+,0,0,0
2024-07-21,6,Current,0,0,0
2024-07-20,100,Current,0,0,0
2024-07-20,100,DPD15-29,0,0,0
2024-07-20,102,Current,0,0,0
2024-07-20,102,DPD3-14,0,0,0
2024-07-20,102,DPD60-89,0,0,0
2024-07-20,102,DPD90+,0,0,0
2024-07-20,104,Current,0,0,0
2024-07-20,104,DPD15-29,0,0,0
2024-07-20,104,DPD60-89,0,0,0
2024-07-20,20,Current,0,0,0
2024-07-20,20,DPD15-29,204,204,0
2024-07-20,20,DPD3-14,296,296,0
2024-07-20,20,DPD30-59,86,86,0
2024-07-20,20,DPD60-89,8,8,0
2024-07-20,20,DPD90+,5,5,0
2024-07-20,22,Current,0,0,0
2024-07-20,22,DPD15-29,1,1,0
2024-07-20,22,DPD3-14,0,0,0
2024-07-20,22,DPD30-59,0,0,0
2024-07-20,22,DPD60-89,0,0,0
2024-07-20,24,Current,47,47,0
2024-07-20,24,DPD15-29,111,111,0
2024-07-20,24,DPD3-14,192,192,0
2024-07-20,24,DPD30-59,47,47,0
2024-07-20,24,DPD60-89,0,0,0
2024-07-20,24,DPD90+,0,0,0
2024-07-20,26,Current,0,0,0
2024-07-20,26,DPD15-29,14,14,0
2024-07-20,26,DPD3-14,20,20,0
2024-07-20,26,DPD30-59,4,4,0
2024-07-20,26,DPD60-89,0,0,0
2024-07-20,26,DPD90+,0,0,0
2024-07-20,32,Current,0,0,0
2024-07-20,32,DPD15-29,93,93,0
2024-07-20,32,DPD3-14,123,123,0
2024-07-20,32,DPD30-59,37,37,0
2024-07-20,32,DPD60-89,0,0,0
2024-07-20,32,DPD90+,0,0,0
2024-07-20,34,Current,0,0,0
2024-07-20,34,DPD15-29,37,37,0
2024-07-20,34,DPD3-14,49,49,0
2024-07-20,34,DPD30-59,13,13,0
2024-07-20,34,DPD60-89,0,0,0
2024-07-20,34,DPD90+,0,0,0
2024-07-20,36,Current,0,0,0
2024-07-20,36,DPD15-29,26,26,0
2024-07-20,36,DPD3-14,37,37,0
2024-07-20,36,DPD30-59,19,19,0
2024-07-20,36,DPD60-89,0,0,0
2024-07-20,36,DPD90+,0,0,0
2024-07-20,38,Current,4,4,0
2024-07-20,38,DPD15-29,22,22,0
2024-07-20,38,DPD3-14,49,49,0
2024-07-20,38,DPD30-59,6,6,0
2024-07-20,38,DPD60-89,0,0,0
2024-07-20,38,DPD90+,0,0,0
2024-07-20,40,Current,0,0,0
2024-07-20,40,DPD15-29,14,14,0
2024-07-20,40,DPD3-14,42,42,0
2024-07-20,40,DPD30-59,5,5,0
2024-07-20,40,DPD60-89,0,0,0
2024-07-20,40,DPD90+,0,0,0
2024-07-20,42,Current,0,0,0
2024-07-20,42,DPD15-29,16,16,0
2024-07-20,42,DPD3-14,13,13,0
2024-07-20,42,DPD30-59,5,5,0
2024-07-20,42,DPD60-89,0,0,0
2024-07-20,42,DPD90+,0,0,0
2024-07-20,44,Current,0,0,0
2024-07-20,44,DPD15-29,15,15,0
2024-07-20,44,DPD3-14,50,50,0
2024-07-20,44,DPD30-59,15,15,0
2024-07-20,44,DPD60-89,0,0,0
2024-07-20,44,DPD90+,0,0,0
2024-07-20,46,Current,0,0,0
2024-07-20,46,DPD3-14,0,0,0
2024-07-20,48,Current,29,29,0
2024-07-20,48,DPD15-29,12,12,0
2024-07-20,48,DPD3-14,39,39,0
2024-07-20,48,DPD30-59,5,5,0
2024-07-20,48,DPD60-89,0,0,0
2024-07-20,48,DPD90+,0,0,0
2024-07-20,6,Current,0,0,0
2024-07-19,100,Current,0,0,0
2024-07-19,100,DPD15-29,0,0,0
2024-07-19,102,Current,0,0,0
2024-07-19,102,DPD3-14,1,1,0
2024-07-19,102,DPD60-89,0,0,0
2024-07-19,102,DPD90+,0,0,0
2024-07-19,104,Current,0,0,0
2024-07-19,104,DPD15-29,0,0,0
2024-07-19,104,DPD60-89,0,0,0
2024-07-19,20,Current,0,0,0
2024-07-19,20,DPD15-29,237,237,0
2024-07-19,20,DPD3-14,360,360,0
2024-07-19,20,DPD30-59,107,107,0
2024-07-19,20,DPD60-89,22,22,0
2024-07-19,20,DPD90+,55,55,0
2024-07-19,22,Current,0,0,0
2024-07-19,22,DPD15-29,0,0,0
2024-07-19,22,DPD3-14,1,1,0
2024-07-19,22,DPD30-59,0,0,0
2024-07-19,22,DPD60-89,0,0,0
2024-07-19,24,Current,76,76,0
2024-07-19,24,DPD15-29,112,112,0
2024-07-19,24,DPD3-14,208,208,0
2024-07-19,24,DPD30-59,52,52,0
2024-07-19,24,DPD60-89,0,0,0
2024-07-19,24,DPD90+,0,0,0
2024-07-19,26,Current,0,0,0
2024-07-19,26,DPD15-29,16,16,0
2024-07-19,26,DPD3-14,20,20,0
2024-07-19,26,DPD30-59,3,3,0
2024-07-19,26,DPD60-89,0,0,0
2024-07-19,26,DPD90+,0,0,0
2024-07-19,32,Current,0,0,0
2024-07-19,32,DPD15-29,113,113,0
2024-07-19,32,DPD3-14,150,150,0
2024-07-19,32,DPD30-59,65,65,0
2024-07-19,32,DPD60-89,0,0,0
2024-07-19,32,DPD90+,0,0,0
2024-07-19,34,Current,0,0,0
2024-07-19,34,DPD15-29,48,48,0
2024-07-19,34,DPD3-14,64,64,0
2024-07-19,34,DPD30-59,17,17,0
2024-07-19,34,DPD60-89,0,0,0
2024-07-19,34,DPD90+,0,0,0
2024-07-19,36,Current,0,0,0
2024-07-19,36,DPD15-29,32,32,0
2024-07-19,36,DPD3-14,46,46,0
2024-07-19,36,DPD30-59,17,17,0
2024-07-19,36,DPD60-89,0,0,0
2024-07-19,36,DPD90+,0,0,0
2024-07-19,38,Current,2,2,0
2024-07-19,38,DPD15-29,35,35,0
2024-07-19,38,DPD3-14,56,56,0
2024-07-19,38,DPD30-59,11,11,0
2024-07-19,38,DPD60-89,0,0,0
2024-07-19,38,DPD90+,0,0,0
2024-07-19,40,Current,0,0,0
2024-07-19,40,DPD15-29,20,20,0
2024-07-19,40,DPD3-14,32,32,0
2024-07-19,40,DPD30-59,5,5,0
2024-07-19,40,DPD60-89,0,0,0
2024-07-19,40,DPD90+,0,0,0
2024-07-19,42,Current,0,0,0
2024-07-19,42,DPD15-29,11,11,0
2024-07-19,42,DPD3-14,26,26,0
2024-07-19,42,DPD30-59,7,7,0
2024-07-19,42,DPD60-89,0,0,0
2024-07-19,42,DPD90+,0,0,0
2024-07-19,44,Current,0,0,0
2024-07-19,44,DPD15-29,33,33,0
2024-07-19,44,DPD3-14,51,51,0
2024-07-19,44,DPD30-59,13,13,0
2024-07-19,44,DPD60-89,0,0,0
2024-07-19,44,DPD90+,0,0,0
2024-07-19,46,Current,0,0,0
2024-07-19,46,DPD3-14,1,1,0
2024-07-19,48,Current,57,57,0
2024-07-19,48,DPD15-29,16,16,0
2024-07-19,48,DPD3-14,36,36,0
2024-07-19,48,DPD30-59,18,18,0
2024-07-19,48,DPD60-89,0,0,0
2024-07-19,48,DPD90+,0,0,0
2024-07-19,6,Current,0,0,0
2024-07-18,100,Current,0,0,0
2024-07-18,100,DPD15-29,0,0,0
2024-07-18,102,Current,0,0,0
2024-07-18,102,DPD3-14,0,0,0
2024-07-18,102,DPD60-89,0,0,0
2024-07-18,102,DPD90+,0,0,0
2024-07-18,104,Current,0,0,0
2024-07-18,104,DPD15-29,0,0,0
2024-07-18,104,DPD60-89,0,0,0
2024-07-18,20,Current,0,0,0
2024-07-18,20,DPD15-29,231,231,0
2024-07-18,20,DPD3-14,274,274,0
2024-07-18,20,DPD30-59,102,102,0
2024-07-18,20,DPD60-89,71,71,0
2024-07-18,20,DPD90+,28,28,0
2024-07-18,22,Current,0,0,0
2024-07-18,22,DPD15-29,1,1,0
2024-07-18,22,DPD3-14,0,0,0
2024-07-18,22,DPD30-59,0,0,0
2024-07-18,22,DPD60-89,0,0,0
2024-07-18,24,Current,27,27,0
2024-07-18,24,DPD15-29,117,117,0
2024-07-18,24,DPD3-14,175,175,0
2024-07-18,24,DPD30-59,41,41,0
2024-07-18,24,DPD60-89,0,0,0
2024-07-18,24,DPD90+,0,0,0
2024-07-18,26,Current,0,0,0
2024-07-18,26,DPD15-29,17,17,0
2024-07-18,26,DPD3-14,15,15,0
2024-07-18,26,DPD30-59,8,8,0
2024-07-18,26,DPD60-89,0,0,0
2024-07-18,26,DPD90+,0,0,0
2024-07-18,32,Current,0,0,0
2024-07-18,32,DPD15-29,100,100,0
2024-07-18,32,DPD3-14,89,89,0
2024-07-18,32,DPD30-59,48,48,0
2024-07-18,32,DPD60-89,0,0,0
2024-07-18,32,DPD90+,0,0,0
2024-07-18,34,Current,0,0,0
2024-07-18,34,DPD15-29,42,42,0
2024-07-18,34,DPD3-14,53,53,0
2024-07-18,34,DPD30-59,13,13,0
2024-07-18,34,DPD60-89,0,0,0
2024-07-18,34,DPD90+,0,0,0
2024-07-18,36,Current,0,0,0
2024-07-18,36,DPD15-29,27,27,0
2024-07-18,36,DPD3-14,29,29,0
2024-07-18,36,DPD30-59,9,9,0
2024-07-18,36,DPD60-89,0,0,0
2024-07-18,36,DPD90+,0,0,0
2024-07-18,38,Current,0,0,0
2024-07-18,38,DPD15-29,22,22,0
2024-07-18,38,DPD3-14,38,38,0
2024-07-18,38,DPD30-59,13,13,0
2024-07-18,38,DPD60-89,0,0,0
2024-07-18,38,DPD90+,0,0,0
2024-07-18,40,Current,0,0,0
2024-07-18,40,DPD15-29,20,20,0
2024-07-18,40,DPD3-14,31,31,0
2024-07-18,40,DPD30-59,3,3,0
2024-07-18,40,DPD60-89,0,0,0
2024-07-18,40,DPD90+,0,0,0
2024-07-18,42,Current,0,0,0
2024-07-18,42,DPD15-29,18,18,0
2024-07-18,42,DPD3-14,12,12,0
2024-07-18,42,DPD30-59,4,4,0
2024-07-18,42,DPD60-89,0,0,0
2024-07-18,42,DPD90+,0,0,0
2024-07-18,44,Current,0,0,0
2024-07-18,44,DPD15-29,22,22,0
2024-07-18,44,DPD3-14,37,37,0
2024-07-18,44,DPD30-59,10,10,0
2024-07-18,44,DPD60-89,0,0,0
2024-07-18,44,DPD90+,0,0,0
2024-07-18,46,Current,0,0,0
2024-07-18,46,DPD3-14,0,0,0
2024-07-18,48,Current,15,15,0
2024-07-18,48,DPD15-29,8,8,0
2024-07-18,48,DPD3-14,36,36,0
2024-07-18,48,DPD30-59,9,9,0
2024-07-18,48,DPD60-89,0,0,0
2024-07-18,48,DPD90+,0,0,0
2024-07-18,6,Current,0,0,0
2024-07-17,100,Current,0,0,0
2024-07-17,100,DPD3-14,0,0,0
2024-07-17,102,Current,0,0,0
2024-07-17,102,DPD60-89,0,0,0
2024-07-17,102,DPD90+,0,0,0
2024-07-17,104,Current,0,0,0
2024-07-17,104,DPD15-29,0,0,0
2024-07-17,104,DPD60-89,0,0,0
2024-07-17,20,Current,0,0,0
2024-07-17,20,DPD15-29,248,248,0
2024-07-17,20,DPD3-14,205,205,0
2024-07-17,20,DPD30-59,86,86,0
2024-07-17,20,DPD60-89,16,16,0
2024-07-17,20,DPD90+,3,3,0
2024-07-17,22,Current,0,0,0
2024-07-17,22,DPD15-29,0,0,0
2024-07-17,22,DPD3-14,1,1,0
2024-07-17,22,DPD30-59,1,1,0
2024-07-17,22,DPD60-89,0,0,0
2024-07-17,24,Current,63,63,0
2024-07-17,24,DPD15-29,123,123,0
2024-07-17,24,DPD3-14,120,120,0
2024-07-17,24,DPD30-59,42,42,0
2024-07-17,24,DPD60-89,0,0,0
2024-07-17,24,DPD90+,0,0,0
2024-07-17,26,Current,0,0,0
2024-07-17,26,DPD15-29,18,18,0
2024-07-17,26,DPD3-14,13,13,0
2024-07-17,26,DPD30-59,5,5,0
2024-07-17,26,DPD60-89,0,0,0
2024-07-17,26,DPD90+,0,0,0
2024-07-17,32,Current,0,0,0
2024-07-17,32,DPD15-29,125,125,0
2024-07-17,32,DPD3-14,89,89,0
2024-07-17,32,DPD30-59,41,41,0
2024-07-17,32,DPD60-89,0,0,0
2024-07-17,32,DPD90+,0,0,0
2024-07-17,34,Current,0,0,0
2024-07-17,34,DPD15-29,50,50,0
2024-07-17,34,DPD3-14,41,41,0
2024-07-17,34,DPD30-59,13,13,0
2024-07-17,34,DPD60-89,0,0,0
2024-07-17,34,DPD90+,0,0,0
2024-07-17,36,Current,0,0,0
2024-07-17,36,DPD15-29,37,37,0
2024-07-17,36,DPD3-14,21,21,0
2024-07-17,36,DPD30-59,11,11,0
2024-07-17,36,DPD60-89,0,0,0
2024-07-17,36,DPD90+,0,0,0
2024-07-17,38,Current,0,0,0
2024-07-17,38,DPD15-29,38,38,0
2024-07-17,38,DPD3-14,25,25,0
2024-07-17,38,DPD30-59,12,12,0
2024-07-17,38,DPD60-89,0,0,0
2024-07-17,38,DPD90+,0,0,0
2024-07-17,40,Current,0,0,0
2024-07-17,40,DPD15-29,19,19,0
2024-07-17,40,DPD3-14,18,18,0
2024-07-17,40,DPD30-59,6,6,0
2024-07-17,40,DPD60-89,0,0,0
2024-07-17,40,DPD90+,0,0,0
2024-07-17,42,Current,0,0,0
2024-07-17,42,DPD15-29,10,10,0
2024-07-17,42,DPD3-14,14,14,0
2024-07-17,42,DPD30-59,7,7,0
2024-07-17,42,DPD60-89,0,0,0
2024-07-17,42,DPD90+,0,0,0
2024-07-17,44,Current,0,0,0
2024-07-17,44,DPD15-29,40,40,0
2024-07-17,44,DPD3-14,36,36,0
2024-07-17,44,DPD30-59,2,2,0
2024-07-17,44,DPD60-89,0,0,0
2024-07-17,44,DPD90+,0,0,0
2024-07-17,46,Current,0,0,0
2024-07-17,46,DPD3-14,1,1,0
2024-07-17,48,Current,38,38,0
2024-07-17,48,DPD15-29,17,17,0
2024-07-17,48,DPD3-14,29,29,0
2024-07-17,48,DPD30-59,11,11,0
2024-07-17,48,DPD60-89,0,0,0
2024-07-17,48,DPD90+,0,0,0
2024-07-17,6,Current,0,0,0
2024-07-16,100,Current,0,0,0
2024-07-16,100,DPD3-14,0,0,0
2024-07-16,102,Current,5,5,0
2024-07-16,102,DPD60-89,0,0,0
2024-07-16,102,DPD90+,0,0,0
2024-07-16,104,Current,0,0,0
2024-07-16,104,DPD15-29,0,0,0
2024-07-16,104,DPD60-89,0,0,0
2024-07-16,20,Current,1105,1105,0
2024-07-16,20,DPD15-29,230,230,0
2024-07-16,20,DPD3-14,299,299,0
2024-07-16,20,DPD30-59,85,85,0
2024-07-16,20,DPD60-89,21,21,0
2024-07-16,20,DPD90+,8,8,0
2024-07-16,22,Current,0,0,0
2024-07-16,22,DPD15-29,1,1,0
2024-07-16,22,DPD3-14,0,0,0
2024-07-16,22,DPD30-59,0,0,0
2024-07-16,22,DPD60-89,0,0,0
2024-07-16,24,Current,1174,1174,0
2024-07-16,24,DPD15-29,120,120,0
2024-07-16,24,DPD3-14,171,171,0
2024-07-16,24,DPD30-59,45,45,0
2024-07-16,24,DPD60-89,0,0,0
2024-07-16,24,DPD90+,0,0,0
2024-07-16,26,Current,14,14,0
2024-07-16,26,DPD15-29,19,19,0
2024-07-16,26,DPD3-14,18,18,0
2024-07-16,26,DPD30-59,4,4,0
2024-07-16,26,DPD60-89,0,0,0
2024-07-16,26,DPD90+,0,0,0
2024-07-16,32,Current,3,3,0
2024-07-16,32,DPD15-29,116,116,0
2024-07-16,32,DPD3-14,92,92,0
2024-07-16,32,DPD30-59,46,46,0
2024-07-16,32,DPD60-89,0,0,0
2024-07-16,32,DPD90+,0,0,0
2024-07-16,34,Current,0,0,0
2024-07-16,34,DPD15-29,46,46,0
2024-07-16,34,DPD3-14,47,47,0
2024-07-16,34,DPD30-59,13,13,0
2024-07-16,34,DPD60-89,0,0,0
2024-07-16,34,DPD90+,0,0,0
2024-07-16,36,Current,0,0,0
2024-07-16,36,DPD15-29,29,29,0
2024-07-16,36,DPD3-14,34,34,0
2024-07-16,36,DPD30-59,18,18,0
2024-07-16,36,DPD60-89,0,0,0
2024-07-16,36,DPD90+,0,0,0
2024-07-16,38,Current,1,1,0
2024-07-16,38,DPD15-29,27,27,0
2024-07-16,38,DPD3-14,37,37,0
2024-07-16,38,DPD30-59,6,6,0
2024-07-16,38,DPD60-89,0,0,0
2024-07-16,38,DPD90+,0,0,0
2024-07-16,40,Current,0,0,0
2024-07-16,40,DPD15-29,24,24,0
2024-07-16,40,DPD3-14,31,31,0
2024-07-16,40,DPD30-59,12,12,0
2024-07-16,40,DPD60-89,0,0,0
2024-07-16,40,DPD90+,0,0,0
2024-07-16,42,Current,0,0,0
2024-07-16,42,DPD15-29,17,17,0
2024-07-16,42,DPD3-14,15,15,0
2024-07-16,42,DPD30-59,4,4,0
2024-07-16,42,DPD60-89,0,0,0
2024-07-16,42,DPD90+,0,0,0
2024-07-16,44,Current,15,15,0
2024-07-16,44,DPD15-29,29,29,0
2024-07-16,44,DPD3-14,37,37,0
2024-07-16,44,DPD30-59,13,13,0
2024-07-16,44,DPD60-89,0,0,0
2024-07-16,44,DPD90+,0,0,0
2024-07-16,46,Current,1,1,0
2024-07-16,46,DPD3-14,0,0,0
2024-07-16,48,Current,821,821,0
2024-07-16,48,DPD15-29,11,11,0
2024-07-16,48,DPD3-14,41,41,0
2024-07-16,48,DPD30-59,6,6,0
2024-07-16,48,DPD60-89,0,0,0
2024-07-16,48,DPD90+,0,0,0
2024-07-16,6,Current,0,0,0
2024-07-15,100,Current,0,0,0
2024-07-15,100,DPD3-14,1,1,0
2024-07-15,102,Current,0,0,0
2024-07-15,102,DPD60-89,0,0,0
2024-07-15,102,DPD90+,0,0,0
2024-07-15,104,Current,0,0,0
2024-07-15,104,DPD15-29,0,0,0
2024-07-15,104,DPD60-89,0,0,0
2024-07-15,20,Current,4551,4551,0
2024-07-15,20,DPD15-29,308,308,0
2024-07-15,20,DPD3-14,377,377,0
2024-07-15,20,DPD30-59,165,165,0
2024-07-15,20,DPD60-89,51,51,0
2024-07-15,20,DPD90+,57,57,0
2024-07-15,22,Current,0,0,0
2024-07-15,22,DPD15-29,0,0,0
2024-07-15,22,DPD3-14,1,1,0
2024-07-15,22,DPD30-59,0,0,0
2024-07-15,22,DPD60-89,0,0,0
2024-07-15,24,Current,4180,4180,0
2024-07-15,24,DPD15-29,150,150,0
2024-07-15,24,DPD3-14,218,218,0
2024-07-15,24,DPD30-59,73,73,0
2024-07-15,24,DPD60-89,11,11,0
2024-07-15,24,DPD90+,10,10,0
2024-07-15,26,Current,0,0,0
2024-07-15,26,DPD15-29,21,21,0
2024-07-15,26,DPD3-14,21,21,0
2024-07-15,26,DPD30-59,7,7,0
2024-07-15,26,DPD60-89,0,0,0
2024-07-15,26,DPD90+,0,0,0
2024-07-15,32,Current,235,235,0
2024-07-15,32,DPD15-29,124,124,0
2024-07-15,32,DPD3-14,153,153,0
2024-07-15,32,DPD30-59,69,69,0
2024-07-15,32,DPD60-89,3,3,0
2024-07-15,32,DPD90+,4,4,0
2024-07-15,34,Current,0,0,0
2024-07-15,34,DPD15-29,58,58,0
2024-07-15,34,DPD3-14,55,55,0
2024-07-15,34,DPD30-59,17,17,0
2024-07-15,34,DPD60-89,0,0,0
2024-07-15,34,DPD90+,0,0,0
2024-07-15,36,Current,246,246,0
2024-07-15,36,DPD15-29,42,42,0
2024-07-15,36,DPD3-14,35,35,0
2024-07-15,36,DPD30-59,21,21,0
2024-07-15,36,DPD60-89,2,2,0
2024-07-15,36,DPD90+,3,3,0
2024-07-15,38,Current,0,0,0
2024-07-15,38,DPD15-29,36,36,0
2024-07-15,38,DPD3-14,45,45,0
2024-07-15,38,DPD30-59,13,13,0
2024-07-15,38,DPD60-89,0,0,0
2024-07-15,38,DPD90+,0,0,0
2024-07-15,40,Current,273,273,0
2024-07-15,40,DPD15-29,22,22,0
2024-07-15,40,DPD3-14,31,31,0
2024-07-15,40,DPD30-59,10,10,0
2024-07-15,40,DPD60-89,1,1,0
2024-07-15,40,DPD90+,1,1,0
2024-07-15,42,Current,0,0,0
2024-07-15,42,DPD15-29,11,11,0
2024-07-15,42,DPD3-14,16,16,0
2024-07-15,42,DPD30-59,8,8,0
2024-07-15,42,DPD60-89,0,0,0
2024-07-15,42,DPD90+,0,0,0
2024-07-15,44,Current,173,173,0
2024-07-15,44,DPD15-29,41,41,0
2024-07-15,44,DPD3-14,54,54,0
2024-07-15,44,DPD30-59,15,15,0
2024-07-15,44,DPD60-89,2,2,0
2024-07-15,44,DPD90+,1,1,0
2024-07-15,46,Current,4,4,0
2024-07-15,46,DPD3-14,1,1,0
2024-07-15,48,Current,4375,4375,0
2024-07-15,48,DPD15-29,37,37,0
2024-07-15,48,DPD3-14,92,92,0
2024-07-15,48,DPD30-59,36,36,0
2024-07-15,48,DPD60-89,14,14,0
2024-07-15,48,DPD90+,10,10,0
2024-07-15,6,Current,0,0,0
2024-07-14,100,Current,0,0,0
2024-07-14,100,DPD3-14,0,0,0
2024-07-14,102,Current,0,0,0
2024-07-14,102,DPD60-89,0,0,0
2024-07-14,102,DPD90+,0,0,0
2024-07-14,104,Current,0,0,0
2024-07-14,104,DPD15-29,0,0,0
2024-07-14,104,DPD60-89,0,0,0
2024-07-14,20,Current,0,0,0
2024-07-14,20,DPD15-29,284,284,0
2024-07-14,20,DPD3-14,249,249,0
2024-07-14,20,DPD30-59,103,103,0
2024-07-14,20,DPD60-89,81,81,0
2024-07-14,20,DPD90+,63,63,0
2024-07-14,22,Current,0,0,0
2024-07-14,22,DPD15-29,2,2,0
2024-07-14,22,DPD3-14,0,0,0
2024-07-14,22,DPD30-59,0,0,0
2024-07-14,22,DPD60-89,0,0,0
2024-07-14,24,Current,58,58,0
2024-07-14,24,DPD15-29,138,138,0
2024-07-14,24,DPD3-14,153,153,0
2024-07-14,24,DPD30-59,50,50,0
2024-07-14,24,DPD60-89,0,0,0
2024-07-14,24,DPD90+,0,0,0
2024-07-14,26,Current,0,0,0
2024-07-14,26,DPD15-29,23,23,0
2024-07-14,26,DPD3-14,17,17,0
2024-07-14,26,DPD30-59,6,6,0
2024-07-14,26,DPD60-89,0,0,0
2024-07-14,26,DPD90+,0,0,0
2024-07-14,32,Current,0,0,0
2024-07-14,32,DPD15-29,144,144,0
2024-07-14,32,DPD3-14,84,84,0
2024-07-14,32,DPD30-59,46,46,0
2024-07-14,32,DPD60-89,0,0,0
2024-07-14,32,DPD90+,0,0,0
2024-07-14,34,Current,0,0,0
2024-07-14,34,DPD15-29,52,52,0
2024-07-14,34,DPD3-14,37,37,0
2024-07-14,34,DPD30-59,21,21,0
2024-07-14,34,DPD60-89,0,0,0
2024-07-14,34,DPD90+,0,0,0
2024-07-14,36,Current,0,0,0
2024-07-14,36,DPD15-29,34,34,0
2024-07-14,36,DPD3-14,28,28,0
2024-07-14,36,DPD30-59,11,11,0
2024-07-14,36,DPD60-89,0,0,0
2024-07-14,36,DPD90+,0,0,0
2024-07-14,38,Current,0,0,0
2024-07-14,38,DPD15-29,31,31,0
2024-07-14,38,DPD3-14,37,37,0
2024-07-14,38,DPD30-59,13,13,0
2024-07-14,38,DPD60-89,0,0,0
2024-07-14,38,DPD90+,0,0,0
2024-07-14,40,Current,0,0,0
2024-07-14,40,DPD15-29,26,26,0
2024-07-14,40,DPD3-14,26,26,0
2024-07-14,40,DPD30-59,3,3,0
2024-07-14,40,DPD60-89,0,0,0
2024-07-14,40,DPD90+,0,0,0
2024-07-14,42,Current,0,0,0
2024-07-14,42,DPD15-29,17,17,0
2024-07-14,42,DPD3-14,13,13,0
2024-07-14,42,DPD30-59,5,5,0
2024-07-14,42,DPD60-89,0,0,0
2024-07-14,42,DPD90+,0,0,0
2024-07-14,44,Current,0,0,0
2024-07-14,44,DPD15-29,37,37,0
2024-07-14,44,DPD3-14,36,36,0
2024-07-14,44,DPD30-59,10,10,0
2024-07-14,44,DPD60-89,0,0,0
2024-07-14,44,DPD90+,0,0,0
2024-07-14,46,Current,0,0,0
2024-07-14,46,DPD3-14,0,0,0
2024-07-14,48,Current,38,38,0
2024-07-14,48,DPD15-29,13,13,0
2024-07-14,48,DPD3-14,36,36,0
2024-07-14,48,DPD30-59,6,6,0
2024-07-14,48,DPD60-89,0,0,0
2024-07-14,48,DPD90+,0,0,0
2024-07-14,6,Current,0,0,0
2024-07-14,6,DPD15-29,0,0,0
2024-07-13,100,Current,0,0,0
2024-07-13,100,DPD3-14,1,1,0
2024-07-13,102,Current,0,0,0
2024-07-13,102,DPD60-89,0,0,0
2024-07-13,102,DPD90+,0,0,0
2024-07-13,104,Current,0,0,0
2024-07-13,104,DPD15-29,0,0,0
2024-07-13,104,DPD60-89,0,0,0
2024-07-13,20,Current,0,0,0
2024-07-13,20,DPD15-29,233,233,0
2024-07-13,20,DPD3-14,264,264,0
2024-07-13,20,DPD30-59,74,74,0
2024-07-13,20,DPD60-89,37,37,0
2024-07-13,20,DPD90+,39,39,0
2024-07-13,22,Current,0,0,0
2024-07-13,22,DPD15-29,0,0,0
2024-07-13,22,DPD30-59,1,1,0
2024-07-13,22,DPD60-89,0,0,0
2024-07-13,24,Current,66,66,0
2024-07-13,24,DPD15-29,121,121,0
2024-07-13,24,DPD3-14,140,140,0
2024-07-13,24,DPD30-59,38,38,0
2024-07-13,24,DPD60-89,0,0,0
2024-07-13,24,DPD90+,0,0,0
2024-07-13,26,Current,0,0,0
2024-07-13,26,DPD15-29,20,20,0
2024-07-13,26,DPD3-14,19,19,0
2024-07-13,26,DPD30-59,2,2,0
2024-07-13,26,DPD60-89,0,0,0
2024-07-13,26,DPD90+,0,0,0
2024-07-13,32,Current,0,0,0
2024-07-13,32,DPD15-29,117,117,0
2024-07-13,32,DPD3-14,129,129,0
2024-07-13,32,DPD30-59,29,29,0
2024-07-13,32,DPD60-89,0,0,0
2024-07-13,32,DPD90+,0,0,0
2024-07-13,34,Current,0,0,0
2024-07-13,34,DPD15-29,58,58,0
2024-07-13,34,DPD3-14,49,49,0
2024-07-13,34,DPD30-59,9,9,0
2024-07-13,34,DPD60-89,0,0,0
2024-07-13,34,DPD90+,0,0,0
2024-07-13,36,Current,0,0,0
2024-07-13,36,DPD15-29,41,41,0
2024-07-13,36,DPD3-14,28,28,0
2024-07-13,36,DPD30-59,6,6,0
2024-07-13,36,DPD60-89,0,0,0
2024-07-13,36,DPD90+,0,0,0
2024-07-13,38,Current,0,0,0
2024-07-13,38,DPD15-29,34,34,0
2024-07-13,38,DPD3-14,38,38,0
2024-07-13,38,DPD30-59,10,10,0
2024-07-13,38,DPD60-89,0,0,0
2024-07-13,38,DPD90+,0,0,0
2024-07-13,40,Current,0,0,0
2024-07-13,40,DPD15-29,21,21,0
2024-07-13,40,DPD3-14,22,22,0
2024-07-13,40,DPD30-59,6,6,0
2024-07-13,40,DPD60-89,0,0,0
2024-07-13,40,DPD90+,0,0,0
2024-07-13,42,Current,0,0,0
2024-07-13,42,DPD15-29,13,13,0
2024-07-13,42,DPD3-14,12,12,0
2024-07-13,42,DPD30-59,5,5,0
2024-07-13,42,DPD60-89,0,0,0
2024-07-13,42,DPD90+,0,0,0
2024-07-13,44,Current,0,0,0
2024-07-13,44,DPD15-29,33,33,0
2024-07-13,44,DPD3-14,47,47,0
2024-07-13,44,DPD30-59,3,3,0
2024-07-13,44,DPD60-89,0,0,0
2024-07-13,44,DPD90+,0,0,0
2024-07-13,46,Current,0,0,0
2024-07-13,46,DPD3-14,1,1,0
2024-07-13,48,Current,32,32,0
2024-07-13,48,DPD15-29,20,20,0
2024-07-13,48,DPD3-14,28,28,0
2024-07-13,48,DPD30-59,13,13,0
2024-07-13,48,DPD60-89,0,0,0
2024-07-13,48,DPD90+,0,0,0
2024-07-13,6,Current,0,0,0
2024-07-13,6,DPD15-29,1,1,0
2024-07-12,100,Current,0,0,0
2024-07-12,100,DPD3-14,0,0,0
2024-07-12,102,Current,0,0,0
2024-07-12,102,DPD60-89,0,0,0
2024-07-12,102,DPD90+,0,0,0
2024-07-12,104,Current,0,0,0
2024-07-12,104,DPD15-29,0,0,0
2024-07-12,104,DPD60-89,0,0,0
2024-07-12,20,Current,1,1,0
2024-07-12,20,DPD15-29,224,224,0
2024-07-12,20,DPD3-14,294,294,0
2024-07-12,20,DPD30-59,63,63,0
2024-07-12,20,DPD60-89,6,6,0
2024-07-12,20,DPD90+,5,5,0
2024-07-12,22,Current,0,0,0
2024-07-12,22,DPD15-29,1,1,0
2024-07-12,22,DPD3-14,1,1,0
2024-07-12,22,DPD30-59,0,0,0
2024-07-12,22,DPD60-89,0,0,0
2024-07-12,24,Current,108,108,0
2024-07-12,24,DPD15-29,114,114,0
2024-07-12,24,DPD3-14,162,162,0
2024-07-12,24,DPD30-59,39,39,0
2024-07-12,24,DPD60-89,0,0,0
2024-07-12,24,DPD90+,0,0,0
2024-07-12,26,Current,0,0,0
2024-07-12,26,DPD15-29,19,19,0
2024-07-12,26,DPD3-14,27,27,0
2024-07-12,26,DPD30-59,4,4,0
2024-07-12,26,DPD60-89,0,0,0
2024-07-12,26,DPD90+,0,0,0
2024-07-12,32,Current,0,0,0
2024-07-12,32,DPD15-29,128,128,0
2024-07-12,32,DPD3-14,109,109,0
2024-07-12,32,DPD30-59,27,27,0
2024-07-12,32,DPD60-89,0,0,0
2024-07-12,32,DPD90+,0,0,0
2024-07-12,34,Current,0,0,0
2024-07-12,34,DPD15-29,45,45,0
2024-07-12,34,DPD3-14,40,40,0
2024-07-12,34,DPD30-59,10,10,0
2024-07-12,34,DPD60-89,0,0,0
2024-07-12,34,DPD90+,0,0,0
2024-07-12,36,Current,0,0,0
2024-07-12,36,DPD15-29,31,31,0
2024-07-12,36,DPD3-14,32,32,0
2024-07-12,36,DPD30-59,12,12,0
2024-07-12,36,DPD60-89,0,0,0
2024-07-12,36,DPD90+,0,0,0
2024-07-12,38,Current,0,0,0
2024-07-12,38,DPD15-29,26,26,0
2024-07-12,38,DPD3-14,44,44,0
2024-07-12,38,DPD30-59,5,5,0
2024-07-12,38,DPD60-89,0,0,0
2024-07-12,38,DPD90+,0,0,0
2024-07-12,40,Current,0,0,0
2024-07-12,40,DPD15-29,17,17,0
2024-07-12,40,DPD3-14,29,29,0
2024-07-12,40,DPD30-59,13,13,0
2024-07-12,40,DPD60-89,0,0,0
2024-07-12,40,DPD90+,0,0,0
2024-07-12,42,Current,0,0,0
2024-07-12,42,DPD15-29,10,10,0
2024-07-12,42,DPD3-14,19,19,0
2024-07-12,42,DPD30-59,5,5,0
2024-07-12,42,DPD60-89,0,0,0
2024-07-12,42,DPD90+,0,0,0
2024-07-12,44,Current,0,0,0
2024-07-12,44,DPD15-29,35,35,0
2024-07-12,44,DPD3-14,40,40,0
2024-07-12,44,DPD30-59,10,10,0
2024-07-12,44,DPD60-89,0,0,0
2024-07-12,44,DPD90+,0,0,0
2024-07-12,46,Current,0,0,0
2024-07-12,46,DPD3-14,0,0,0
2024-07-12,48,Current,77,77,0
2024-07-12,48,DPD15-29,12,12,0
2024-07-12,48,DPD3-14,34,34,0
2024-07-12,48,DPD30-59,5,5,0
2024-07-12,48,DPD60-89,0,0,0
2024-07-12,48,DPD90+,0,0,0
2024-07-12,6,Current,0,0,0
2024-07-12,6,DPD15-29,0,0,0
2024-07-11,100,Current,0,0,0
2024-07-11,100,DPD3-14,1,1,0
2024-07-11,102,Current,0,0,0
2024-07-11,102,DPD60-89,0,0,0
2024-07-11,102,DPD90+,0,0,0
2024-07-11,104,Current,0,0,0
2024-07-11,104,DPD15-29,0,0,0
2024-07-11,104,DPD60-89,0,0,0
2024-07-11,20,Current,0,0,0
2024-07-11,20,DPD15-29,238,238,0
2024-07-11,20,DPD3-14,294,294,0
2024-07-11,20,DPD30-59,102,102,0
2024-07-11,20,DPD60-89,41,41,0
2024-07-11,20,DPD90+,41,41,0
2024-07-11,22,Current,0,0,0
2024-07-11,22,DPD15-29,1,1,0
2024-07-11,22,DPD3-14,0,0,0
2024-07-11,22,DPD30-59,0,0,0
2024-07-11,22,DPD60-89,0,0,0
2024-07-11,24,Current,46,46,0
2024-07-11,24,DPD15-29,133,133,0
2024-07-11,24,DPD3-14,160,160,0
2024-07-11,24,DPD30-59,56,56,0
2024-07-11,24,DPD60-89,0,0,0
2024-07-11,24,DPD90+,0,0,0
2024-07-11,26,Current,0,0,0
2024-07-11,26,DPD15-29,23,23,0
2024-07-11,26,DPD3-14,16,16,0
2024-07-11,26,DPD30-59,7,7,0
2024-07-11,26,DPD60-89,0,0,0
2024-07-11,26,DPD90+,0,0,0
2024-07-11,32,Current,0,0,0
2024-07-11,32,DPD15-29,130,130,0
2024-07-11,32,DPD3-14,134,134,0
2024-07-11,32,DPD30-59,64,64,0
2024-07-11,32,DPD60-89,0,0,0
2024-07-11,32,DPD90+,0,0,0
2024-07-11,34,Current,0,0,0
2024-07-11,34,DPD15-29,57,57,0
2024-07-11,34,DPD3-14,50,50,0
2024-07-11,34,DPD30-59,21,21,0
2024-07-11,34,DPD60-89,0,0,0
2024-07-11,34,DPD90+,0,0,0
2024-07-11,36,Current,0,0,0
2024-07-11,36,DPD15-29,44,44,0
2024-07-11,36,DPD3-14,35,35,0
2024-07-11,36,DPD30-59,24,24,0
2024-07-11,36,DPD60-89,0,0,0
2024-07-11,36,DPD90+,0,0,0
2024-07-11,38,Current,0,0,0
2024-07-11,38,DPD15-29,36,36,0
2024-07-11,38,DPD3-14,51,51,0
2024-07-11,38,DPD30-59,14,14,0
2024-07-11,38,DPD60-89,0,0,0
2024-07-11,38,DPD90+,0,0,0
2024-07-11,40,Current,0,0,0
2024-07-11,40,DPD15-29,22,22,0
2024-07-11,40,DPD3-14,20,20,0
2024-07-11,40,DPD30-59,4,4,0
2024-07-11,40,DPD60-89,0,0,0
2024-07-11,40,DPD90+,0,0,0
2024-07-11,42,Current,0,0,0
2024-07-11,42,DPD15-29,17,17,0
2024-07-11,42,DPD3-14,13,13,0
2024-07-11,42,DPD30-59,5,5,0
2024-07-11,42,DPD60-89,0,0,0
2024-07-11,42,DPD90+,0,0,0
2024-07-11,44,Current,0,0,0
2024-07-11,44,DPD15-29,33,33,0
2024-07-11,44,DPD3-14,53,53,0
2024-07-11,44,DPD30-59,18,18,0
2024-07-11,44,DPD60-89,0,0,0
2024-07-11,44,DPD90+,0,0,0
2024-07-11,46,Current,0,0,0
2024-07-11,46,DPD3-14,1,1,0
2024-07-11,48,Current,24,24,0
2024-07-11,48,DPD15-29,24,24,0
2024-07-11,48,DPD3-14,31,31,0
2024-07-11,48,DPD30-59,11,11,0
2024-07-11,48,DPD60-89,0,0,0
2024-07-11,48,DPD90+,0,0,0
2024-07-11,6,Current,0,0,0
2024-07-11,6,DPD3-14,1,1,0
2024-07-10,100,Current,0,0,0
2024-07-10,100,DPD3-14,0,0,0
2024-07-10,102,Current,0,0,0
2024-07-10,102,DPD60-89,0,0,0
2024-07-10,102,DPD90+,0,0,0
2024-07-10,104,Current,0,0,0
2024-07-10,104,DPD15-29,0,0,0
2024-07-10,104,DPD60-89,0,0,0
2024-07-10,20,Current,0,0,0
2024-07-10,20,DPD15-29,240,240,0
2024-07-10,20,DPD3-14,288,288,0
2024-07-10,20,DPD30-59,122,122,0
2024-07-10,20,DPD60-89,64,64,0
2024-07-10,20,DPD90+,38,38,0
2024-07-10,22,Current,0,0,0
2024-07-10,22,DPD15-29,1,1,0
2024-07-10,22,DPD3-14,2,2,0
2024-07-10,22,DPD30-59,0,0,0
2024-07-10,22,DPD60-89,0,0,0
2024-07-10,24,Current,27,27,0
2024-07-10,24,DPD15-29,105,105,0
2024-07-10,24,DPD3-14,183,183,0
2024-07-10,24,DPD30-59,60,60,0
2024-07-10,24,DPD60-89,0,0,0
2024-07-10,24,DPD90+,0,0,0
2024-07-10,26,Current,0,0,0
2024-07-10,26,DPD15-29,18,18,0
2024-07-10,26,DPD3-14,27,27,0
2024-07-10,26,DPD30-59,5,5,0
2024-07-10,26,DPD60-89,0,0,0
2024-07-10,26,DPD90+,0,0,0
2024-07-10,32,Current,0,0,0
2024-07-10,32,DPD15-29,121,121,0
2024-07-10,32,DPD3-14,111,111,0
2024-07-10,32,DPD30-59,55,55,0
2024-07-10,32,DPD60-89,0,0,0
2024-07-10,32,DPD90+,0,0,0
2024-07-10,34,Current,0,0,0
2024-07-10,34,DPD15-29,45,45,0
2024-07-10,34,DPD3-14,46,46,0
2024-07-10,34,DPD30-59,23,23,0
2024-07-10,34,DPD60-89,0,0,0
2024-07-10,34,DPD90+,0,0,0
2024-07-10,36,Current,0,0,0
2024-07-10,36,DPD15-29,32,32,0
2024-07-10,36,DPD3-14,35,35,0
2024-07-10,36,DPD30-59,16,16,0
2024-07-10,36,DPD60-89,0,0,0
2024-07-10,36,DPD90+,0,0,0
2024-07-10,38,Current,0,0,0
2024-07-10,38,DPD15-29,27,27,0
2024-07-10,38,DPD3-14,31,31,0
2024-07-10,38,DPD30-59,12,12,0
2024-07-10,38,DPD60-89,0,0,0
2024-07-10,38,DPD90+,0,0,0
2024-07-10,40,Current,0,0,0
2024-07-10,40,DPD15-29,17,17,0
2024-07-10,40,DPD3-14,24,24,0
2024-07-10,40,DPD30-59,1,1,0
2024-07-10,40,DPD60-89,0,0,0
2024-07-10,40,DPD90+,0,0,0
2024-07-10,42,Current,0,0,0
2024-07-10,42,DPD15-29,12,12,0
2024-07-10,42,DPD3-14,17,17,0
2024-07-10,42,DPD30-59,7,7,0
2024-07-10,42,DPD60-89,0,0,0
2024-07-10,42,DPD90+,0,0,0
2024-07-10,44,Current,0,0,0
2024-07-10,44,DPD15-29,34,34,0
2024-07-10,44,DPD3-14,34,34,0
2024-07-10,44,DPD30-59,13,13,0
2024-07-10,44,DPD60-89,0,0,0
2024-07-10,44,DPD90+,0,0,0
2024-07-10,46,Current,0,0,0
2024-07-10,46,DPD3-14,0,0,0
2024-07-10,48,Current,18,18,0
2024-07-10,48,DPD15-29,11,11,0
2024-07-10,48,DPD3-14,27,27,0
2024-07-10,48,DPD30-59,7,7,0
2024-07-10,48,DPD60-89,0,0,0
2024-07-10,48,DPD90+,0,0,0
2024-07-10,6,Current,0,0,0
2024-07-10,6,DPD3-14,0,0,0
2024-07-09,100,Current,0,0,0
2024-07-09,100,DPD3-14,1,1,0
2024-07-09,102,Current,0,0,0
2024-07-09,102,DPD60-89,0,0,0
2024-07-09,102,DPD90+,0,0,0
2024-07-09,104,Current,0,0,0
2024-07-09,104,DPD15-29,0,0,0
2024-07-09,104,DPD60-89,0,0,0
2024-07-09,20,Current,0,0,0
2024-07-09,20,DPD15-29,237,237,0
2024-07-09,20,DPD3-14,370,370,0
2024-07-09,20,DPD30-59,76,76,0
2024-07-09,20,DPD60-89,13,13,0
2024-07-09,20,DPD90+,3,3,0
2024-07-09,22,Current,0,0,0
2024-07-09,22,DPD15-29,1,1,0
2024-07-09,22,DPD3-14,0,0,0
2024-07-09,22,DPD30-59,1,1,0
2024-07-09,22,DPD60-89,0,0,0
2024-07-09,24,Current,20,20,0
2024-07-09,24,DPD15-29,133,133,0
2024-07-09,24,DPD3-14,179,179,0
2024-07-09,24,DPD30-59,37,37,0
2024-07-09,24,DPD60-89,0,0,0
2024-07-09,24,DPD90+,0,0,0
2024-07-09,26,Current,0,0,0
2024-07-09,26,DPD15-29,22,22,0
2024-07-09,26,DPD3-14,22,22,0
2024-07-09,26,DPD30-59,6,6,0
2024-07-09,26,DPD60-89,0,0,0
2024-07-09,26,DPD90+,0,0,0
2024-07-09,32,Current,0,0,0
2024-07-09,32,DPD15-29,132,132,0
2024-07-09,32,DPD3-14,139,139,0
2024-07-09,32,DPD30-59,29,29,0
2024-07-09,32,DPD60-89,0,0,0
2024-07-09,32,DPD90+,0,0,0
2024-07-09,34,Current,0,0,0
2024-07-09,34,DPD15-29,53,53,0
2024-07-09,34,DPD3-14,57,57,0
2024-07-09,34,DPD30-59,12,12,0
2024-07-09,34,DPD60-89,0,0,0
2024-07-09,34,DPD90+,0,0,0
2024-07-09,36,Current,0,0,0
2024-07-09,36,DPD15-29,41,41,0
2024-07-09,36,DPD3-14,37,37,0
2024-07-09,36,DPD30-59,6,6,0
2024-07-09,36,DPD60-89,0,0,0
2024-07-09,36,DPD90+,0,0,0
2024-07-09,38,Current,0,0,0
2024-07-09,38,DPD15-29,37,37,0
2024-07-09,38,DPD3-14,50,50,0
2024-07-09,38,DPD30-59,9,9,0
2024-07-09,38,DPD60-89,0,0,0
2024-07-09,38,DPD90+,0,0,0
2024-07-09,40,Current,0,0,0
2024-07-09,40,DPD15-29,20,20,0
2024-07-09,40,DPD3-14,27,27,0
2024-07-09,40,DPD30-59,4,4,0
2024-07-09,40,DPD60-89,0,0,0
2024-07-09,40,DPD90+,0,0,0
2024-07-09,42,Current,0,0,0
2024-07-09,42,DPD15-29,14,14,0
2024-07-09,42,DPD3-14,15,15,0
2024-07-09,42,DPD30-59,3,3,0
2024-07-09,42,DPD60-89,0,0,0
2024-07-09,42,DPD90+,0,0,0
2024-07-09,44,Current,0,0,0
2024-07-09,44,DPD15-29,31,31,0
2024-07-09,44,DPD3-14,47,47,0
2024-07-09,44,DPD30-59,4,4,0
2024-07-09,44,DPD60-89,0,0,0
2024-07-09,44,DPD90+,0,0,0
2024-07-09,46,Current,0,0,0
2024-07-09,48,Current,14,14,0
2024-07-09,48,DPD15-29,26,26,0
2024-07-09,48,DPD3-14,32,32,0
2024-07-09,48,DPD30-59,16,16,0
2024-07-09,48,DPD60-89,0,0,0
2024-07-09,48,DPD90+,0,0,0
2024-07-09,6,Current,0,0,0
2024-07-09,6,DPD3-14,1,1,0
2024-07-08,100,Current,0,0,0
2024-07-08,100,DPD3-14,0,0,0
2024-07-08,102,Current,0,0,0
2024-07-08,102,DPD60-89,0,0,0
2024-07-08,102,DPD90+,0,0,0
2024-07-08,104,Current,0,0,0
2024-07-08,104,DPD15-29,0,0,0
2024-07-08,104,DPD60-89,0,0,0
2024-07-08,20,Current,0,0,0
2024-07-08,20,DPD15-29,240,240,0
2024-07-08,20,DPD3-14,325,325,0
2024-07-08,20,DPD30-59,49,49,0
2024-07-08,20,DPD60-89,16,16,0
2024-07-08,20,DPD90+,10,10,0
2024-07-08,22,Current,0,0,0
2024-07-08,22,DPD15-29,1,1,0
2024-07-08,22,DPD3-14,2,2,0
2024-07-08,22,DPD30-59,0,0,0
2024-07-08,24,Current,44,44,0
2024-07-08,24,DPD15-29,121,121,0
2024-07-08,24,DPD3-14,196,196,0
2024-07-08,24,DPD30-59,36,36,0
2024-07-08,24,DPD60-89,0,0,0
2024-07-08,24,DPD90+,0,0,0
2024-07-08,26,Current,0,0,0
2024-07-08,26,DPD15-29,12,12,0
2024-07-08,26,DPD3-14,36,36,0
2024-07-08,26,DPD30-59,3,3,0
2024-07-08,26,DPD60-89,0,0,0
2024-07-08,26,DPD90+,0,0,0
2024-07-08,32,Current,0,0,0
2024-07-08,32,DPD15-29,124,124,0
2024-07-08,32,DPD3-14,151,151,0
2024-07-08,32,DPD30-59,21,21,0
2024-07-08,32,DPD60-89,0,0,0
2024-07-08,32,DPD90+,0,0,0
2024-07-08,34,Current,0,0,0
2024-07-08,34,DPD15-29,45,45,0
2024-07-08,34,DPD3-14,59,59,0
2024-07-08,34,DPD30-59,9,9,0
2024-07-08,34,DPD60-89,0,0,0
2024-07-08,34,DPD90+,0,0,0
2024-07-08,36,Current,0,0,0
2024-07-08,36,DPD15-29,37,37,0
2024-07-08,36,DPD3-14,41,41,0
2024-07-08,36,DPD30-59,7,7,0
2024-07-08,36,DPD60-89,0,0,0
2024-07-08,36,DPD90+,0,0,0
2024-07-08,38,Current,0,0,0
2024-07-08,38,DPD15-29,30,30,0
2024-07-08,38,DPD3-14,47,47,0
2024-07-08,38,DPD30-59,3,3,0
2024-07-08,38,DPD60-89,0,0,0
2024-07-08,38,DPD90+,0,0,0
2024-07-08,40,Current,0,0,0
2024-07-08,40,DPD15-29,22,22,0
2024-07-08,40,DPD3-14,28,28,0
2024-07-08,40,DPD30-59,0,0,0
2024-07-08,40,DPD60-89,0,0,0
2024-07-08,40,DPD90+,0,0,0
2024-07-08,42,Current,0,0,0
2024-07-08,42,DPD15-29,13,13,0
2024-07-08,42,DPD3-14,24,24,0
2024-07-08,42,DPD30-59,3,3,0
2024-07-08,42,DPD60-89,0,0,0
2024-07-08,42,DPD90+,0,0,0
2024-07-08,44,Current,0,0,0
2024-07-08,44,DPD15-29,34,34,0
2024-07-08,44,DPD3-14,42,42,0
2024-07-08,44,DPD30-59,9,9,0
2024-07-08,44,DPD60-89,0,0,0
2024-07-08,44,DPD90+,0,0,0
2024-07-08,46,Current,0,0,0
2024-07-08,46,DPD3-14,0,0,0
2024-07-08,48,Current,46,46,0
2024-07-08,48,DPD15-29,13,13,0
2024-07-08,48,DPD3-14,25,25,0
2024-07-08,48,DPD30-59,4,4,0
2024-07-08,48,DPD60-89,0,0,0
2024-07-08,48,DPD90+,0,0,0
2024-07-08,6,Current,0,0,0
2024-07-08,6,DPD3-14,0,0,0
2024-07-07,100,Current,0,0,0
2024-07-07,100,DPD3-14,0,0,0
2024-07-07,102,Current,0,0,0
2024-07-07,102,DPD60-89,0,0,0
2024-07-07,102,DPD90+,0,0,0
2024-07-07,104,Current,0,0,0
2024-07-07,104,DPD15-29,0,0,0
2024-07-07,104,DPD30-59,0,0,0
2024-07-07,104,DPD60-89,0,0,0
2024-07-07,20,Current,0,0,0
2024-07-07,20,DPD15-29,236,236,0
2024-07-07,20,DPD3-14,392,392,0
2024-07-07,20,DPD30-59,105,105,0
2024-07-07,20,DPD60-89,41,41,0
2024-07-07,20,DPD90+,65,65,0
2024-07-07,22,Current,0,0,0
2024-07-07,22,DPD15-29,1,1,0
2024-07-07,22,DPD3-14,0,0,0
2024-07-07,22,DPD30-59,0,0,0
2024-07-07,24,Current,62,62,0
2024-07-07,24,DPD15-29,130,130,0
2024-07-07,24,DPD3-14,187,187,0
2024-07-07,24,DPD30-59,55,55,0
2024-07-07,24,DPD60-89,0,0,0
2024-07-07,24,DPD90+,0,0,0
2024-07-07,26,Current,0,0,0
2024-07-07,26,DPD15-29,19,19,0
2024-07-07,26,DPD3-14,33,33,0
2024-07-07,26,DPD30-59,7,7,0
2024-07-07,26,DPD60-89,0,0,0
2024-07-07,26,DPD90+,0,0,0
2024-07-07,32,Current,0,0,0
2024-07-07,32,DPD15-29,137,137,0
2024-07-07,32,DPD3-14,161,161,0
2024-07-07,32,DPD30-59,65,65,0
2024-07-07,32,DPD60-89,0,0,0
2024-07-07,32,DPD90+,0,0,0
2024-07-07,34,Current,0,0,0
2024-07-07,34,DPD15-29,50,50,0
2024-07-07,34,DPD3-14,63,63,0
2024-07-07,34,DPD30-59,25,25,0
2024-07-07,34,DPD60-89,0,0,0
2024-07-07,34,DPD90+,0,0,0
2024-07-07,36,Current,0,0,0
2024-07-07,36,DPD15-29,38,38,0
2024-07-07,36,DPD3-14,48,48,0
2024-07-07,36,DPD30-59,25,25,0
2024-07-07,36,DPD60-89,0,0,0
2024-07-07,36,DPD90+,0,0,0
2024-07-07,38,Current,0,0,0
2024-07-07,38,DPD15-29,32,32,0
2024-07-07,38,DPD3-14,61,61,0
2024-07-07,38,DPD30-59,15,15,0
2024-07-07,38,DPD60-89,0,0,0
2024-07-07,38,DPD90+,0,0,0
2024-07-07,40,Current,0,0,0
2024-07-07,40,DPD15-29,20,20,0
2024-07-07,40,DPD3-14,30,30,0
2024-07-07,40,DPD30-59,16,16,0
2024-07-07,40,DPD60-89,0,0,0
2024-07-07,40,DPD90+,0,0,0
2024-07-07,42,Current,0,0,0
2024-07-07,42,DPD15-29,14,14,0
2024-07-07,42,DPD3-14,14,14,0
2024-07-07,42,DPD30-59,4,4,0
2024-07-07,42,DPD60-89,0,0,0
2024-07-07,42,DPD90+,0,0,0
2024-07-07,44,Current,0,0,0
2024-07-07,44,DPD15-29,29,29,0
2024-07-07,44,DPD3-14,54,54,0
2024-07-07,44,DPD30-59,17,17,0
2024-07-07,44,DPD60-89,0,0,0
2024-07-07,44,DPD90+,0,0,0
2024-07-07,46,Current,0,0,0
2024-07-07,46,DPD3-14,1,1,0
2024-07-07,46,DPD30-59,0,0,0
2024-07-07,48,Current,31,31,0
2024-07-07,48,DPD15-29,31,31,0
2024-07-07,48,DPD3-14,32,32,0
2024-07-07,48,DPD30-59,5,5,0
2024-07-07,48,DPD60-89,0,0,0
2024-07-07,48,DPD90+,0,0,0
2024-07-07,6,Current,0,0,0
2024-07-07,6,DPD3-14,1,1,0
2024-07-06,100,Current,0,0,0
2024-07-06,100,DPD3-14,0,0,0
2024-07-06,102,Current,0,0,0
2024-07-06,102,DPD60-89,0,0,0
2024-07-06,104,Current,0,0,0
2024-07-06,104,DPD3-14,0,0,0
2024-07-06,104,DPD30-59,0,0,0
2024-07-06,104,DPD60-89,0,0,0
2024-07-06,20,Current,1,1,0
2024-07-06,20,DPD15-29,214,214,0
2024-07-06,20,DPD3-14,314,314,0
2024-07-06,20,DPD30-59,129,129,0
2024-07-06,20,DPD60-89,65,65,0
2024-07-06,20,DPD90+,24,24,0
2024-07-06,22,Current,0,0,0
2024-07-06,22,DPD15-29,0,0,0
2024-07-06,22,DPD3-14,3,3,0
2024-07-06,22,DPD30-59,0,0,0
2024-07-06,24,Current,50,50,0
2024-07-06,24,DPD15-29,112,112,0
2024-07-06,24,DPD3-14,180,180,0
2024-07-06,24,DPD30-59,68,68,0
2024-07-06,24,DPD60-89,0,0,0
2024-07-06,24,DPD90+,0,0,0
2024-07-06,26,Current,0,0,0
2024-07-06,26,DPD15-29,14,14,0
2024-07-06,26,DPD3-14,33,33,0
2024-07-06,26,DPD30-59,6,6,0
2024-07-06,26,DPD60-89,0,0,0
2024-07-06,26,DPD90+,0,0,0
2024-07-06,32,Current,0,0,0
2024-07-06,32,DPD15-29,110,110,0
2024-07-06,32,DPD3-14,152,152,0
2024-07-06,32,DPD30-59,57,57,0
2024-07-06,32,DPD60-89,0,0,0
2024-07-06,32,DPD90+,0,0,0
2024-07-06,34,Current,0,0,0
2024-07-06,34,DPD15-29,42,42,0
2024-07-06,34,DPD3-14,50,50,0
2024-07-06,34,DPD30-59,28,28,0
2024-07-06,34,DPD60-89,0,0,0
2024-07-06,34,DPD90+,0,0,0
2024-07-06,36,Current,0,0,0
2024-07-06,36,DPD15-29,34,34,0
2024-07-06,36,DPD3-14,34,34,0
2024-07-06,36,DPD30-59,18,18,0
2024-07-06,36,DPD60-89,0,0,0
2024-07-06,36,DPD90+,0,0,0
2024-07-06,38,Current,0,0,0
2024-07-06,38,DPD15-29,24,24,0
2024-07-06,38,DPD3-14,47,47,0
2024-07-06,38,DPD30-59,16,16,0
2024-07-06,38,DPD60-89,0,0,0
2024-07-06,38,DPD90+,0,0,0
2024-07-06,40,Current,0,0,0
2024-07-06,40,DPD15-29,21,21,0
2024-07-06,40,DPD3-14,26,26,0
2024-07-06,40,DPD30-59,0,0,0
2024-07-06,40,DPD60-89,0,0,0
2024-07-06,40,DPD90+,0,0,0
2024-07-06,42,Current,0,0,0
2024-07-06,42,DPD15-29,12,12,0
2024-07-06,42,DPD3-14,24,24,0
2024-07-06,42,DPD30-59,8,8,0
2024-07-06,42,DPD60-89,0,0,0
2024-07-06,42,DPD90+,0,0,0
2024-07-06,44,Current,0,0,0
2024-07-06,44,DPD15-29,34,34,0
2024-07-06,44,DPD3-14,38,38,0
2024-07-06,44,DPD30-59,18,18,0
2024-07-06,44,DPD60-89,0,0,0
2024-07-06,44,DPD90+,0,0,0
2024-07-06,46,Current,0,0,0
2024-07-06,46,DPD15-29,0,0,0
2024-07-06,46,DPD3-14,0,0,0
2024-07-06,48,Current,40,40,0
2024-07-06,48,DPD15-29,12,12,0
2024-07-06,48,DPD3-14,20,20,0
2024-07-06,48,DPD30-59,8,8,0
2024-07-06,48,DPD60-89,0,0,0
2024-07-06,48,DPD90+,0,0,0
2024-07-06,6,Current,0,0,0
2024-07-06,6,DPD3-14,0,0,0
2024-07-05,100,Current,0,0,0
2024-07-05,102,Current,0,0,0
2024-07-05,102,DPD60-89,0,0,0
2024-07-05,104,Current,0,0,0
2024-07-05,104,DPD3-14,0,0,0
2024-07-05,104,DPD30-59,0,0,0
2024-07-05,104,DPD60-89,0,0,0
2024-07-05,20,Current,0,0,0
2024-07-05,20,DPD15-29,220,220,0
2024-07-05,20,DPD3-14,438,438,0
2024-07-05,20,DPD30-59,71,71,0
2024-07-05,20,DPD60-89,43,43,0
2024-07-05,20,DPD90+,45,45,0
2024-07-05,22,Current,0,0,0
2024-07-05,22,DPD3-14,1,1,0
2024-07-05,22,DPD30-59,1,1,0
2024-07-05,24,Current,157,157,0
2024-07-05,24,DPD15-29,131,131,0
2024-07-05,24,DPD3-14,197,197,0
2024-07-05,24,DPD30-59,31,31,0
2024-07-05,24,DPD60-89,0,0,0
2024-07-05,24,DPD90+,0,0,0
2024-07-05,26,Current,0,0,0
2024-07-05,26,DPD15-29,20,20,0
2024-07-05,26,DPD3-14,29,29,0
2024-07-05,26,DPD30-59,5,5,0
2024-07-05,26,DPD60-89,0,0,0
2024-07-05,26,DPD90+,0,0,0
2024-07-05,32,Current,0,0,0
2024-07-05,32,DPD15-29,123,123,0
2024-07-05,32,DPD3-14,174,174,0
2024-07-05,32,DPD30-59,22,22,0
2024-07-05,32,DPD60-89,0,0,0
2024-07-05,32,DPD90+,0,0,0
2024-07-05,34,Current,0,0,0
2024-07-05,34,DPD15-29,40,40,0
2024-07-05,34,DPD3-14,74,74,0
2024-07-05,34,DPD30-59,14,14,0
2024-07-05,34,DPD60-89,0,0,0
2024-07-05,34,DPD90+,0,0,0
2024-07-05,36,Current,0,0,0
2024-07-05,36,DPD15-29,34,34,0
2024-07-05,36,DPD3-14,60,60,0
2024-07-05,36,DPD30-59,4,4,0
2024-07-05,36,DPD60-89,0,0,0
2024-07-05,36,DPD90+,0,0,0
2024-07-05,38,Current,0,0,0
2024-07-05,38,DPD15-29,27,27,0
2024-07-05,38,DPD3-14,69,69,0
2024-07-05,38,DPD30-59,5,5,0
2024-07-05,38,DPD60-89,0,0,0
2024-07-05,38,DPD90+,0,0,0
2024-07-05,40,Current,0,0,0
2024-07-05,40,DPD15-29,19,19,0
2024-07-05,40,DPD3-14,34,34,0
2024-07-05,40,DPD30-59,3,3,0
2024-07-05,40,DPD60-89,0,0,0
2024-07-05,40,DPD90+,0,0,0
2024-07-05,42,Current,0,0,0
2024-07-05,42,DPD15-29,17,17,0
2024-07-05,42,DPD3-14,13,13,0
2024-07-05,42,DPD30-59,4,4,0
2024-07-05,42,DPD60-89,0,0,0
2024-07-05,42,DPD90+,0,0,0
2024-07-05,44,Current,0,0,0
2024-07-05,44,DPD15-29,28,28,0
2024-07-05,44,DPD3-14,60,60,0
2024-07-05,44,DPD30-59,3,3,0
2024-07-05,44,DPD60-89,0,0,0
2024-07-05,44,DPD90+,0,0,0
2024-07-05,46,Current,0,0,0
2024-07-05,46,DPD15-29,1,1,0
2024-07-05,46,DPD3-14,1,1,0
2024-07-05,48,Current,138,138,0
2024-07-05,48,DPD15-29,34,34,0
2024-07-05,48,DPD3-14,38,38,0
2024-07-05,48,DPD30-59,18,18,0
2024-07-05,48,DPD60-89,0,0,0
2024-07-05,48,DPD90+,0,0,0
2024-07-05,6,Current,0,0,0
2024-07-05,6,DPD3-14,1,1,0
2024-07-05,6,DPD90+,0,0,0
2024-07-04,100,Current,0,0,0
2024-07-04,100,DPD60-89,0,0,0
2024-07-04,102,Current,0,0,0
2024-07-04,102,DPD30-59,0,0,0
2024-07-04,102,DPD60-89,0,0,0
2024-07-04,104,Current,0,0,0
2024-07-04,104,DPD3-14,0,0,0
2024-07-04,104,DPD30-59,1,1,0
2024-07-04,104,DPD60-89,0,0,0
2024-07-04,20,Current,0,0,0
2024-07-04,20,DPD15-29,194,194,0
2024-07-04,20,DPD3-14,300,300,0
2024-07-04,20,DPD30-59,37,37,0
2024-07-04,20,DPD60-89,3,3,0
2024-07-04,20,DPD90+,2,2,0
2024-07-04,22,Current,0,0,0
2024-07-04,22,DPD3-14,3,3,0
2024-07-04,22,DPD30-59,0,0,0
2024-07-04,22,DPD60-89,0,0,0
2024-07-04,24,Current,49,49,0
2024-07-04,24,DPD15-29,103,103,0
2024-07-04,24,DPD3-14,171,171,0
2024-07-04,24,DPD30-59,30,30,0
2024-07-04,24,DPD60-89,0,0,0
2024-07-04,24,DPD90+,0,0,0
2024-07-04,26,Current,0,0,0
2024-07-04,26,DPD15-29,12,12,0
2024-07-04,26,DPD3-14,35,35,0
2024-07-04,26,DPD30-59,1,1,0
2024-07-04,26,DPD60-89,0,0,0
2024-07-04,26,DPD90+,0,0,0
2024-07-04,32,Current,0,0,0
2024-07-04,32,DPD15-29,86,86,0
2024-07-04,32,DPD3-14,173,173,0
2024-07-04,32,DPD30-59,19,19,0
2024-07-04,32,DPD60-89,0,0,0
2024-07-04,32,DPD90+,0,0,0
2024-07-04,34,Current,0,0,0
2024-07-04,34,DPD15-29,36,36,0
2024-07-04,34,DPD3-14,59,59,0
2024-07-04,34,DPD30-59,7,7,0
2024-07-04,34,DPD60-89,0,0,0
2024-07-04,34,DPD90+,0,0,0
2024-07-04,36,Current,0,0,0
2024-07-04,36,DPD15-29,29,29,0
2024-07-04,36,DPD3-14,36,36,0
2024-07-04,36,DPD30-59,7,7,0
2024-07-04,36,DPD60-89,0,0,0
2024-07-04,36,DPD90+,0,0,0
2024-07-04,38,Current,0,0,0
2024-07-04,38,DPD15-29,22,22,0
2024-07-04,38,DPD3-14,45,45,0
2024-07-04,38,DPD30-59,1,1,0
2024-07-04,38,DPD60-89,0,0,0
2024-07-04,38,DPD90+,0,0,0
2024-07-04,40,Current,0,0,0
2024-07-04,40,DPD15-29,21,21,0
2024-07-04,40,DPD3-14,31,31,0
2024-07-04,40,DPD30-59,0,0,0
2024-07-04,40,DPD60-89,0,0,0
2024-07-04,40,DPD90+,0,0,0
2024-07-04,42,Current,0,0,0
2024-07-04,42,DPD15-29,10,10,0
2024-07-04,42,DPD3-14,22,22,0
2024-07-04,42,DPD30-59,3,3,0
2024-07-04,42,DPD60-89,0,0,0
2024-07-04,42,DPD90+,0,0,0
2024-07-04,44,Current,0,0,0
2024-07-04,44,DPD15-29,31,31,0
2024-07-04,44,DPD3-14,31,31,0
2024-07-04,44,DPD30-59,7,7,0
2024-07-04,44,DPD60-89,0,0,0
2024-07-04,44,DPD90+,0,0,0
2024-07-04,46,Current,0,0,0
2024-07-04,46,DPD15-29,0,0,0
2024-07-04,46,DPD3-14,0,0,0
2024-07-04,48,Current,36,36,0
2024-07-04,48,DPD15-29,13,13,0
2024-07-04,48,DPD3-14,15,15,0
2024-07-04,48,DPD30-59,3,3,0
2024-07-04,48,DPD60-89,0,0,0
2024-07-04,48,DPD90+,0,0,0
2024-07-04,6,Current,0,0,0
2024-07-04,6,DPD3-14,0,0,0
2024-07-04,6,DPD90+,0,0,0
2024-07-03,100,Current,0,0,0
2024-07-03,100,DPD60-89,0,0,0
2024-07-03,102,Current,0,0,0
2024-07-03,102,DPD30-59,0,0,0
2024-07-03,102,DPD60-89,0,0,0
2024-07-03,104,Current,0,0,0
2024-07-03,104,DPD3-14,0,0,0
2024-07-03,104,DPD30-59,0,0,0
2024-07-03,104,DPD60-89,0,0,0
2024-07-03,20,Current,0,0,0
2024-07-03,20,DPD15-29,225,225,0
2024-07-03,20,DPD3-14,307,307,0
2024-07-03,20,DPD30-59,126,126,0
2024-07-03,20,DPD60-89,47,47,0
2024-07-03,20,DPD90+,29,29,0
2024-07-03,22,Current,0,0,0
2024-07-03,22,DPD3-14,1,1,0
2024-07-03,22,DPD30-59,0,0,0
2024-07-03,22,DPD60-89,0,0,0
2024-07-03,24,Current,20,20,0
2024-07-03,24,DPD15-29,122,122,0
2024-07-03,24,DPD3-14,150,150,0
2024-07-03,24,DPD30-59,59,59,0
2024-07-03,24,DPD60-89,0,0,0
2024-07-03,24,DPD90+,0,0,0
2024-07-03,26,Current,0,0,0
2024-07-03,26,DPD15-29,16,16,0
2024-07-03,26,DPD3-14,25,25,0
2024-07-03,26,DPD30-59,8,8,0
2024-07-03,26,DPD60-89,0,0,0
2024-07-03,26,DPD90+,0,0,0
2024-07-03,32,Current,0,0,0
2024-07-03,32,DPD15-29,117,117,0
2024-07-03,32,DPD3-14,128,128,0
2024-07-03,32,DPD30-59,69,69,0
2024-07-03,32,DPD60-89,0,0,0
2024-07-03,32,DPD90+,0,0,0
2024-07-03,34,Current,0,0,0
2024-07-03,34,DPD15-29,40,40,0
2024-07-03,34,DPD3-14,62,62,0
2024-07-03,34,DPD30-59,27,27,0
2024-07-03,34,DPD60-89,0,0,0
2024-07-03,34,DPD90+,0,0,0
2024-07-03,36,Current,0,0,0
2024-07-03,36,DPD15-29,30,30,0
2024-07-03,36,DPD3-14,45,45,0
2024-07-03,36,DPD30-59,23,23,0
2024-07-03,36,DPD60-89,0,0,0
2024-07-03,36,DPD90+,0,0,0
2024-07-03,38,Current,0,0,0
2024-07-03,38,DPD15-29,23,23,0
2024-07-03,38,DPD3-14,52,52,0
2024-07-03,38,DPD30-59,17,17,0
2024-07-03,38,DPD60-89,0,0,0
2024-07-03,38,DPD90+,0,0,0
2024-07-03,40,Current,0,0,0
2024-07-03,40,DPD15-29,18,18,0
2024-07-03,40,DPD3-14,30,30,0
2024-07-03,40,DPD30-59,14,14,0
2024-07-03,40,DPD60-89,0,0,0
2024-07-03,40,DPD90+,0,0,0
2024-07-03,42,Current,0,0,0
2024-07-03,42,DPD15-29,17,17,0
2024-07-03,42,DPD3-14,9,9,0
2024-07-03,42,DPD30-59,4,4,0
2024-07-03,42,DPD60-89,0,0,0
2024-07-03,42,DPD90+,0,0,0
2024-07-03,44,Current,0,0,0
2024-07-03,44,DPD15-29,15,15,0
2024-07-03,44,DPD3-14,44,44,0
2024-07-03,44,DPD30-59,18,18,0
2024-07-03,44,DPD60-89,0,0,0
2024-07-03,44,DPD90+,0,0,0
2024-07-03,46,Current,0,0,0
2024-07-03,46,DPD15-29,1,1,0
2024-07-03,48,Current,22,22,0
2024-07-03,48,DPD15-29,33,33,0
2024-07-03,48,DPD3-14,25,25,0
2024-07-03,48,DPD30-59,3,3,0
2024-07-03,48,DPD60-89,0,0,0
2024-07-03,48,DPD90+,0,0,0
2024-07-03,6,Current,0,0,0
2024-07-03,6,DPD3-14,1,1,0
2024-07-03,6,DPD90+,0,0,0
2024-07-02,100,Current,0,0,0
2024-07-02,100,DPD60-89,0,0,0
2024-07-02,102,Current,0,0,0
2024-07-02,102,DPD30-59,0,0,0
2024-07-02,102,DPD60-89,0,0,0
2024-07-02,104,Current,0,0,0
2024-07-02,104,DPD3-14,0,0,0
2024-07-02,104,DPD30-59,0,0,0
2024-07-02,104,DPD60-89,0,0,0
2024-07-02,20,Current,0,0,0
2024-07-02,20,DPD15-29,199,199,0
2024-07-02,20,DPD3-14,449,449,0
2024-07-02,20,DPD30-59,135,135,0
2024-07-02,20,DPD60-89,69,69,0
2024-07-02,20,DPD90+,40,40,0
2024-07-02,22,Current,0,0,0
2024-07-02,22,DPD3-14,3,3,0
2024-07-02,22,DPD30-59,0,0,0
2024-07-02,24,Current,53,53,0
2024-07-02,24,DPD15-29,101,101,0
2024-07-02,24,DPD3-14,263,263,0
2024-07-02,24,DPD30-59,79,79,0
2024-07-02,24,DPD60-89,0,0,0
2024-07-02,24,DPD90+,0,0,0
2024-07-02,26,Current,0,0,0
2024-07-02,26,DPD15-29,12,12,0
2024-07-02,26,DPD3-14,45,45,0
2024-07-02,26,DPD30-59,9,9,0
2024-07-02,26,DPD60-89,0,0,0
2024-07-02,26,DPD90+,0,0,0
2024-07-02,32,Current,0,0,0
2024-07-02,32,DPD15-29,91,91,0
2024-07-02,32,DPD3-14,219,219,0
2024-07-02,32,DPD30-59,66,66,0
2024-07-02,32,DPD60-89,0,0,0
2024-07-02,32,DPD90+,0,0,0
2024-07-02,34,Current,0,0,0
2024-07-02,34,DPD15-29,35,35,0
2024-07-02,34,DPD3-14,87,87,0
2024-07-02,34,DPD30-59,28,28,0
2024-07-02,34,DPD60-89,0,0,0
2024-07-02,34,DPD90+,0,0,0
2024-07-02,36,Current,0,0,0
2024-07-02,36,DPD15-29,29,29,0
2024-07-02,36,DPD3-14,55,55,0
2024-07-02,36,DPD30-59,22,22,0
2024-07-02,36,DPD60-89,0,0,0
2024-07-02,36,DPD90+,0,0,0
2024-07-02,38,Current,0,0,0
2024-07-02,38,DPD15-29,20,20,0
2024-07-02,38,DPD3-14,59,59,0
2024-07-02,38,DPD30-59,17,17,0
2024-07-02,38,DPD60-89,0,0,0
2024-07-02,38,DPD90+,0,0,0
2024-07-02,40,Current,0,0,0
2024-07-02,40,DPD15-29,20,20,0
2024-07-02,40,DPD3-14,39,39,0
2024-07-02,40,DPD30-59,1,1,0
2024-07-02,40,DPD60-89,0,0,0
2024-07-02,40,DPD90+,0,0,0
2024-07-02,42,Current,0,0,0
2024-07-02,42,DPD15-29,9,9,0
2024-07-02,42,DPD3-14,27,27,0
2024-07-02,42,DPD30-59,9,9,0
2024-07-02,42,DPD60-89,0,0,0
2024-07-02,42,DPD90+,0,0,0
2024-07-02,44,Current,0,0,0
2024-07-02,44,DPD15-29,25,25,0
2024-07-02,44,DPD3-14,53,53,0
2024-07-02,44,DPD30-59,16,16,0
2024-07-02,44,DPD60-89,0,0,0
2024-07-02,44,DPD90+,0,0,0
2024-07-02,46,Current,0,0,0
2024-07-02,46,DPD15-29,0,0,0
2024-07-02,48,Current,22,22,0
2024-07-02,48,DPD15-29,17,17,0
2024-07-02,48,DPD3-14,34,34,0
2024-07-02,48,DPD30-59,6,6,0
2024-07-02,48,DPD60-89,0,0,0
2024-07-02,48,DPD90+,0,0,0
2024-07-02,6,Current,0,0,0
2024-07-02,6,DPD3-14,0,0,0
2024-07-02,6,DPD90+,0,0,0
2024-07-01,100,Current,0,0,0
2024-07-01,100,DPD30-59,0,0,0
2024-07-01,102,Current,0,0,0
2024-07-01,102,DPD30-59,0,0,0
2024-07-01,102,DPD60-89,0,0,0
2024-07-01,104,Current,0,0,0
2024-07-01,104,DPD3-14,0,0,0
2024-07-01,104,DPD30-59,0,0,0
2024-07-01,104,DPD60-89,0,0,0
2024-07-01,20,Current,4624,4624,0
2024-07-01,20,DPD15-29,319,319,0
2024-07-01,20,DPD3-14,517,517,0
2024-07-01,20,DPD30-59,85,85,0
2024-07-01,20,DPD60-89,49,49,0
2024-07-01,20,DPD90+,27,27,0
2024-07-01,22,Current,0,0,0
2024-07-01,22,DPD3-14,1,1,0
2024-07-01,22,DPD30-59,1,1,0
2024-07-01,24,Current,4051,4051,0
2024-07-01,24,DPD15-29,158,158,0
2024-07-01,24,DPD3-14,280,280,0
2024-07-01,24,DPD30-59,40,40,0
2024-07-01,24,DPD60-89,10,10,0
2024-07-01,24,DPD90+,11,11,0
2024-07-01,26,Current,0,0,0
2024-07-01,26,DPD15-29,18,18,0
2024-07-01,26,DPD3-14,35,35,0
2024-07-01,26,DPD30-59,4,4,0
2024-07-01,26,DPD60-89,0,0,0
2024-07-01,26,DPD90+,0,0,0
2024-07-01,32,Current,237,237,0
2024-07-01,32,DPD15-29,126,126,0
2024-07-01,32,DPD3-14,189,189,0
2024-07-01,32,DPD30-59,20,20,0
2024-07-01,32,DPD60-89,5,5,0
2024-07-01,32,DPD90+,3,3,0
2024-07-01,34,Current,0,0,0
2024-07-01,34,DPD15-29,34,34,0
2024-07-01,34,DPD3-14,88,88,0
2024-07-01,34,DPD30-59,13,13,0
2024-07-01,34,DPD60-89,0,0,0
2024-07-01,34,DPD90+,0,0,0
2024-07-01,36,Current,252,252,0
2024-07-01,36,DPD15-29,30,30,0
2024-07-01,36,DPD3-14,62,62,0
2024-07-01,36,DPD30-59,8,8,0
2024-07-01,36,DPD60-89,2,2,0
2024-07-01,36,DPD90+,1,1,0
2024-07-01,38,Current,0,0,0
2024-07-01,38,DPD15-29,25,25,0
2024-07-01,38,DPD3-14,73,73,0
2024-07-01,38,DPD30-59,6,6,0
2024-07-01,38,DPD60-89,0,0,0
2024-07-01,38,DPD90+,0,0,0
2024-07-01,40,Current,275,275,0
2024-07-01,40,DPD15-29,27,27,0
2024-07-01,40,DPD3-14,45,45,0
2024-07-01,40,DPD30-59,2,2,0
2024-07-01,40,DPD60-89,3,3,0
2024-07-01,40,DPD90+,0,0,0
2024-07-01,42,Current,0,0,0
2024-07-01,42,DPD15-29,19,19,0
2024-07-01,42,DPD3-14,20,20,0
2024-07-01,42,DPD30-59,4,4,0
2024-07-01,42,DPD60-89,0,0,0
2024-07-01,42,DPD90+,0,0,0
2024-07-01,44,Current,174,174,0
2024-07-01,44,DPD15-29,24,24,0
2024-07-01,44,DPD3-14,68,68,0
2024-07-01,44,DPD30-59,7,7,0
2024-07-01,44,DPD60-89,3,3,0
2024-07-01,44,DPD90+,0,0,0
2024-07-01,46,Current,4,4,0
2024-07-01,46,DPD15-29,1,1,0
2024-07-01,48,Current,4319,4319,0
2024-07-01,48,DPD15-29,60,60,0
2024-07-01,48,DPD3-14,79,79,0
2024-07-01,48,DPD30-59,35,35,0
2024-07-01,48,DPD60-89,13,13,0
2024-07-01,48,DPD90+,12,12,0
2024-07-01,6,Current,0,0,0
2024-07-01,6,DPD3-14,1,1,0
2024-07-01,6,DPD90+,0,0,0
2024-06-30,100,Current,0,0,0
2024-06-30,100,DPD3-14,1,1,0
2024-06-30,100,DPD30-59,1,1,0
2024-06-30,102,Current,0,0,0
2024-06-30,102,DPD3-14,1,1,0
2024-06-30,102,DPD30-59,0,0,0
2024-06-30,102,DPD60-89,0,0,0
2024-06-30,104,Current,0,0,0
2024-06-30,104,DPD3-14,0,0,0
2024-06-30,104,DPD30-59,1,1,0
2024-06-30,104,DPD60-89,0,0,0
2024-06-30,20,Current,0,0,0
2024-06-30,20,DPD15-29,167,167,0
2024-06-30,20,DPD3-14,335,335,0
2024-06-30,20,DPD30-59,76,76,0
2024-06-30,20,DPD60-89,15,15,0
2024-06-30,20,DPD90+,10,10,0
2024-06-30,22,Current,0,0,0
2024-06-30,22,DPD3-14,2,2,0
2024-06-30,22,DPD30-59,0,0,0
2024-06-30,24,Current,119,119,0
2024-06-30,24,DPD15-29,85,85,0
2024-06-30,24,DPD3-14,204,204,0
2024-06-30,24,DPD30-59,46,46,0
2024-06-30,24,DPD60-89,0,0,0
2024-06-30,24,DPD90+,0,0,0
2024-06-30,26,Current,0,0,0
2024-06-30,26,DPD15-29,11,11,0
2024-06-30,26,DPD3-14,26,26,0
2024-06-30,26,DPD30-59,4,4,0
2024-06-30,26,DPD60-89,0,0,0
2024-06-30,26,DPD90+,0,0,0
2024-06-30,32,Current,0,0,0
2024-06-30,32,DPD15-29,64,64,0
2024-06-30,32,DPD3-14,173,173,0
2024-06-30,32,DPD30-59,49,49,0
2024-06-30,32,DPD60-89,0,0,0
2024-06-30,32,DPD90+,0,0,0
2024-06-30,34,Current,0,0,0
2024-06-30,34,DPD15-29,33,33,0
2024-06-30,34,DPD3-14,56,56,0
2024-06-30,34,DPD30-59,23,23,0
2024-06-30,34,DPD60-89,0,0,0
2024-06-30,34,DPD90+,0,0,0
2024-06-30,36,Current,0,0,0
2024-06-30,36,DPD15-29,23,23,0
2024-06-30,36,DPD3-14,50,50,0
2024-06-30,36,DPD30-59,9,9,0
2024-06-30,36,DPD60-89,0,0,0
2024-06-30,36,DPD90+,0,0,0
2024-06-30,38,Current,0,0,0
2024-06-30,38,DPD15-29,15,15,0
2024-06-30,38,DPD3-14,52,52,0
2024-06-30,38,DPD30-59,9,9,0
2024-06-30,38,DPD60-89,0,0,0
2024-06-30,38,DPD90+,0,0,0
2024-06-30,40,Current,0,0,0
2024-06-30,40,DPD15-29,17,17,0
2024-06-30,40,DPD3-14,28,28,0
2024-06-30,40,DPD30-59,1,1,0
2024-06-30,40,DPD60-89,0,0,0
2024-06-30,40,DPD90+,0,0,0
2024-06-30,42,Current,0,0,0
2024-06-30,42,DPD15-29,9,9,0
2024-06-30,42,DPD3-14,17,17,0
2024-06-30,42,DPD30-59,3,3,0
2024-06-30,42,DPD60-89,0,0,0
2024-06-30,42,DPD90+,0,0,0
2024-06-30,44,Current,0,0,0
2024-06-30,44,DPD15-29,19,19,0
2024-06-30,44,DPD3-14,46,46,0
2024-06-30,44,DPD30-59,12,12,0
2024-06-30,44,DPD60-89,0,0,0
2024-06-30,44,DPD90+,0,0,0
2024-06-30,46,Current,0,0,0
2024-06-30,46,DPD15-29,0,0,0
2024-06-30,48,Current,62,62,0
2024-06-30,48,DPD15-29,16,16,0
2024-06-30,48,DPD3-14,20,20,0
2024-06-30,48,DPD30-59,1,1,0
2024-06-30,48,DPD60-89,0,0,0
2024-06-30,48,DPD90+,0,0,0
2024-06-30,6,Current,0,0,0
2024-06-30,6,DPD3-14,0,0,0
2024-06-30,6,DPD90+,0,0,0
2024-06-29,100,Current,0,0,0
2024-06-29,100,DPD3-14,0,0,0
2024-06-29,100,DPD30-59,0,0,0
2024-06-29,102,Current,0,0,0
2024-06-29,102,DPD3-14,0,0,0
2024-06-29,102,DPD30-59,0,0,0
2024-06-29,102,DPD60-89,0,0,0
2024-06-29,104,Current,0,0,0
2024-06-29,104,DPD3-14,0,0,0
2024-06-29,104,DPD30-59,0,0,0
2024-06-29,20,Current,0,0,0
2024-06-29,20,DPD15-29,151,151,0
2024-06-29,20,DPD3-14,403,403,0
2024-06-29,20,DPD30-59,64,64,0
2024-06-29,20,DPD60-89,47,47,0
2024-06-29,20,DPD90+,58,58,0
2024-06-29,22,Current,0,0,0
2024-06-29,22,DPD3-14,1,1,0
2024-06-29,22,DPD30-59,1,1,0
2024-06-29,24,Current,42,42,0
2024-06-29,24,DPD15-29,89,89,0
2024-06-29,24,DPD3-14,230,230,0
2024-06-29,24,DPD30-59,32,32,0
2024-06-29,24,DPD60-89,0,0,0
2024-06-29,24,DPD90+,0,0,0
2024-06-29,26,Current,0,0,0
2024-06-29,26,DPD15-29,10,10,0
2024-06-29,26,DPD3-14,39,39,0
2024-06-29,26,DPD30-59,4,4,0
2024-06-29,26,DPD60-89,0,0,0
2024-06-29,26,DPD90+,0,0,0
2024-06-29,32,Current,0,0,0
2024-06-29,32,DPD15-29,71,71,0
2024-06-29,32,DPD3-14,186,186,0
2024-06-29,32,DPD30-59,40,40,0
2024-06-29,32,DPD60-89,0,0,0
2024-06-29,32,DPD90+,0,0,0
2024-06-29,34,Current,0,0,0
2024-06-29,34,DPD15-29,24,24,0
2024-06-29,34,DPD3-14,82,82,0
2024-06-29,34,DPD30-59,15,15,0
2024-06-29,34,DPD60-89,0,0,0
2024-06-29,34,DPD90+,0,0,0
2024-06-29,36,Current,0,0,0
2024-06-29,36,DPD15-29,19,19,0
2024-06-29,36,DPD3-14,57,57,0
2024-06-29,36,DPD30-59,16,16,0
2024-06-29,36,DPD60-89,0,0,0
2024-06-29,36,DPD90+,0,0,0
2024-06-29,38,Current,0,0,0
2024-06-29,38,DPD15-29,15,15,0
2024-06-29,38,DPD3-14,65,65,0
2024-06-29,38,DPD30-59,11,11,0
2024-06-29,38,DPD60-89,0,0,0
2024-06-29,38,DPD90+,0,0,0
2024-06-29,40,Current,0,0,0
2024-06-29,40,DPD15-29,14,14,0
2024-06-29,40,DPD3-14,36,36,0
2024-06-29,40,DPD30-59,5,5,0
2024-06-29,40,DPD60-89,0,0,0
2024-06-29,40,DPD90+,0,0,0
2024-06-29,42,Current,0,0,0
2024-06-29,42,DPD15-29,9,9,0
2024-06-29,42,DPD3-14,24,24,0
2024-06-29,42,DPD30-59,1,1,0
2024-06-29,42,DPD60-89,0,0,0
2024-06-29,42,DPD90+,0,0,0
2024-06-29,44,Current,0,0,0
2024-06-29,44,DPD15-29,16,16,0
2024-06-29,44,DPD3-14,62,62,0
2024-06-29,44,DPD30-59,8,8,0
2024-06-29,44,DPD60-89,0,0,0
2024-06-29,44,DPD90+,0,0,0
2024-06-29,46,Current,0,0,0
2024-06-29,46,DPD15-29,1,1,0
2024-06-29,48,Current,26,26,0
2024-06-29,48,DPD15-29,15,15,0
2024-06-29,48,DPD3-14,37,37,0
2024-06-29,48,DPD30-59,1,1,0
2024-06-29,48,DPD60-89,0,0,0
2024-06-29,48,DPD90+,0,0,0
2024-06-29,6,Current,0,0,0
2024-06-29,6,DPD90+,0,0,0
2024-06-28,100,Current,0,0,0
2024-06-28,100,DPD30-59,0,0,0
2024-06-28,102,Current,0,0,0
2024-06-28,102,DPD3-14,1,1,0
2024-06-28,102,DPD30-59,0,0,0
2024-06-28,102,DPD60-89,0,0,0
2024-06-28,104,Current,0,0,0
2024-06-28,104,DPD3-14,0,0,0
2024-06-28,104,DPD30-59,0,0,0
2024-06-28,20,Current,0,0,0
2024-06-28,20,DPD15-29,137,137,0
2024-06-28,20,DPD3-14,359,359,0
2024-06-28,20,DPD30-59,140,140,0
2024-06-28,20,DPD60-89,103,103,0
2024-06-28,20,DPD90+,46,46,0
2024-06-28,22,Current,0,0,0
2024-06-28,22,DPD3-14,1,1,0
2024-06-28,22,DPD30-59,0,0,0
2024-06-28,24,Current,39,39,0
2024-06-28,24,DPD15-29,74,74,0
2024-06-28,24,DPD3-14,180,180,0
2024-06-28,24,DPD30-59,75,75,0
2024-06-28,24,DPD60-89,0,0,0
2024-06-28,24,DPD90+,0,0,0
2024-06-28,26,Current,0,0,0
2024-06-28,26,DPD15-29,10,10,0
2024-06-28,26,DPD3-14,24,24,0
2024-06-28,26,DPD30-59,11,11,0
2024-06-28,26,DPD60-89,0,0,0
2024-06-28,26,DPD90+,0,0,0
2024-06-28,32,Current,0,0,0
2024-06-28,32,DPD15-29,56,56,0
2024-06-28,32,DPD3-14,163,163,0
2024-06-28,32,DPD30-59,72,72,0
2024-06-28,32,DPD60-89,0,0,0
2024-06-28,32,DPD90+,0,0,0
2024-06-28,34,Current,0,0,0
2024-06-28,34,DPD15-29,28,28,0
2024-06-28,34,DPD3-14,67,67,0
2024-06-28,34,DPD30-59,27,27,0
2024-06-28,34,DPD60-89,0,0,0
2024-06-28,34,DPD90+,0,0,0
2024-06-28,36,Current,0,0,0
2024-06-28,36,DPD15-29,16,16,0
2024-06-28,36,DPD3-14,53,53,0
2024-06-28,36,DPD30-59,20,20,0
2024-06-28,36,DPD60-89,0,0,0
2024-06-28,36,DPD90+,0,0,0
2024-06-28,38,Current,0,0,0
2024-06-28,38,DPD15-29,15,15,0
2024-06-28,38,DPD3-14,51,51,0
2024-06-28,38,DPD30-59,14,14,0
2024-06-28,38,DPD60-89,0,0,0
2024-06-28,38,DPD90+,0,0,0
2024-06-28,40,Current,0,0,0
2024-06-28,40,DPD15-29,18,18,0
2024-06-28,40,DPD3-14,28,28,0
2024-06-28,40,DPD30-59,12,12,0
2024-06-28,40,DPD60-89,0,0,0
2024-06-28,40,DPD90+,0,0,0
2024-06-28,42,Current,0,0,0
2024-06-28,42,DPD15-29,8,8,0
2024-06-28,42,DPD3-14,16,16,0
2024-06-28,42,DPD30-59,11,11,0
2024-06-28,42,DPD60-89,0,0,0
2024-06-28,42,DPD90+,0,0,0
2024-06-28,44,Current,0,0,0
2024-06-28,44,DPD15-29,16,16,0
2024-06-28,44,DPD3-14,43,43,0
2024-06-28,44,DPD30-59,17,17,0
2024-06-28,44,DPD60-89,0,0,0
2024-06-28,44,DPD90+,0,0,0
2024-06-28,46,Current,0,0,0
2024-06-28,46,DPD15-29,0,0,0
2024-06-28,48,Current,30,30,0
2024-06-28,48,DPD15-29,15,15,0
2024-06-28,48,DPD3-14,23,23,0
2024-06-28,48,DPD30-59,8,8,0
2024-06-28,48,DPD60-89,0,0,0
2024-06-28,48,DPD90+,0,0,0
2024-06-28,6,Current,0,0,0
2024-06-28,6,DPD90+,0,0,0
2024-06-27,100,Current,0,0,0
2024-06-27,100,DPD30-59,0,0,0
2024-06-27,102,Current,0,0,0
2024-06-27,102,DPD3-14,0,0,0
2024-06-27,102,DPD30-59,0,0,0
2024-06-27,102,DPD60-89,0,0,0
2024-06-27,104,Current,0,0,0
2024-06-27,104,DPD3-14,0,0,0
2024-06-27,104,DPD30-59,0,0,0
2024-06-27,20,Current,0,0,0
2024-06-27,20,DPD15-29,187,187,0
2024-06-27,20,DPD3-14,422,422,0
2024-06-27,20,DPD30-59,55,55,0
2024-06-27,20,DPD60-89,13,13,0
2024-06-27,20,DPD90+,37,37,0
2024-06-27,22,Current,0,0,0
2024-06-27,22,DPD3-14,1,1,0
2024-06-27,22,DPD30-59,1,1,0
2024-06-27,24,Current,20,20,0
2024-06-27,24,DPD15-29,109,109,0
2024-06-27,24,DPD3-14,242,242,0
2024-06-27,24,DPD30-59,25,25,0
2024-06-27,24,DPD60-89,0,0,0
2024-06-27,24,DPD90+,0,0,0
2024-06-27,26,Current,0,0,0
2024-06-27,26,DPD15-29,10,10,0
2024-06-27,26,DPD3-14,35,35,0
2024-06-27,26,DPD30-59,4,4,0
2024-06-27,26,DPD60-89,0,0,0
2024-06-27,26,DPD90+,0,0,0
2024-06-27,32,Current,0,0,0
2024-06-27,32,DPD15-29,95,95,0
2024-06-27,32,DPD3-14,214,214,0
2024-06-27,32,DPD30-59,23,23,0
2024-06-27,32,DPD60-89,0,0,0
2024-06-27,32,DPD90+,0,0,0
2024-06-27,34,Current,0,0,0
2024-06-27,34,DPD15-29,31,31,0
2024-06-27,34,DPD3-14,81,81,0
2024-06-27,34,DPD30-59,15,15,0
2024-06-27,34,DPD60-89,0,0,0
2024-06-27,34,DPD90+,0,0,0
2024-06-27,36,Current,0,0,0
2024-06-27,36,DPD15-29,23,23,0
2024-06-27,36,DPD3-14,59,59,0
2024-06-27,36,DPD30-59,7,7,0
2024-06-27,36,DPD60-89,0,0,0
2024-06-27,36,DPD90+,0,0,0
2024-06-27,38,Current,0,0,0
2024-06-27,38,DPD15-29,28,28,0
2024-06-27,38,DPD3-14,68,68,0
2024-06-27,38,DPD30-59,9,9,0
2024-06-27,38,DPD60-89,0,0,0
2024-06-27,38,DPD90+,0,0,0
2024-06-27,40,Current,0,0,0
2024-06-27,40,DPD15-29,14,14,0
2024-06-27,40,DPD3-14,32,32,0
2024-06-27,40,DPD30-59,4,4,0
2024-06-27,40,DPD60-89,0,0,0
2024-06-27,40,DPD90+,0,0,0
2024-06-27,42,Current,0,0,0
2024-06-27,42,DPD15-29,13,13,0
2024-06-27,42,DPD3-14,26,26,0
2024-06-27,42,DPD30-59,4,4,0
2024-06-27,42,DPD60-89,0,0,0
2024-06-27,42,DPD90+,0,0,0
2024-06-27,44,Current,0,0,0
2024-06-27,44,DPD15-29,22,22,0
2024-06-27,44,DPD3-14,64,64,0
2024-06-27,44,DPD30-59,5,5,0
2024-06-27,44,DPD60-89,0,0,0
2024-06-27,44,DPD90+,0,0,0
2024-06-27,46,Current,0,0,0
2024-06-27,46,DPD15-29,1,1,0
2024-06-27,48,Current,19,19,0
2024-06-27,48,DPD15-29,16,16,0
2024-06-27,48,DPD3-14,44,44,0
2024-06-27,48,DPD30-59,1,1,0
2024-06-27,48,DPD60-89,0,0,0
2024-06-27,48,DPD90+,0,0,0
2024-06-27,6,Current,0,0,0
2024-06-27,6,DPD90+,0,0,0
2024-06-26,100,Current,0,0,0
2024-06-26,100,DPD30-59,1,1,0
2024-06-26,102,Current,0,0,0
2024-06-26,102,DPD30-59,0,0,0
2024-06-26,102,DPD60-89,0,0,0
2024-06-26,104,Current,0,0,0
2024-06-26,104,DPD3-14,0,0,0
2024-06-26,104,DPD30-59,1,1,0
2024-06-26,20,Current,0,0,0
2024-06-26,20,DPD15-29,160,160,0
2024-06-26,20,DPD3-14,323,323,0
2024-06-26,20,DPD30-59,103,103,0
2024-06-26,20,DPD60-89,2,2,0
2024-06-26,20,DPD90+,0,0,0
2024-06-26,22,Current,0,0,0
2024-06-26,22,DPD15-29,0,0,0
2024-06-26,22,DPD3-14,1,1,0
2024-06-26,22,DPD30-59,0,0,0
2024-06-26,24,Current,49,49,0
2024-06-26,24,DPD15-29,77,77,0
2024-06-26,24,DPD3-14,179,179,0
2024-06-26,24,DPD30-59,52,52,0
2024-06-26,24,DPD60-89,0,0,0
2024-06-26,24,DPD90+,0,0,0
2024-06-26,26,Current,0,0,0
2024-06-26,26,DPD15-29,15,15,0
2024-06-26,26,DPD3-14,18,18,0
2024-06-26,26,DPD30-59,5,5,0
2024-06-26,26,DPD60-89,0,0,0
2024-06-26,26,DPD90+,0,0,0
2024-06-26,32,Current,0,0,0
2024-06-26,32,DPD15-29,60,60,0
2024-06-26,32,DPD3-14,159,159,0
2024-06-26,32,DPD30-59,64,64,0
2024-06-26,32,DPD60-89,0,0,0
2024-06-26,32,DPD90+,0,0,0
2024-06-26,34,Current,0,0,0
2024-06-26,34,DPD15-29,26,26,0
2024-06-26,34,DPD3-14,62,62,0
2024-06-26,34,DPD30-59,26,26,0
2024-06-26,34,DPD60-89,0,0,0
2024-06-26,34,DPD90+,0,0,0
2024-06-26,36,Current,0,0,0
2024-06-26,36,DPD15-29,24,24,0
2024-06-26,36,DPD3-14,49,49,0
2024-06-26,36,DPD30-59,10,10,0
2024-06-26,36,DPD60-89,0,0,0
2024-06-26,36,DPD90+,0,0,0
2024-06-26,38,Current,0,0,0
2024-06-26,38,DPD15-29,18,18,0
2024-06-26,38,DPD3-14,50,50,0
2024-06-26,38,DPD30-59,11,11,0
2024-06-26,38,DPD60-89,0,0,0
2024-06-26,38,DPD90+,0,0,0
2024-06-26,40,Current,0,0,0
2024-06-26,40,DPD15-29,19,19,0
2024-06-26,40,DPD3-14,31,31,0
2024-06-26,40,DPD30-59,1,1,0
2024-06-26,40,DPD60-89,0,0,0
2024-06-26,40,DPD90+,0,0,0
2024-06-26,42,Current,0,0,0
2024-06-26,42,DPD15-29,8,8,0
2024-06-26,42,DPD3-14,15,15,0
2024-06-26,42,DPD30-59,4,4,0
2024-06-26,42,DPD60-89,0,0,0
2024-06-26,42,DPD90+,0,0,0
2024-06-26,44,Current,0,0,0
2024-06-26,44,DPD15-29,15,15,0
2024-06-26,44,DPD3-14,47,47,0
2024-06-26,44,DPD30-59,13,13,0
2024-06-26,44,DPD60-89,0,0,0
2024-06-26,44,DPD90+,0,0,0
2024-06-26,46,Current,0,0,0
2024-06-26,46,DPD15-29,0,0,0
2024-06-26,48,Current,28,28,0
2024-06-26,48,DPD15-29,17,17,0
2024-06-26,48,DPD3-14,33,33,0
2024-06-26,48,DPD30-59,4,4,0
2024-06-26,48,DPD60-89,0,0,0
2024-06-26,48,DPD90+,0,0,0
2024-06-26,6,Current,0,0,0
2024-06-26,6,DPD90+,0,0,0
2024-06-25,100,Current,0,0,0
2024-06-25,100,DPD30-59,0,0,0
2024-06-25,102,Current,0,0,0
2024-06-25,102,DPD30-59,0,0,0
2024-06-25,102,DPD60-89,0,0,0
2024-06-25,104,Current,0,0,0
2024-06-25,104,DPD3-14,0,0,0
2024-06-25,104,DPD30-59,0,0,0
2024-06-25,20,Current,0,0,0
2024-06-25,20,DPD15-29,198,198,0
2024-06-25,20,DPD3-14,471,471,0
2024-06-25,20,DPD30-59,68,68,0
2024-06-25,20,DPD60-89,57,57,0
2024-06-25,20,DPD90+,20,20,0
2024-06-25,22,Current,0,0,0
2024-06-25,22,DPD15-29,1,1,0
2024-06-25,22,DPD3-14,1,1,0
2024-06-25,22,DPD30-59,1,1,0
2024-06-25,24,Current,25,25,0
2024-06-25,24,DPD15-29,104,104,0
2024-06-25,24,DPD3-14,252,252,0
2024-06-25,24,DPD30-59,33,33,0
2024-06-25,24,DPD60-89,0,0,0
2024-06-25,24,DPD90+,0,0,0
2024-06-25,26,Current,0,0,0
2024-06-25,26,DPD15-29,7,7,0
2024-06-25,26,DPD3-14,44,44,0
2024-06-25,26,DPD30-59,5,5,0
2024-06-25,26,DPD60-89,0,0,0
2024-06-25,26,DPD90+,0,0,0
2024-06-25,32,Current,0,0,0
2024-06-25,32,DPD15-29,107,107,0
2024-06-25,32,DPD3-14,229,229,0
2024-06-25,32,DPD30-59,40,40,0
2024-06-25,32,DPD60-89,0,0,0
2024-06-25,32,DPD90+,0,0,0
2024-06-25,34,Current,0,0,0
2024-06-25,34,DPD15-29,34,34,0
2024-06-25,34,DPD3-14,81,81,0
2024-06-25,34,DPD30-59,15,15,0
2024-06-25,34,DPD60-89,0,0,0
2024-06-25,34,DPD90+,0,0,0
2024-06-25,36,Current,0,0,0
2024-06-25,36,DPD15-29,28,28,0
2024-06-25,36,DPD3-14,68,68,0
2024-06-25,36,DPD30-59,15,15,0
2024-06-25,36,DPD60-89,0,0,0
2024-06-25,36,DPD90+,0,0,0
2024-06-25,38,Current,0,0,0
2024-06-25,38,DPD15-29,30,30,0
2024-06-25,38,DPD3-14,61,61,0
2024-06-25,38,DPD30-59,8,8,0
2024-06-25,38,DPD60-89,0,0,0
2024-06-25,38,DPD90+,0,0,0
2024-06-25,40,Current,0,0,0
2024-06-25,40,DPD15-29,19,19,0
2024-06-25,40,DPD3-14,46,46,0
2024-06-25,40,DPD30-59,4,4,0
2024-06-25,40,DPD60-89,0,0,0
2024-06-25,40,DPD90+,0,0,0
2024-06-25,42,Current,0,0,0
2024-06-25,42,DPD15-29,12,12,0
2024-06-25,42,DPD3-14,26,26,0
2024-06-25,42,DPD30-59,1,1,0
2024-06-25,42,DPD60-89,0,0,0
2024-06-25,42,DPD90+,0,0,0
2024-06-25,44,Current,0,0,0
2024-06-25,44,DPD15-29,25,25,0
2024-06-25,44,DPD3-14,67,67,0
2024-06-25,44,DPD30-59,10,10,0
2024-06-25,44,DPD60-89,0,0,0
2024-06-25,44,DPD90+,0,0,0
2024-06-25,46,Current,0,0,0
2024-06-25,46,DPD15-29,2,2,0
2024-06-25,48,Current,17,17,0
2024-06-25,48,DPD15-29,16,16,0
2024-06-25,48,DPD3-14,47,47,0
2024-06-25,48,DPD30-59,2,2,0
2024-06-25,48,DPD60-89,0,0,0
2024-06-25,48,DPD90+,0,0,0
2024-06-25,6,Current,0,0,0
2024-06-25,6,DPD90+,0,0,0
2024-06-24,100,Current,0,0,0
2024-06-24,100,DPD30-59,0,0,0
2024-06-24,102,Current,0,0,0
2024-06-24,102,DPD3-14,0,0,0
2024-06-24,102,DPD30-59,0,0,0
2024-06-24,102,DPD60-89,0,0,0
2024-06-24,104,Current,0,0,0
2024-06-24,104,DPD30-59,1,1,0
2024-06-24,20,Current,0,0,0
2024-06-24,20,DPD15-29,176,176,0
2024-06-24,20,DPD3-14,379,379,0
2024-06-24,20,DPD30-59,170,170,0
2024-06-24,20,DPD60-89,61,61,0
2024-06-24,20,DPD90+,60,60,0
2024-06-24,22,Current,0,0,0
2024-06-24,22,DPD15-29,0,0,0
2024-06-24,22,DPD3-14,0,0,0
2024-06-24,22,DPD30-59,0,0,0
2024-06-24,24,Current,39,39,0
2024-06-24,24,DPD15-29,85,85,0
2024-06-24,24,DPD3-14,230,230,0
2024-06-24,24,DPD30-59,99,99,0
2024-06-24,24,DPD60-89,0,0,0
2024-06-24,24,DPD90+,0,0,0
2024-06-24,26,Current,0,0,0
2024-06-24,26,DPD15-29,15,15,0
2024-06-24,26,DPD3-14,29,29,0
2024-06-24,26,DPD30-59,10,10,0
2024-06-24,26,DPD60-89,0,0,0
2024-06-24,26,DPD90+,0,0,0
2024-06-24,32,Current,0,0,0
2024-06-24,32,DPD15-29,80,80,0
2024-06-24,32,DPD3-14,170,170,0
2024-06-24,32,DPD30-59,86,86,0
2024-06-24,32,DPD60-89,0,0,0
2024-06-24,32,DPD90+,0,0,0
2024-06-24,34,Current,0,0,0
2024-06-24,34,DPD15-29,28,28,0
2024-06-24,34,DPD3-14,81,81,0
2024-06-24,34,DPD30-59,43,43,0
2024-06-24,34,DPD60-89,0,0,0
2024-06-24,34,DPD90+,0,0,0
2024-06-24,36,Current,0,0,0
2024-06-24,36,DPD15-29,25,25,0
2024-06-24,36,DPD3-14,60,60,0
2024-06-24,36,DPD30-59,30,30,0
2024-06-24,36,DPD60-89,0,0,0
2024-06-24,36,DPD90+,0,0,0
2024-06-24,38,Current,0,0,0
2024-06-24,38,DPD15-29,22,22,0
2024-06-24,38,DPD3-14,50,50,0
2024-06-24,38,DPD30-59,17,17,0
2024-06-24,38,DPD60-89,0,0,0
2024-06-24,38,DPD90+,0,0,0
2024-06-24,40,Current,0,0,0
2024-06-24,40,DPD15-29,18,18,0
2024-06-24,40,DPD3-14,41,41,0
2024-06-24,40,DPD30-59,12,12,0
2024-06-24,40,DPD60-89,0,0,0
2024-06-24,40,DPD90+,0,0,0
2024-06-24,42,Current,0,0,0
2024-06-24,42,DPD15-29,9,9,0
2024-06-24,42,DPD3-14,20,20,0
2024-06-24,42,DPD30-59,14,14,0
2024-06-24,42,DPD60-89,0,0,0
2024-06-24,42,DPD90+,0,0,0
2024-06-24,44,Current,0,0,0
2024-06-24,44,DPD15-29,27,27,0
2024-06-24,44,DPD3-14,58,58,0
2024-06-24,44,DPD30-59,23,23,0
2024-06-24,44,DPD60-89,0,0,0
2024-06-24,44,DPD90+,0,0,0
2024-06-24,46,Current,0,0,0
2024-06-24,46,DPD15-29,0,0,0
2024-06-24,48,Current,25,25,0
2024-06-24,48,DPD15-29,18,18,0
2024-06-24,48,DPD3-14,42,42,0
2024-06-24,48,DPD30-59,23,23,0
2024-06-24,48,DPD60-89,0,0,0
2024-06-24,48,DPD90+,0,0,0
2024-06-24,6,Current,0,0,0
2024-06-24,6,DPD90+,0,0,0
2024-06-23,100,Current,0,0,0
2024-06-23,100,DPD30-59,0,0,0
2024-06-23,102,Current,0,0,0
2024-06-23,102,DPD3-14,1,1,0
2024-06-23,102,DPD30-59,0,0,0
2024-06-23,102,DPD60-89,0,0,0
2024-06-23,104,Current,0,0,0
2024-06-23,104,DPD30-59,0,0,0
2024-06-23,20,Current,1,1,0
2024-06-23,20,DPD15-29,199,199,0
2024-06-23,20,DPD3-14,393,393,0
2024-06-23,20,DPD30-59,33,33,0
2024-06-23,20,DPD60-89,1,1,0
2024-06-23,20,DPD90+,0,0,0
2024-06-23,22,Current,0,0,0
2024-06-23,22,DPD15-29,1,1,0
2024-06-23,22,DPD3-14,1,1,0
2024-06-23,22,DPD30-59,0,0,0
2024-06-23,24,Current,41,41,0
2024-06-23,24,DPD15-29,104,104,0
2024-06-23,24,DPD3-14,219,219,0
2024-06-23,24,DPD30-59,19,19,0
2024-06-23,24,DPD60-89,0,0,0
2024-06-23,24,DPD90+,0,0,0
2024-06-23,26,Current,0,0,0
2024-06-23,26,DPD15-29,8,8,0
2024-06-23,26,DPD3-14,33,33,0
2024-06-23,26,DPD30-59,4,4,0
2024-06-23,26,DPD60-89,0,0,0
2024-06-23,26,DPD90+,0,0,0
2024-06-23,32,Current,0,0,0
2024-06-23,32,DPD15-29,97,97,0
2024-06-23,32,DPD3-14,207,207,0
2024-06-23,32,DPD30-59,16,16,0
2024-06-23,32,DPD60-89,0,0,0
2024-06-23,32,DPD90+,0,0,0
2024-06-23,34,Current,0,0,0
2024-06-23,34,DPD15-29,35,35,0
2024-06-23,34,DPD3-14,62,62,0
2024-06-23,34,DPD30-59,14,14,0
2024-06-23,34,DPD60-89,0,0,0
2024-06-23,34,DPD90+,0,0,0
2024-06-23,36,Current,0,0,0
2024-06-23,36,DPD15-29,27,27,0
2024-06-23,36,DPD3-14,55,55,0
2024-06-23,36,DPD30-59,5,5,0
2024-06-23,36,DPD60-89,0,0,0
2024-06-23,36,DPD90+,0,0,0
2024-06-23,38,Current,0,0,0
2024-06-23,38,DPD15-29,29,29,0
2024-06-23,38,DPD3-14,52,52,0
2024-06-23,38,DPD30-59,10,10,0
2024-06-23,38,DPD60-89,0,0,0
2024-06-23,38,DPD90+,0,0,0
2024-06-23,40,Current,0,0,0
2024-06-23,40,DPD15-29,16,16,0
2024-06-23,40,DPD3-14,41,41,0
2024-06-23,40,DPD30-59,1,1,0
2024-06-23,40,DPD60-89,0,0,0
2024-06-23,40,DPD90+,0,0,0
2024-06-23,42,Current,0,0,0
2024-06-23,42,DPD15-29,14,14,0
2024-06-23,42,DPD3-14,29,29,0
2024-06-23,42,DPD30-59,2,2,0
2024-06-23,42,DPD60-89,0,0,0
2024-06-23,42,DPD90+,0,0,0
2024-06-23,44,Current,0,0,0
2024-06-23,44,DPD15-29,24,24,0
2024-06-23,44,DPD3-14,61,61,0
2024-06-23,44,DPD30-59,4,4,0
2024-06-23,44,DPD60-89,0,0,0
2024-06-23,44,DPD90+,0,0,0
2024-06-23,46,Current,0,0,0
2024-06-23,46,DPD15-29,3,3,0
2024-06-23,48,Current,25,25,0
2024-06-23,48,DPD15-29,17,17,0
2024-06-23,48,DPD3-14,41,41,0
2024-06-23,48,DPD30-59,0,0,0
2024-06-23,48,DPD60-89,0,0,0
2024-06-23,48,DPD90+,0,0,0
2024-06-23,6,Current,0,0,0
2024-06-23,6,DPD90+,0,0,0
2024-06-22,100,Current,0,0,0
2024-06-22,100,DPD30-59,1,1,0
2024-06-22,102,Current,0,0,0
2024-06-22,102,DPD3-14,0,0,0
2024-06-22,102,DPD30-59,0,0,0
2024-06-22,102,DPD60-89,0,0,0
2024-06-22,104,Current,0,0,0
2024-06-22,104,DPD30-59,0,0,0
2024-06-22,20,Current,0,0,0
2024-06-22,20,DPD15-29,154,154,0
2024-06-22,20,DPD3-14,293,293,0
2024-06-22,20,DPD30-59,75,75,0
2024-06-22,20,DPD60-89,8,8,0
2024-06-22,20,DPD90+,11,11,0
2024-06-22,22,Current,0,0,0
2024-06-22,22,DPD15-29,0,0,0
2024-06-22,22,DPD3-14,0,0,0
2024-06-22,22,DPD30-59,0,0,0
2024-06-22,24,Current,20,20,0
2024-06-22,24,DPD15-29,80,80,0
2024-06-22,24,DPD3-14,188,188,0
2024-06-22,24,DPD30-59,42,42,0
2024-06-22,24,DPD60-89,0,0,0
2024-06-22,24,DPD90+,0,0,0
2024-06-22,26,Current,0,0,0
2024-06-22,26,DPD15-29,12,12,0
2024-06-22,26,DPD3-14,18,18,0
2024-06-22,26,DPD30-59,5,5,0
2024-06-22,26,DPD60-89,0,0,0
2024-06-22,26,DPD90+,0,0,0
2024-06-22,32,Current,0,0,0
2024-06-22,32,DPD15-29,72,72,0
2024-06-22,32,DPD3-14,122,122,0
2024-06-22,32,DPD30-59,42,42,0
2024-06-22,32,DPD60-89,0,0,0
2024-06-22,32,DPD90+,0,0,0
2024-06-22,34,Current,0,0,0
2024-06-22,34,DPD15-29,29,29,0
2024-06-22,34,DPD3-14,63,63,0
2024-06-22,34,DPD30-59,18,18,0
2024-06-22,34,DPD60-89,0,0,0
2024-06-22,34,DPD90+,0,0,0
2024-06-22,36,Current,0,0,0
2024-06-22,36,DPD15-29,19,19,0
2024-06-22,36,DPD3-14,39,39,0
2024-06-22,36,DPD30-59,10,10,0
2024-06-22,36,DPD60-89,0,0,0
2024-06-22,36,DPD90+,0,0,0
2024-06-22,38,Current,0,0,0
2024-06-22,38,DPD15-29,20,20,0
2024-06-22,38,DPD3-14,42,42,0
2024-06-22,38,DPD30-59,9,9,0
2024-06-22,38,DPD60-89,0,0,0
2024-06-22,38,DPD90+,0,0,0
2024-06-22,40,Current,0,0,0
2024-06-22,40,DPD15-29,12,12,0
2024-06-22,40,DPD3-14,38,38,0
2024-06-22,40,DPD30-59,0,0,0
2024-06-22,40,DPD60-89,0,0,0
2024-06-22,40,DPD90+,0,0,0
2024-06-22,42,Current,0,0,0
2024-06-22,42,DPD15-29,6,6,0
2024-06-22,42,DPD3-14,17,17,0
2024-06-22,42,DPD30-59,2,2,0
2024-06-22,42,DPD60-89,0,0,0
2024-06-22,42,DPD90+,0,0,0
2024-06-22,44,Current,0,0,0
2024-06-22,44,DPD15-29,25,25,0
2024-06-22,44,DPD3-14,50,50,0
2024-06-22,44,DPD30-59,4,4,0
2024-06-22,44,DPD60-89,0,0,0
2024-06-22,44,DPD90+,0,0,0
2024-06-22,46,Current,0,0,0
2024-06-22,46,DPD15-29,0,0,0
2024-06-22,48,Current,21,21,0
2024-06-22,48,DPD15-29,3,3,0
2024-06-22,48,DPD3-14,36,36,0
2024-06-22,48,DPD30-59,2,2,0
2024-06-22,48,DPD60-89,0,0,0
2024-06-22,48,DPD90+,0,0,0
2024-06-22,6,Current,0,0,0
2024-06-22,6,DPD90+,0,0,0
2024-06-21,100,Current,0,0,0
2024-06-21,100,DPD30-59,0,0,0
2024-06-21,102,Current,0,0,0
2024-06-21,102,DPD3-14,2,2,0
2024-06-21,102,DPD30-59,0,0,0
2024-06-21,102,DPD60-89,0,0,0
2024-06-21,104,Current,0,0,0
2024-06-21,104,DPD30-59,0,0,0
2024-06-21,20,Current,0,0,0
2024-06-21,20,DPD15-29,210,210,0
2024-06-21,20,DPD3-14,464,464,0
2024-06-21,20,DPD30-59,56,56,0
2024-06-21,20,DPD60-89,66,66,0
2024-06-21,20,DPD90+,63,63,0
2024-06-21,22,Current,0,0,0
2024-06-21,22,DPD15-29,1,1,0
2024-06-21,22,DPD30-59,2,2,0
2024-06-21,24,Current,63,63,0
2024-06-21,24,DPD15-29,106,106,0
2024-06-21,24,DPD3-14,254,254,0
2024-06-21,24,DPD30-59,33,33,0
2024-06-21,24,DPD60-89,0,0,0
2024-06-21,24,DPD90+,0,0,0
2024-06-21,26,Current,0,0,0
2024-06-21,26,DPD15-29,11,11,0
2024-06-21,26,DPD3-14,40,40,0
2024-06-21,26,DPD30-59,3,3,0
2024-06-21,26,DPD60-89,0,0,0
2024-06-21,26,DPD90+,0,0,0
2024-06-21,32,Current,0,0,0
2024-06-21,32,DPD15-29,93,93,0
2024-06-21,32,DPD3-14,217,217,0
2024-06-21,32,DPD30-59,35,35,0
2024-06-21,32,DPD60-89,0,0,0
2024-06-21,32,DPD90+,0,0,0
2024-06-21,34,Current,0,0,0
2024-06-21,34,DPD15-29,45,45,0
2024-06-21,34,DPD3-14,75,75,0
2024-06-21,34,DPD30-59,15,15,0
2024-06-21,34,DPD60-89,0,0,0
2024-06-21,34,DPD90+,0,0,0
2024-06-21,36,Current,0,0,0
2024-06-21,36,DPD15-29,25,25,0
2024-06-21,36,DPD3-14,60,60,0
2024-06-21,36,DPD30-59,11,11,0
2024-06-21,36,DPD60-89,0,0,0
2024-06-21,36,DPD90+,0,0,0
2024-06-21,38,Current,0,0,0
2024-06-21,38,DPD15-29,32,32,0
2024-06-21,38,DPD3-14,57,57,0
2024-06-21,38,DPD30-59,9,9,0
2024-06-21,38,DPD60-89,0,0,0
2024-06-21,38,DPD90+,0,0,0
2024-06-21,40,Current,0,0,0
2024-06-21,40,DPD15-29,13,13,0
2024-06-21,40,DPD3-14,45,45,0
2024-06-21,40,DPD30-59,4,4,0
2024-06-21,40,DPD60-89,0,0,0
2024-06-21,40,DPD90+,0,0,0
2024-06-21,42,Current,0,0,0
2024-06-21,42,DPD15-29,15,15,0
2024-06-21,42,DPD3-14,32,32,0
2024-06-21,42,DPD30-59,0,0,0
2024-06-21,42,DPD60-89,0,0,0
2024-06-21,42,DPD90+,0,0,0
2024-06-21,44,Current,0,0,0
2024-06-21,44,DPD15-29,22,22,0
2024-06-21,44,DPD3-14,56,56,0
2024-06-21,44,DPD30-59,5,5,0
2024-06-21,44,DPD60-89,0,0,0
2024-06-21,44,DPD90+,0,0,0
2024-06-21,46,Current,0,0,0
2024-06-21,46,DPD15-29,1,1,0
2024-06-21,46,DPD3-14,2,2,0
2024-06-21,48,Current,34,34,0
2024-06-21,48,DPD15-29,13,13,0
2024-06-21,48,DPD3-14,49,49,0
2024-06-21,48,DPD30-59,2,2,0
2024-06-21,48,DPD60-89,0,0,0
2024-06-21,48,DPD90+,0,0,0
2024-06-21,6,Current,0,0,0
2024-06-21,6,DPD90+,0,0,0
2024-06-20,100,Current,0,0,0
2024-06-20,100,DPD30-59,0,0,0
2024-06-20,102,Current,0,0,0
2024-06-20,102,DPD3-14,0,0,0
2024-06-20,102,DPD30-59,0,0,0
2024-06-20,102,DPD60-89,0,0,0
2024-06-20,104,Current,0,0,0
2024-06-20,104,DPD30-59,1,1,0
2024-06-20,20,Current,0,0,0
2024-06-20,20,DPD15-29,198,198,0
2024-06-20,20,DPD3-14,325,325,0
2024-06-20,20,DPD30-59,204,204,0
2024-06-20,20,DPD60-89,85,85,0
2024-06-20,20,DPD90+,49,49,0
2024-06-20,22,Current,0,0,0
2024-06-20,22,DPD15-29,0,0,0
2024-06-20,22,DPD30-59,0,0,0
2024-06-20,24,Current,53,53,0
2024-06-20,24,DPD15-29,88,88,0
2024-06-20,24,DPD3-14,199,199,0
2024-06-20,24,DPD30-59,104,104,0
2024-06-20,24,DPD60-89,0,0,0
2024-06-20,24,DPD90+,0,0,0
2024-06-20,26,Current,0,0,0
2024-06-20,26,DPD15-29,17,17,0
2024-06-20,26,DPD3-14,21,21,0
2024-06-20,26,DPD30-59,12,12,0
2024-06-20,26,DPD60-89,0,0,0
2024-06-20,26,DPD90+,0,0,0
2024-06-20,32,Current,0,0,0
2024-06-20,32,DPD15-29,98,98,0
2024-06-20,32,DPD3-14,134,134,0
2024-06-20,32,DPD30-59,107,107,0
2024-06-20,32,DPD60-89,0,0,0
2024-06-20,32,DPD90+,0,0,0
2024-06-20,34,Current,0,0,0
2024-06-20,34,DPD15-29,31,31,0
2024-06-20,34,DPD3-14,57,57,0
2024-06-20,34,DPD30-59,53,53,0
2024-06-20,34,DPD60-89,0,0,0
2024-06-20,34,DPD90+,0,0,0
2024-06-20,36,Current,0,0,0
2024-06-20,36,DPD15-29,24,24,0
2024-06-20,36,DPD3-14,40,40,0
2024-06-20,36,DPD30-59,45,45,0
2024-06-20,36,DPD60-89,0,0,0
2024-06-20,36,DPD90+,0,0,0
2024-06-20,38,Current,0,0,0
2024-06-20,38,DPD15-29,23,23,0
2024-06-20,38,DPD3-14,42,42,0
2024-06-20,38,DPD30-59,17,17,0
2024-06-20,38,DPD60-89,0,0,0
2024-06-20,38,DPD90+,0,0,0
2024-06-20,40,Current,0,0,0
2024-06-20,40,DPD15-29,11,11,0
2024-06-20,40,DPD3-14,34,34,0
2024-06-20,40,DPD30-59,15,15,0
2024-06-20,40,DPD60-89,0,0,0
2024-06-20,40,DPD90+,0,0,0
2024-06-20,42,Current,0,0,0
2024-06-20,42,DPD15-29,10,10,0
2024-06-20,42,DPD3-14,15,15,0
2024-06-20,42,DPD30-59,13,13,0
2024-06-20,42,DPD60-89,0,0,0
2024-06-20,42,DPD90+,0,0,0
2024-06-20,44,Current,0,0,0
2024-06-20,44,DPD15-29,25,25,0
2024-06-20,44,DPD3-14,43,43,0
2024-06-20,44,DPD30-59,30,30,0
2024-06-20,44,DPD60-89,0,0,0
2024-06-20,44,DPD90+,0,0,0
2024-06-20,46,Current,0,0,0
2024-06-20,46,DPD15-29,0,0,0
2024-06-20,46,DPD3-14,0,0,0
2024-06-20,48,Current,28,28,0
2024-06-20,48,DPD15-29,5,5,0
2024-06-20,48,DPD3-14,38,38,0
2024-06-20,48,DPD30-59,18,18,0
2024-06-20,48,DPD60-89,0,0,0
2024-06-20,48,DPD90+,0,0,0
2024-06-20,6,Current,0,0,0
2024-06-20,6,DPD90+,0,0,0
2024-06-19,100,Current,0,0,0
2024-06-19,100,DPD30-59,1,1,0
2024-06-19,102,Current,0,0,0
2024-06-19,102,DPD3-14,2,2,0
2024-06-19,102,DPD30-59,0,0,0
2024-06-19,102,DPD60-89,0,0,0
2024-06-19,104,Current,0,0,0
2024-06-19,104,DPD30-59,0,0,0
2024-06-19,20,Current,0,0,0
2024-06-19,20,DPD15-29,216,216,0
2024-06-19,20,DPD3-14,336,336,0
2024-06-19,20,DPD30-59,82,82,0
2024-06-19,20,DPD60-89,21,21,0
2024-06-19,20,DPD90+,42,42,0
2024-06-19,22,Current,0,0,0
2024-06-19,22,DPD15-29,3,3,0
2024-06-19,22,DPD30-59,0,0,0
2024-06-19,22,DPD60-89,0,0,0
2024-06-19,24,Current,124,124,0
2024-06-19,24,DPD15-29,106,106,0
2024-06-19,24,DPD3-14,189,189,0
2024-06-19,24,DPD30-59,35,35,0
2024-06-19,24,DPD60-89,0,0,0
2024-06-19,24,DPD90+,0,0,0
2024-06-19,26,Current,0,0,0
2024-06-19,26,DPD15-29,12,12,0
2024-06-19,26,DPD3-14,33,33,0
2024-06-19,26,DPD30-59,7,7,0
2024-06-19,26,DPD60-89,0,0,0
2024-06-19,26,DPD90+,0,0,0
2024-06-19,32,Current,0,0,0
2024-06-19,32,DPD15-29,106,106,0
2024-06-19,32,DPD3-14,136,136,0
2024-06-19,32,DPD30-59,37,37,0
2024-06-19,32,DPD60-89,0,0,0
2024-06-19,32,DPD90+,0,0,0
2024-06-19,34,Current,0,0,0
2024-06-19,34,DPD15-29,49,49,0
2024-06-19,34,DPD3-14,58,58,0
2024-06-19,34,DPD30-59,16,16,0
2024-06-19,34,DPD60-89,0,0,0
2024-06-19,34,DPD90+,0,0,0
2024-06-19,36,Current,0,0,0
2024-06-19,36,DPD15-29,26,26,0
2024-06-19,36,DPD3-14,46,46,0
2024-06-19,36,DPD30-59,9,9,0
2024-06-19,36,DPD60-89,0,0,0
2024-06-19,36,DPD90+,0,0,0
2024-06-19,38,Current,0,0,0
2024-06-19,38,DPD15-29,31,31,0
2024-06-19,38,DPD3-14,52,52,0
2024-06-19,38,DPD30-59,13,13,0
2024-06-19,38,DPD60-89,0,0,0
2024-06-19,38,DPD90+,0,0,0
2024-06-19,40,Current,0,0,0
2024-06-19,40,DPD15-29,11,11,0
2024-06-19,40,DPD3-14,37,37,0
2024-06-19,40,DPD30-59,2,2,0
2024-06-19,40,DPD60-89,0,0,0
2024-06-19,40,DPD90+,0,0,0
2024-06-19,42,Current,0,0,0
2024-06-19,42,DPD15-29,15,15,0
2024-06-19,42,DPD3-14,26,26,0
2024-06-19,42,DPD30-59,2,2,0
2024-06-19,42,DPD60-89,0,0,0
2024-06-19,42,DPD90+,0,0,0
2024-06-19,44,Current,0,0,0
2024-06-19,44,DPD15-29,25,25,0
2024-06-19,44,DPD3-14,41,41,0
2024-06-19,44,DPD30-59,9,9,0
2024-06-19,44,DPD60-89,0,0,0
2024-06-19,44,DPD90+,0,0,0
2024-06-19,46,Current,0,0,0
2024-06-19,46,DPD15-29,1,1,0
2024-06-19,46,DPD3-14,2,2,0
2024-06-19,48,Current,55,55,0
2024-06-19,48,DPD15-29,23,23,0
2024-06-19,48,DPD3-14,39,39,0
2024-06-19,48,DPD30-59,3,3,0
2024-06-19,48,DPD60-89,0,0,0
2024-06-19,48,DPD90+,0,0,0
2024-06-19,6,Current,0,0,0
2024-06-19,6,DPD90+,0,0,0
2024-06-18,100,Current,0,0,0
2024-06-18,100,DPD30-59,0,0,0
2024-06-18,102,Current,0,0,0
2024-06-18,102,DPD3-14,0,0,0
2024-06-18,102,DPD30-59,0,0,0
2024-06-18,102,DPD60-89,0,0,0
2024-06-18,104,Current,0,0,0
2024-06-18,104,DPD30-59,0,0,0
2024-06-18,20,Current,0,0,0
2024-06-18,20,DPD15-29,201,201,0
2024-06-18,20,DPD3-14,271,271,0
2024-06-18,20,DPD30-59,43,43,0
2024-06-18,20,DPD60-89,24,24,0
2024-06-18,20,DPD90+,9,9,0
2024-06-18,22,Current,0,0,0
2024-06-18,22,DPD15-29,0,0,0
2024-06-18,22,DPD30-59,0,0,0
2024-06-18,22,DPD60-89,0,0,0
2024-06-18,24,Current,50,50,0
2024-06-18,24,DPD15-29,95,95,0
2024-06-18,24,DPD3-14,153,153,0
2024-06-18,24,DPD30-59,28,28,0
2024-06-18,24,DPD60-89,0,0,0
2024-06-18,24,DPD90+,0,0,0
2024-06-18,26,Current,0,0,0
2024-06-18,26,DPD15-29,18,18,0
2024-06-18,26,DPD3-14,16,16,0
2024-06-18,26,DPD30-59,4,4,0
2024-06-18,26,DPD60-89,0,0,0
2024-06-18,26,DPD90+,0,0,0
2024-06-18,32,Current,0,0,0
2024-06-18,32,DPD15-29,103,103,0
2024-06-18,32,DPD3-14,90,90,0
2024-06-18,32,DPD30-59,26,26,0
2024-06-18,32,DPD60-89,0,0,0
2024-06-18,32,DPD90+,0,0,0
2024-06-18,34,Current,0,0,0
2024-06-18,34,DPD15-29,27,27,0
2024-06-18,34,DPD3-14,48,48,0
2024-06-18,34,DPD30-59,14,14,0
2024-06-18,34,DPD60-89,0,0,0
2024-06-18,34,DPD90+,0,0,0
2024-06-18,36,Current,0,0,0
2024-06-18,36,DPD15-29,25,25,0
2024-06-18,36,DPD3-14,31,31,0
2024-06-18,36,DPD30-59,7,7,0
2024-06-18,36,DPD60-89,0,0,0
2024-06-18,36,DPD90+,0,0,0
2024-06-18,38,Current,0,0,0
2024-06-18,38,DPD15-29,21,21,0
2024-06-18,38,DPD3-14,28,28,0
2024-06-18,38,DPD30-59,4,4,0
2024-06-18,38,DPD60-89,0,0,0
2024-06-18,38,DPD90+,0,0,0
2024-06-18,40,Current,0,0,0
2024-06-18,40,DPD15-29,13,13,0
2024-06-18,40,DPD3-14,32,32,0
2024-06-18,40,DPD30-59,4,4,0
2024-06-18,40,DPD60-89,0,0,0
2024-06-18,40,DPD90+,0,0,0
2024-06-18,42,Current,0,0,0
2024-06-18,42,DPD15-29,11,11,0
2024-06-18,42,DPD3-14,13,13,0
2024-06-18,42,DPD30-59,0,0,0
2024-06-18,42,DPD60-89,0,0,0
2024-06-18,42,DPD90+,0,0,0
2024-06-18,44,Current,0,0,0
2024-06-18,44,DPD15-29,29,29,0
2024-06-18,44,DPD3-14,32,32,0
2024-06-18,44,DPD30-59,6,6,0
2024-06-18,44,DPD60-89,0,0,0
2024-06-18,44,DPD90+,0,0,0
2024-06-18,46,Current,0,0,0
2024-06-18,46,DPD15-29,0,0,0
2024-06-18,46,DPD3-14,0,0,0
2024-06-18,48,Current,25,25,0
2024-06-18,48,DPD15-29,5,5,0
2024-06-18,48,DPD3-14,32,32,0
2024-06-18,48,DPD30-59,1,1,0
2024-06-18,48,DPD60-89,0,0,0
2024-06-18,48,DPD90+,0,0,0
2024-06-18,6,Current,0,0,0
2024-06-18,6,DPD90+,0,0,0
2024-06-17,100,Current,0,0,0
2024-06-17,100,DPD30-59,0,0,0
2024-06-17,102,Current,0,0,0
2024-06-17,102,DPD30-59,0,0,0
2024-06-17,102,DPD60-89,0,0,0
2024-06-17,104,Current,0,0,0
2024-06-17,104,DPD30-59,1,1,0
2024-06-17,20,Current,0,0,0
2024-06-17,20,DPD15-29,248,248,0
2024-06-17,20,DPD3-14,274,274,0
2024-06-17,20,DPD30-59,152,152,0
2024-06-17,20,DPD60-89,52,52,0
2024-06-17,20,DPD90+,3,3,0
2024-06-17,22,Current,0,0,0
2024-06-17,22,DPD15-29,4,4,0
2024-06-17,22,DPD30-59,0,0,0
2024-06-17,22,DPD60-89,0,0,0
2024-06-17,24,Current,61,61,0
2024-06-17,24,DPD15-29,121,121,0
2024-06-17,24,DPD3-14,176,176,0
2024-06-17,24,DPD30-59,76,76,0
2024-06-17,24,DPD60-89,0,0,0
2024-06-17,24,DPD90+,0,0,0
2024-06-17,26,Current,0,0,0
2024-06-17,26,DPD15-29,16,16,0
2024-06-17,26,DPD3-14,21,21,0
2024-06-17,26,DPD30-59,7,7,0
2024-06-17,26,DPD60-89,0,0,0
2024-06-17,26,DPD90+,0,0,0
2024-06-17,32,Current,0,0,0
2024-06-17,32,DPD15-29,120,120,0
2024-06-17,32,DPD3-14,105,105,0
2024-06-17,32,DPD30-59,74,74,0
2024-06-17,32,DPD60-89,0,0,0
2024-06-17,32,DPD90+,0,0,0
2024-06-17,34,Current,0,0,0
2024-06-17,34,DPD15-29,56,56,0
2024-06-17,34,DPD3-14,47,47,0
2024-06-17,34,DPD30-59,38,38,0
2024-06-17,34,DPD60-89,0,0,0
2024-06-17,34,DPD90+,0,0,0
2024-06-17,36,Current,0,0,0
2024-06-17,36,DPD15-29,34,34,0
2024-06-17,36,DPD3-14,30,30,0
2024-06-17,36,DPD30-59,28,28,0
2024-06-17,36,DPD60-89,0,0,0
2024-06-17,36,DPD90+,0,0,0
2024-06-17,38,Current,0,0,0
2024-06-17,38,DPD15-29,38,38,0
2024-06-17,38,DPD3-14,43,43,0
2024-06-17,38,DPD30-59,12,12,0
2024-06-17,38,DPD60-89,0,0,0
2024-06-17,38,DPD90+,0,0,0
2024-06-17,40,Current,0,0,0
2024-06-17,40,DPD15-29,14,14,0
2024-06-17,40,DPD3-14,31,31,0
2024-06-17,40,DPD30-59,14,14,0
2024-06-17,40,DPD60-89,0,0,0
2024-06-17,40,DPD90+,0,0,0
2024-06-17,42,Current,0,0,0
2024-06-17,42,DPD15-29,14,14,0
2024-06-17,42,DPD3-14,17,17,0
2024-06-17,42,DPD30-59,8,8,0
2024-06-17,42,DPD60-89,0,0,0
2024-06-17,42,DPD90+,0,0,0
2024-06-17,44,Current,0,0,0
2024-06-17,44,DPD15-29,29,29,0
2024-06-17,44,DPD3-14,35,35,0
2024-06-17,44,DPD30-59,20,20,0
2024-06-17,44,DPD60-89,0,0,0
2024-06-17,44,DPD90+,0,0,0
2024-06-17,46,Current,0,0,0
2024-06-17,46,DPD15-29,1,1,0
2024-06-17,46,DPD3-14,2,2,0
2024-06-17,48,Current,32,32,0
2024-06-17,48,DPD15-29,27,27,0
2024-06-17,48,DPD3-14,46,46,0
2024-06-17,48,DPD30-59,24,24,0
2024-06-17,48,DPD60-89,0,0,0
2024-06-17,48,DPD90+,0,0,0
2024-06-17,6,Current,0,0,0
2024-06-17,6,DPD90+,0,0,0
2024-06-16,100,Current,0,0,0
2024-06-16,100,DPD30-59,0,0,0
2024-06-16,102,Current,0,0,0
2024-06-16,102,DPD30-59,0,0,0
2024-06-16,102,DPD60-89,0,0,0
2024-06-16,104,Current,0,0,0
2024-06-16,104,DPD30-59,0,0,0
2024-06-16,104,DPD90+,0,0,0
2024-06-16,20,Current,0,0,0
2024-06-16,20,DPD15-29,178,178,0
2024-06-16,20,DPD3-14,265,265,0
2024-06-16,20,DPD30-59,139,139,0
2024-06-16,20,DPD60-89,41,41,0
2024-06-16,20,DPD90+,81,81,0
2024-06-16,22,Current,0,0,0
2024-06-16,22,DPD15-29,0,0,0
2024-06-16,22,DPD30-59,0,0,0
2024-06-16,22,DPD60-89,0,0,0
2024-06-16,22,DPD90+,0,0,0
2024-06-16,24,Current,115,115,0
2024-06-16,24,DPD15-29,94,94,0
2024-06-16,24,DPD3-14,151,151,0
2024-06-16,24,DPD30-59,69,69,0
2024-06-16,24,DPD60-89,0,0,0
2024-06-16,24,DPD90+,0,0,0
2024-06-16,26,Current,0,0,0
2024-06-16,26,DPD15-29,16,16,0
2024-06-16,26,DPD3-14,20,20,0
2024-06-16,26,DPD30-59,12,12,0
2024-06-16,26,DPD60-89,0,0,0
2024-06-16,26,DPD90+,0,0,0
2024-06-16,32,Current,0,0,0
2024-06-16,32,DPD15-29,95,95,0
2024-06-16,32,DPD3-14,92,92,0
2024-06-16,32,DPD30-59,71,71,0
2024-06-16,32,DPD60-89,0,0,0
2024-06-16,32,DPD90+,0,0,0
2024-06-16,34,Current,0,0,0
2024-06-16,34,DPD15-29,30,30,0
2024-06-16,34,DPD3-14,43,43,0
2024-06-16,34,DPD30-59,33,33,0
2024-06-16,34,DPD60-89,0,0,0
2024-06-16,34,DPD90+,0,0,0
2024-06-16,36,Current,0,0,0
2024-06-16,36,DPD15-29,21,21,0
2024-06-16,36,DPD3-14,29,29,0
2024-06-16,36,DPD30-59,34,34,0
2024-06-16,36,DPD60-89,0,0,0
2024-06-16,36,DPD90+,0,0,0
2024-06-16,38,Current,0,0,0
2024-06-16,38,DPD15-29,23,23,0
2024-06-16,38,DPD3-14,28,28,0
2024-06-16,38,DPD30-59,17,17,0
2024-06-16,38,DPD60-89,0,0,0
2024-06-16,38,DPD90+,0,0,0
2024-06-16,40,Current,0,0,0
2024-06-16,40,DPD15-29,13,13,0
2024-06-16,40,DPD3-14,28,28,0
2024-06-16,40,DPD30-59,3,3,0
2024-06-16,40,DPD60-89,0,0,0
2024-06-16,40,DPD90+,0,0,0
2024-06-16,42,Current,0,0,0
2024-06-16,42,DPD15-29,8,8,0
2024-06-16,42,DPD3-14,13,13,0
2024-06-16,42,DPD30-59,8,8,0
2024-06-16,42,DPD60-89,0,0,0
2024-06-16,42,DPD90+,0,0,0
2024-06-16,44,Current,0,0,0
2024-06-16,44,DPD15-29,23,23,0
2024-06-16,44,DPD3-14,37,37,0
2024-06-16,44,DPD30-59,20,20,0
2024-06-16,44,DPD60-89,0,0,0
2024-06-16,44,DPD90+,0,0,0
2024-06-16,46,Current,0,0,0
2024-06-16,46,DPD15-29,0,0,0
2024-06-16,46,DPD3-14,0,0,0
2024-06-16,48,Current,70,70,0
2024-06-16,48,DPD15-29,1,1,0
2024-06-16,48,DPD3-14,33,33,0
2024-06-16,48,DPD30-59,1,1,0
2024-06-16,48,DPD60-89,0,0,0
2024-06-16,48,DPD90+,0,0,0
2024-06-16,6,Current,0,0,0
2024-06-16,6,DPD90+,0,0,0
2024-06-15,100,Current,0,0,0
2024-06-15,100,DPD30-59,1,1,0
2024-06-15,102,Current,0,0,0
2024-06-15,102,DPD30-59,0,0,0
2024-06-15,102,DPD60-89,0,0,0
2024-06-15,104,Current,0,0,0
2024-06-15,104,DPD30-59,0,0,0
2024-06-15,104,DPD90+,0,0,0
2024-06-15,20,Current,4706,4706,0
2024-06-15,20,DPD15-29,259,259,0
2024-06-15,20,DPD3-14,350,350,0
2024-06-15,20,DPD30-59,109,109,0
2024-06-15,20,DPD60-89,40,40,0
2024-06-15,20,DPD90+,40,40,0
2024-06-15,22,Current,0,0,0
2024-06-15,22,DPD15-29,4,4,0
2024-06-15,22,DPD30-59,0,0,0
2024-06-15,22,DPD60-89,0,0,0
2024-06-15,22,DPD90+,0,0,0
2024-06-15,24,Current,4083,4083,0
2024-06-15,24,DPD15-29,117,117,0
2024-06-15,24,DPD3-14,214,214,0
2024-06-15,24,DPD30-59,42,42,0
2024-06-15,24,DPD60-89,11,11,0
2024-06-15,24,DPD90+,14,14,0
2024-06-15,26,Current,0,0,0
2024-06-15,26,DPD15-29,12,12,0
2024-06-15,26,DPD3-14,20,20,0
2024-06-15,26,DPD30-59,7,7,0
2024-06-15,26,DPD60-89,0,0,0
2024-06-15,26,DPD90+,0,0,0
2024-06-15,32,Current,247,247,0
2024-06-15,32,DPD15-29,112,112,0
2024-06-15,32,DPD3-14,117,117,0
2024-06-15,32,DPD30-59,36,36,0
2024-06-15,32,DPD60-89,4,4,0
2024-06-15,32,DPD90+,1,1,0
2024-06-15,34,Current,0,0,0
2024-06-15,34,DPD15-29,55,55,0
2024-06-15,34,DPD3-14,42,42,0
2024-06-15,34,DPD30-59,16,16,0
2024-06-15,34,DPD60-89,0,0,0
2024-06-15,34,DPD90+,0,0,0
2024-06-15,36,Current,257,257,0
2024-06-15,36,DPD15-29,38,38,0
2024-06-15,36,DPD3-14,28,28,0
2024-06-15,36,DPD30-59,8,8,0
2024-06-15,36,DPD60-89,3,3,0
2024-06-15,36,DPD90+,2,2,0
2024-06-15,38,Current,0,0,0
2024-06-15,38,DPD15-29,33,33,0
2024-06-15,38,DPD3-14,41,41,0
2024-06-15,38,DPD30-59,12,12,0
2024-06-15,38,DPD60-89,0,0,0
2024-06-15,38,DPD90+,0,0,0
2024-06-15,40,Current,282,282,0
2024-06-15,40,DPD15-29,14,14,0
2024-06-15,40,DPD3-14,31,31,0
2024-06-15,40,DPD30-59,4,4,0
2024-06-15,40,DPD60-89,2,2,0
2024-06-15,40,DPD90+,0,0,0
2024-06-15,42,Current,0,0,0
2024-06-15,42,DPD15-29,13,13,0
2024-06-15,42,DPD3-14,14,14,0
2024-06-15,42,DPD30-59,4,4,0
2024-06-15,42,DPD60-89,0,0,0
2024-06-15,42,DPD90+,0,0,0
2024-06-15,44,Current,173,173,0
2024-06-15,44,DPD15-29,27,27,0
2024-06-15,44,DPD3-14,35,35,0
2024-06-15,44,DPD30-59,13,13,0
2024-06-15,44,DPD60-89,1,1,0
2024-06-15,44,DPD90+,0,0,0
2024-06-15,46,Current,4,4,0
2024-06-15,46,DPD3-14,3,3,0
2024-06-15,48,Current,4347,4347,0
2024-06-15,48,DPD15-29,12,12,0
2024-06-15,48,DPD3-14,84,84,0
2024-06-15,48,DPD30-59,20,20,0
2024-06-15,48,DPD60-89,13,13,0
2024-06-15,48,DPD90+,11,11,0
2024-06-15,6,Current,0,0,0
2024-06-15,6,DPD90+,0,0,0
2024-06-14,100,Current,0,0,0
2024-06-14,100,DPD30-59,0,0,0
2024-06-14,102,Current,0,0,0
2024-06-14,102,DPD30-59,0,0,0
2024-06-14,102,DPD60-89,0,0,0
2024-06-14,104,Current,0,0,0
2024-06-14,104,DPD30-59,0,0,0
2024-06-14,104,DPD90+,0,0,0
2024-06-14,20,Current,0,0,0
2024-06-14,20,DPD15-29,239,239,0
2024-06-14,20,DPD3-14,248,248,0
2024-06-14,20,DPD30-59,28,28,0
2024-06-14,20,DPD60-89,37,37,0
2024-06-14,20,DPD90+,15,15,0
2024-06-14,22,Current,0,0,0
2024-06-14,22,DPD15-29,0,0,0
2024-06-14,22,DPD30-59,0,0,0
2024-06-14,22,DPD60-89,0,0,0
2024-06-14,22,DPD90+,0,0,0
2024-06-14,24,Current,102,102,0
2024-06-14,24,DPD15-29,137,137,0
2024-06-14,24,DPD3-14,128,128,0
2024-06-14,24,DPD30-59,11,11,0
2024-06-14,24,DPD60-89,0,0,0
2024-06-14,24,DPD90+,0,0,0
2024-06-14,26,Current,0,0,0
2024-06-14,26,DPD15-29,22,22,0
2024-06-14,26,DPD3-14,19,19,0
2024-06-14,26,DPD30-59,2,2,0
2024-06-14,26,DPD60-89,0,0,0
2024-06-14,26,DPD90+,0,0,0
2024-06-14,32,Current,0,0,0
2024-06-14,32,DPD15-29,137,137,0
2024-06-14,32,DPD3-14,81,81,0
2024-06-14,32,DPD30-59,9,9,0
2024-06-14,32,DPD60-89,0,0,0
2024-06-14,32,DPD90+,0,0,0
2024-06-14,34,Current,0,0,0
2024-06-14,34,DPD15-29,47,47,0
2024-06-14,34,DPD3-14,37,37,0
2024-06-14,34,DPD30-59,6,6,0
2024-06-14,34,DPD60-89,0,0,0
2024-06-14,34,DPD90+,0,0,0
2024-06-14,36,Current,0,0,0
2024-06-14,36,DPD15-29,33,33,0
2024-06-14,36,DPD3-14,27,27,0
2024-06-14,36,DPD30-59,3,3,0
2024-06-14,36,DPD60-89,0,0,0
2024-06-14,36,DPD90+,0,0,0
2024-06-14,38,Current,0,0,0
2024-06-14,38,DPD15-29,31,31,0
2024-06-14,38,DPD3-14,18,18,0
2024-06-14,38,DPD30-59,2,2,0
2024-06-14,38,DPD60-89,0,0,0
2024-06-14,38,DPD90+,0,0,0
2024-06-14,40,Current,0,0,0
2024-06-14,40,DPD15-29,18,18,0
2024-06-14,40,DPD3-14,26,26,0
2024-06-14,40,DPD30-59,3,3,0
2024-06-14,40,DPD60-89,0,0,0
2024-06-14,40,DPD90+,0,0,0
2024-06-14,42,Current,0,0,0
2024-06-14,42,DPD15-29,11,11,0
2024-06-14,42,DPD3-14,11,11,0
2024-06-14,42,DPD30-59,0,0,0
2024-06-14,42,DPD60-89,0,0,0
2024-06-14,42,DPD90+,0,0,0
2024-06-14,44,Current,0,0,0
2024-06-14,44,DPD15-29,36,36,0
2024-06-14,44,DPD3-14,33,33,0
2024-06-14,44,DPD30-59,2,2,0
2024-06-14,44,DPD60-89,0,0,0
2024-06-14,44,DPD90+,0,0,0
2024-06-14,46,Current,0,0,0
2024-06-14,46,DPD3-14,0,0,0
2024-06-14,48,Current,59,59,0
2024-06-14,48,DPD15-29,18,18,0
2024-06-14,48,DPD3-14,30,30,0
2024-06-14,48,DPD30-59,1,1,0
2024-06-14,48,DPD60-89,0,0,0
2024-06-14,48,DPD90+,0,0,0
2024-06-14,6,Current,0,0,0
2024-06-14,6,DPD90+,0,0,0
2024-06-13,100,Current,0,0,0
2024-06-13,100,DPD3-14,0,0,0
2024-06-13,100,DPD30-59,0,0,0
2024-06-13,102,Current,0,0,0
2024-06-13,102,DPD3-14,0,0,0
2024-06-13,102,DPD30-59,0,0,0
2024-06-13,102,DPD60-89,0,0,0
2024-06-13,104,Current,0,0,0
2024-06-13,104,DPD30-59,1,1,0
2024-06-13,104,DPD90+,0,0,0
2024-06-13,20,Current,0,0,0
2024-06-13,20,DPD15-29,277,277,0
2024-06-13,20,DPD3-14,260,260,0
2024-06-13,20,DPD30-59,199,199,0
2024-06-13,20,DPD60-89,54,54,0
2024-06-13,20,DPD90+,47,47,0
2024-06-13,22,Current,0,0,0
2024-06-13,22,DPD15-29,4,4,0
2024-06-13,22,DPD30-59,0,0,0
2024-06-13,22,DPD60-89,0,0,0
2024-06-13,22,DPD90+,0,0,0
2024-06-13,24,Current,33,33,0
2024-06-13,24,DPD15-29,137,137,0
2024-06-13,24,DPD3-14,161,161,0
2024-06-13,24,DPD30-59,88,88,0
2024-06-13,24,DPD60-89,0,0,0
2024-06-13,24,DPD90+,0,0,0
2024-06-13,26,Current,0,0,0
2024-06-13,26,DPD15-29,16,16,0
2024-06-13,26,DPD3-14,17,17,0
2024-06-13,26,DPD30-59,9,9,0
2024-06-13,26,DPD60-89,0,0,0
2024-06-13,26,DPD90+,0,0,0
2024-06-13,32,Current,0,0,0
2024-06-13,32,DPD15-29,138,138,0
2024-06-13,32,DPD3-14,112,112,0
2024-06-13,32,DPD30-59,92,92,0
2024-06-13,32,DPD60-89,0,0,0
2024-06-13,32,DPD90+,0,0,0
2024-06-13,34,Current,0,0,0
2024-06-13,34,DPD15-29,66,66,0
2024-06-13,34,DPD3-14,39,39,0
2024-06-13,34,DPD30-59,46,46,0
2024-06-13,34,DPD60-89,0,0,0
2024-06-13,34,DPD90+,0,0,0
2024-06-13,36,Current,0,0,0
2024-06-13,36,DPD15-29,43,43,0
2024-06-13,36,DPD3-14,25,25,0
2024-06-13,36,DPD30-59,35,35,0
2024-06-13,36,DPD60-89,0,0,0
2024-06-13,36,DPD90+,0,0,0
2024-06-13,38,Current,0,0,0
2024-06-13,38,DPD15-29,38,38,0
2024-06-13,38,DPD3-14,42,42,0
2024-06-13,38,DPD30-59,15,15,0
2024-06-13,38,DPD60-89,0,0,0
2024-06-13,38,DPD90+,0,0,0
2024-06-13,40,Current,0,0,0
2024-06-13,40,DPD15-29,15,15,0
2024-06-13,40,DPD3-14,26,26,0
2024-06-13,40,DPD30-59,7,7,0
2024-06-13,40,DPD60-89,0,0,0
2024-06-13,40,DPD90+,0,0,0
2024-06-13,42,Current,0,0,0
2024-06-13,42,DPD15-29,15,15,0
2024-06-13,42,DPD3-14,9,9,0
2024-06-13,42,DPD30-59,11,11,0
2024-06-13,42,DPD60-89,0,0,0
2024-06-13,42,DPD90+,0,0,0
2024-06-13,44,Current,0,0,0
2024-06-13,44,DPD15-29,31,31,0
2024-06-13,44,DPD3-14,35,35,0
2024-06-13,44,DPD30-59,27,27,0
2024-06-13,44,DPD60-89,0,0,0
2024-06-13,44,DPD90+,0,0,0
2024-06-13,46,Current,0,0,0
2024-06-13,46,DPD3-14,3,3,0
2024-06-13,48,Current,23,23,0
2024-06-13,48,DPD15-29,4,4,0
2024-06-13,48,DPD3-14,42,42,0
2024-06-13,48,DPD30-59,22,22,0
2024-06-13,48,DPD60-89,0,0,0
2024-06-13,48,DPD90+,0,0,0
2024-06-13,6,Current,0,0,0
2024-06-13,6,DPD90+,0,0,0
2024-06-12,100,Current,0,0,0
2024-06-12,100,DPD3-14,0,0,0
2024-06-12,100,DPD30-59,0,0,0
2024-06-12,102,Current,0,0,0
2024-06-12,102,DPD3-14,0,0,0
2024-06-12,102,DPD30-59,0,0,0
2024-06-12,102,DPD60-89,0,0,0
2024-06-12,104,Current,0,0,0
2024-06-12,104,DPD30-59,0,0,0
2024-06-12,104,DPD90+,0,0,0
2024-06-12,20,Current,0,0,0
2024-06-12,20,DPD15-29,272,272,0
2024-06-12,20,DPD3-14,208,208,0
2024-06-12,20,DPD30-59,124,124,0
2024-06-12,20,DPD60-89,52,52,0
2024-06-12,20,DPD90+,45,45,0
2024-06-12,22,Current,0,0,0
2024-06-12,22,DPD15-29,0,0,0
2024-06-12,22,DPD30-59,0,0,0
2024-06-12,22,DPD90+,0,0,0
2024-06-12,24,Current,28,28,0
2024-06-12,24,DPD15-29,145,145,0
2024-06-12,24,DPD3-14,108,108,0
2024-06-12,24,DPD30-59,52,52,0
2024-06-12,24,DPD60-89,0,0,0
2024-06-12,24,DPD90+,0,0,0
2024-06-12,26,Current,0,0,0
2024-06-12,26,DPD15-29,20,20,0
2024-06-12,26,DPD3-14,24,24,0
2024-06-12,26,DPD30-59,10,10,0
2024-06-12,26,DPD60-89,0,0,0
2024-06-12,26,DPD90+,0,0,0
2024-06-12,32,Current,0,0,0
2024-06-12,32,DPD15-29,159,159,0
2024-06-12,32,DPD3-14,72,72,0
2024-06-12,32,DPD30-59,58,58,0
2024-06-12,32,DPD60-89,0,0,0
2024-06-12,32,DPD90+,0,0,0
2024-06-12,34,Current,0,0,0
2024-06-12,34,DPD15-29,59,59,0
2024-06-12,34,DPD3-14,28,28,0
2024-06-12,34,DPD30-59,30,30,0
2024-06-12,34,DPD60-89,0,0,0
2024-06-12,34,DPD90+,0,0,0
2024-06-12,36,Current,0,0,0
2024-06-12,36,DPD15-29,41,41,0
2024-06-12,36,DPD3-14,23,23,0
2024-06-12,36,DPD30-59,29,29,0
2024-06-12,36,DPD60-89,0,0,0
2024-06-12,36,DPD90+,0,0,0
2024-06-12,38,Current,0,0,0
2024-06-12,38,DPD15-29,36,36,0
2024-06-12,38,DPD3-14,26,26,0
2024-06-12,38,DPD30-59,14,14,0
2024-06-12,38,DPD60-89,0,0,0
2024-06-12,38,DPD90+,0,0,0
2024-06-12,40,Current,0,0,0
2024-06-12,40,DPD15-29,17,17,0
2024-06-12,40,DPD3-14,17,17,0
2024-06-12,40,DPD30-59,2,2,0
2024-06-12,40,DPD60-89,0,0,0
2024-06-12,40,DPD90+,0,0,0
2024-06-12,42,Current,0,0,0
2024-06-12,42,DPD15-29,10,10,0
2024-06-12,42,DPD3-14,8,8,0
2024-06-12,42,DPD30-59,7,7,0
2024-06-12,42,DPD60-89,0,0,0
2024-06-12,42,DPD90+,0,0,0
2024-06-12,44,Current,0,0,0
2024-06-12,44,DPD15-29,38,38,0
2024-06-12,44,DPD3-14,32,32,0
2024-06-12,44,DPD30-59,15,15,0
2024-06-12,44,DPD60-89,0,0,0
2024-06-12,44,DPD90+,0,0,0
2024-06-12,46,Current,0,0,0
2024-06-12,46,DPD3-14,0,0,0
2024-06-12,48,Current,15,15,0
2024-06-12,48,DPD15-29,28,28,0
2024-06-12,48,DPD3-14,30,30,0
2024-06-12,48,DPD30-59,2,2,0
2024-06-12,48,DPD60-89,0,0,0
2024-06-12,48,DPD90+,0,0,0
2024-06-12,6,Current,0,0,0
2024-06-12,6,DPD90+,0,0,0
2024-06-11,100,Current,0,0,0
2024-06-11,100,DPD3-14,0,0,0
2024-06-11,100,DPD30-59,1,1,0
2024-06-11,102,Current,0,0,0
2024-06-11,102,DPD3-14,1,1,0
2024-06-11,102,DPD30-59,0,0,0
2024-06-11,102,DPD60-89,0,0,0
2024-06-11,104,Current,0,0,0
2024-06-11,104,DPD30-59,0,0,0
2024-06-11,104,DPD90+,0,0,0
2024-06-11,20,Current,0,0,0
2024-06-11,20,DPD15-29,210,210,0
2024-06-11,20,DPD3-14,345,345,0
2024-06-11,20,DPD30-59,35,35,0
2024-06-11,20,DPD60-89,38,38,0
2024-06-11,20,DPD90+,32,32,0
2024-06-11,22,Current,0,0,0
2024-06-11,22,DPD15-29,2,2,0
2024-06-11,22,DPD3-14,1,1,0
2024-06-11,22,DPD30-59,0,0,0
2024-06-11,22,DPD90+,0,0,0
2024-06-11,24,Current,22,22,0
2024-06-11,24,DPD15-29,107,107,0
2024-06-11,24,DPD3-14,202,202,0
2024-06-11,24,DPD30-59,16,16,0
2024-06-11,24,DPD60-89,0,0,0
2024-06-11,24,DPD90+,0,0,0
2024-06-11,26,Current,0,0,0
2024-06-11,26,DPD15-29,18,18,0
2024-06-11,26,DPD3-14,20,20,0
2024-06-11,26,DPD30-59,5,5,0
2024-06-11,26,DPD60-89,0,0,0
2024-06-11,26,DPD90+,0,0,0
2024-06-11,32,Current,0,0,0
2024-06-11,32,DPD15-29,104,104,0
2024-06-11,32,DPD3-14,139,139,0
2024-06-11,32,DPD30-59,14,14,0
2024-06-11,32,DPD60-89,0,0,0
2024-06-11,32,DPD90+,0,0,0
2024-06-11,34,Current,0,0,0
2024-06-11,34,DPD15-29,47,47,0
2024-06-11,34,DPD3-14,59,59,0
2024-06-11,34,DPD30-59,4,4,0
2024-06-11,34,DPD60-89,0,0,0
2024-06-11,34,DPD90+,0,0,0
2024-06-11,36,Current,0,0,0
2024-06-11,36,DPD15-29,29,29,0
2024-06-11,36,DPD3-14,44,44,0
2024-06-11,36,DPD30-59,3,3,0
2024-06-11,36,DPD60-89,0,0,0
2024-06-11,36,DPD90+,0,0,0
2024-06-11,38,Current,0,0,0
2024-06-11,38,DPD15-29,29,29,0
2024-06-11,38,DPD3-14,54,54,0
2024-06-11,38,DPD30-59,4,4,0
2024-06-11,38,DPD60-89,0,0,0
2024-06-11,38,DPD90+,0,0,0
2024-06-11,40,Current,0,0,0
2024-06-11,40,DPD15-29,17,17,0
2024-06-11,40,DPD3-14,26,26,0
2024-06-11,40,DPD30-59,6,6,0
2024-06-11,40,DPD60-89,0,0,0
2024-06-11,40,DPD90+,0,0,0
2024-06-11,42,Current,0,0,0
2024-06-11,42,DPD15-29,10,10,0
2024-06-11,42,DPD3-14,17,17,0
2024-06-11,42,DPD30-59,1,1,0
2024-06-11,42,DPD60-89,0,0,0
2024-06-11,42,DPD90+,0,0,0
2024-06-11,44,Current,0,0,0
2024-06-11,44,DPD15-29,23,23,0
2024-06-11,44,DPD3-14,48,48,0
2024-06-11,44,DPD30-59,5,5,0
2024-06-11,44,DPD60-89,0,0,0
2024-06-11,44,DPD90+,0,0,0
2024-06-11,46,Current,0,0,0
2024-06-11,46,DPD3-14,3,3,0
2024-06-11,48,Current,17,17,0
2024-06-11,48,DPD15-29,2,2,0
2024-06-11,48,DPD3-14,43,43,0
2024-06-11,48,DPD30-59,0,0,0
2024-06-11,48,DPD60-89,0,0,0
2024-06-11,48,DPD90+,0,0,0
2024-06-11,6,Current,0,0,0
2024-06-11,6,DPD90+,0,0,0
2024-06-10,100,Current,0,0,0
2024-06-10,100,DPD3-14,0,0,0
2024-06-10,100,DPD30-59,0,0,0
2024-06-10,102,Current,0,0,0
2024-06-10,102,DPD3-14,1,1,0
2024-06-10,102,DPD30-59,0,0,0
2024-06-10,102,DPD60-89,0,0,0
2024-06-10,104,Current,0,0,0
2024-06-10,104,DPD30-59,1,1,0
2024-06-10,104,DPD90+,0,0,0
2024-06-10,20,Current,0,0,0
2024-06-10,20,DPD15-29,243,243,0
2024-06-10,20,DPD3-14,257,257,0
2024-06-10,20,DPD30-59,124,124,0
2024-06-10,20,DPD60-89,32,32,0
2024-06-10,20,DPD90+,2,2,0
2024-06-10,22,Current,0,0,0
2024-06-10,22,DPD15-29,0,0,0
2024-06-10,22,DPD3-14,0,0,0
2024-06-10,22,DPD30-59,0,0,0
2024-06-10,22,DPD90+,0,0,0
2024-06-10,24,Current,41,41,0
2024-06-10,24,DPD15-29,138,138,0
2024-06-10,24,DPD3-14,124,124,0
2024-06-10,24,DPD30-59,41,41,0
2024-06-10,24,DPD60-89,0,0,0
2024-06-10,24,DPD90+,0,0,0
2024-06-10,26,Current,0,0,0
2024-06-10,26,DPD15-29,17,17,0
2024-06-10,26,DPD3-14,18,18,0
2024-06-10,26,DPD30-59,6,6,0
2024-06-10,26,DPD60-89,0,0,0
2024-06-10,26,DPD90+,0,0,0
2024-06-10,32,Current,0,0,0
2024-06-10,32,DPD15-29,141,141,0
2024-06-10,32,DPD3-14,98,98,0
2024-06-10,32,DPD30-59,46,46,0
2024-06-10,32,DPD60-89,0,0,0
2024-06-10,32,DPD90+,0,0,0
2024-06-10,34,Current,0,0,0
2024-06-10,34,DPD15-29,60,60,0
2024-06-10,34,DPD3-14,35,35,0
2024-06-10,34,DPD30-59,23,23,0
2024-06-10,34,DPD60-89,0,0,0
2024-06-10,34,DPD90+,0,0,0
2024-06-10,36,Current,0,0,0
2024-06-10,36,DPD15-29,40,40,0
2024-06-10,36,DPD3-14,26,26,0
2024-06-10,36,DPD30-59,23,23,0
2024-06-10,36,DPD60-89,0,0,0
2024-06-10,36,DPD90+,0,0,0
2024-06-10,38,Current,0,0,0
2024-06-10,38,DPD15-29,30,30,0
2024-06-10,38,DPD3-14,31,31,0
2024-06-10,38,DPD30-59,9,9,0
2024-06-10,38,DPD60-89,0,0,0
2024-06-10,38,DPD90+,0,0,0
2024-06-10,40,Current,0,0,0
2024-06-10,40,DPD15-29,17,17,0
2024-06-10,40,DPD3-14,19,19,0
2024-06-10,40,DPD30-59,3,3,0
2024-06-10,40,DPD60-89,0,0,0
2024-06-10,40,DPD90+,0,0,0
2024-06-10,42,Current,0,0,0
2024-06-10,42,DPD15-29,9,9,0
2024-06-10,42,DPD3-14,10,10,0
2024-06-10,42,DPD30-59,5,5,0
2024-06-10,42,DPD60-89,0,0,0
2024-06-10,42,DPD90+,0,0,0
2024-06-10,44,Current,0,0,0
2024-06-10,44,DPD15-29,34,34,0
2024-06-10,44,DPD3-14,30,30,0
2024-06-10,44,DPD30-59,16,16,0
2024-06-10,44,DPD60-89,0,0,0
2024-06-10,44,DPD90+,0,0,0
2024-06-10,46,Current,0,0,0
2024-06-10,46,DPD3-14,0,0,0
2024-06-10,48,Current,20,20,0
2024-06-10,48,DPD15-29,30,30,0
2024-06-10,48,DPD3-14,26,26,0
2024-06-10,48,DPD30-59,24,24,0
2024-06-10,48,DPD60-89,0,0,0
2024-06-10,48,DPD90+,0,0,0
2024-06-10,6,Current,0,0,0
2024-06-10,6,DPD90+,0,0,0
2024-06-09,100,Current,0,0,0
2024-06-09,100,DPD3-14,0,0,0
2024-06-09,100,DPD30-59,0,0,0
2024-06-09,102,Current,0,0,0
2024-06-09,102,DPD3-14,1,1,0
2024-06-09,102,DPD30-59,0,0,0
2024-06-09,102,DPD60-89,0,0,0
2024-06-09,104,Current,0,0,0
2024-06-09,104,DPD30-59,0,0,0
2024-06-09,104,DPD90+,0,0,0
2024-06-09,20,Current,0,0,0
2024-06-09,20,DPD15-29,203,203,0
2024-06-09,20,DPD3-14,346,346,0
2024-06-09,20,DPD30-59,86,86,0
2024-06-09,20,DPD60-89,13,13,0
2024-06-09,20,DPD90+,0,0,0
2024-06-09,22,Current,0,0,0
2024-06-09,22,DPD15-29,0,0,0
2024-06-09,22,DPD3-14,2,2,0
2024-06-09,22,DPD30-59,1,1,0
2024-06-09,22,DPD90+,0,0,0
2024-06-09,24,Current,88,88,0
2024-06-09,24,DPD15-29,107,107,0
2024-06-09,24,DPD3-14,197,197,0
2024-06-09,24,DPD30-59,53,53,0
2024-06-09,24,DPD60-89,0,0,0
2024-06-09,24,DPD90+,0,0,0
2024-06-09,26,Current,0,0,0
2024-06-09,26,DPD15-29,22,22,0
2024-06-09,26,DPD3-14,22,22,0
2024-06-09,26,DPD30-59,4,4,0
2024-06-09,26,DPD60-89,0,0,0
2024-06-09,26,DPD90+,0,0,0
2024-06-09,32,Current,0,0,0
2024-06-09,32,DPD15-29,103,103,0
2024-06-09,32,DPD3-14,136,136,0
2024-06-09,32,DPD30-59,62,62,0
2024-06-09,32,DPD60-89,0,0,0
2024-06-09,32,DPD90+,0,0,0
2024-06-09,34,Current,0,0,0
2024-06-09,34,DPD15-29,44,44,0
2024-06-09,34,DPD3-14,56,56,0
2024-06-09,34,DPD30-59,30,30,0
2024-06-09,34,DPD60-89,0,0,0
2024-06-09,34,DPD90+,0,0,0
2024-06-09,36,Current,0,0,0
2024-06-09,36,DPD15-29,29,29,0
2024-06-09,36,DPD3-14,46,46,0
2024-06-09,36,DPD30-59,14,14,0
2024-06-09,36,DPD60-89,0,0,0
2024-06-09,36,DPD90+,0,0,0
2024-06-09,38,Current,0,0,0
2024-06-09,38,DPD15-29,26,26,0
2024-06-09,38,DPD3-14,56,56,0
2024-06-09,38,DPD30-59,10,10,0
2024-06-09,38,DPD60-89,0,0,0
2024-06-09,38,DPD90+,0,0,0
2024-06-09,40,Current,0,0,0
2024-06-09,40,DPD15-29,13,13,0
2024-06-09,40,DPD3-14,25,25,0
2024-06-09,40,DPD30-59,9,9,0
2024-06-09,40,DPD60-89,0,0,0
2024-06-09,40,DPD90+,0,0,0
2024-06-09,42,Current,0,0,0
2024-06-09,42,DPD15-29,9,9,0
2024-06-09,42,DPD3-14,14,14,0
2024-06-09,42,DPD30-59,5,5,0
2024-06-09,42,DPD60-89,0,0,0
2024-06-09,42,DPD90+,0,0,0
2024-06-09,44,Current,0,0,0
2024-06-09,44,DPD15-29,24,24,0
2024-06-09,44,DPD3-14,40,40,0
2024-06-09,44,DPD30-59,13,13,0
2024-06-09,44,DPD60-89,0,0,0
2024-06-09,44,DPD90+,0,0,0
2024-06-09,46,Current,0,0,0
2024-06-09,46,DPD3-14,1,1,0
2024-06-09,48,Current,46,46,0
2024-06-09,48,DPD15-29,2,2,0
2024-06-09,48,DPD3-14,31,31,0
2024-06-09,48,DPD30-59,1,1,0
2024-06-09,48,DPD60-89,0,0,0
2024-06-09,48,DPD90+,0,0,0
2024-06-09,6,Current,0,0,0
2024-06-09,6,DPD90+,0,0,0
2024-06-08,100,Current,0,0,0
2024-06-08,100,DPD3-14,0,0,0
2024-06-08,100,DPD30-59,0,0,0
2024-06-08,102,Current,0,0,0
2024-06-08,102,DPD3-14,0,0,0
2024-06-08,102,DPD30-59,0,0,0
2024-06-08,102,DPD60-89,0,0,0
2024-06-08,104,Current,0,0,0
2024-06-08,104,DPD30-59,0,0,0
2024-06-08,104,DPD90+,0,0,0
2024-06-08,20,Current,0,0,0
2024-06-08,20,DPD15-29,228,228,0
2024-06-08,20,DPD3-14,239,239,0
2024-06-08,20,DPD30-59,129,129,0
2024-06-08,20,DPD60-89,54,54,0
2024-06-08,20,DPD90+,86,86,0
2024-06-08,22,Current,0,0,0
2024-06-08,22,DPD15-29,0,0,0
2024-06-08,22,DPD3-14,0,0,0
2024-06-08,22,DPD30-59,0,0,0
2024-06-08,22,DPD90+,0,0,0
2024-06-08,24,Current,47,47,0
2024-06-08,24,DPD15-29,130,130,0
2024-06-08,24,DPD3-14,111,111,0
2024-06-08,24,DPD30-59,57,57,0
2024-06-08,24,DPD60-89,0,0,0
2024-06-08,24,DPD90+,0,0,0
2024-06-08,26,Current,0,0,0
2024-06-08,26,DPD15-29,15,15,0
2024-06-08,26,DPD3-14,17,17,0
2024-06-08,26,DPD30-59,9,9,0
2024-06-08,26,DPD60-89,0,0,0
2024-06-08,26,DPD90+,0,0,0
2024-06-08,32,Current,0,0,0
2024-06-08,32,DPD15-29,130,130,0
2024-06-08,32,DPD3-14,108,108,0
2024-06-08,32,DPD30-59,58,58,0
2024-06-08,32,DPD60-89,0,0,0
2024-06-08,32,DPD90+,0,0,0
2024-06-08,34,Current,0,0,0
2024-06-08,34,DPD15-29,50,50,0
2024-06-08,34,DPD3-14,41,41,0
2024-06-08,34,DPD30-59,27,27,0
2024-06-08,34,DPD60-89,0,0,0
2024-06-08,34,DPD90+,0,0,0
2024-06-08,36,Current,0,0,0
2024-06-08,36,DPD15-29,35,35,0
2024-06-08,36,DPD3-14,28,28,0
2024-06-08,36,DPD30-59,26,26,0
2024-06-08,36,DPD60-89,0,0,0
2024-06-08,36,DPD90+,0,0,0
2024-06-08,38,Current,0,0,0
2024-06-08,38,DPD15-29,28,28,0
2024-06-08,38,DPD3-14,30,30,0
2024-06-08,38,DPD30-59,15,15,0
2024-06-08,38,DPD60-89,0,0,0
2024-06-08,38,DPD90+,0,0,0
2024-06-08,40,Current,0,0,0
2024-06-08,40,DPD15-29,13,13,0
2024-06-08,40,DPD3-14,20,20,0
2024-06-08,40,DPD30-59,2,2,0
2024-06-08,40,DPD60-89,0,0,0
2024-06-08,40,DPD90+,0,0,0
2024-06-08,42,Current,0,0,0
2024-06-08,42,DPD15-29,7,7,0
2024-06-08,42,DPD3-14,9,9,0
2024-06-08,42,DPD30-59,6,6,0
2024-06-08,42,DPD60-89,0,0,0
2024-06-08,42,DPD90+,0,0,0
2024-06-08,44,Current,0,0,0
2024-06-08,44,DPD15-29,28,28,0
2024-06-08,44,DPD3-14,30,30,0
2024-06-08,44,DPD30-59,15,15,0
2024-06-08,44,DPD60-89,0,0,0
2024-06-08,44,DPD90+,0,0,0
2024-06-08,46,Current,0,0,0
2024-06-08,46,DPD3-14,0,0,0
2024-06-08,48,Current,23,23,0
2024-06-08,48,DPD15-29,1,1,0
2024-06-08,48,DPD3-14,9,9,0
2024-06-08,48,DPD30-59,2,2,0
2024-06-08,48,DPD60-89,0,0,0
2024-06-08,48,DPD90+,0,0,0
2024-06-08,6,Current,0,0,0
2024-06-08,6,DPD90+,0,0,0
2024-06-07,100,Current,0,0,0
2024-06-07,100,DPD3-14,0,0,0
2024-06-07,100,DPD30-59,1,1,0
2024-06-07,102,Current,0,0,0
2024-06-07,102,DPD3-14,1,1,0
2024-06-07,102,DPD30-59,0,0,0
2024-06-07,102,DPD60-89,0,0,0
2024-06-07,104,Current,0,0,0
2024-06-07,104,DPD15-29,0,0,0
2024-06-07,104,DPD30-59,0,0,0
2024-06-07,104,DPD90+,0,0,0
2024-06-07,20,Current,0,0,0
2024-06-07,20,DPD15-29,214,214,0
2024-06-07,20,DPD3-14,339,339,0
2024-06-07,20,DPD30-59,24,24,0
2024-06-07,20,DPD60-89,10,10,0
2024-06-07,20,DPD90+,2,2,0
2024-06-07,22,Current,0,0,0
2024-06-07,22,DPD15-29,0,0,0
2024-06-07,22,DPD3-14,2,2,0
2024-06-07,22,DPD30-59,0,0,0
2024-06-07,22,DPD90+,0,0,0
2024-06-07,24,Current,86,86,0
2024-06-07,24,DPD15-29,115,115,0
2024-06-07,24,DPD3-14,189,189,0
2024-06-07,24,DPD30-59,8,8,0
2024-06-07,24,DPD60-89,0,0,0
2024-06-07,24,DPD90+,0,0,0
2024-06-07,26,Current,0,0,0
2024-06-07,26,DPD15-29,20,20,0
2024-06-07,26,DPD3-14,28,28,0
2024-06-07,26,DPD30-59,3,3,0
2024-06-07,26,DPD60-89,0,0,0
2024-06-07,26,DPD90+,0,0,0
2024-06-07,32,Current,0,0,0
2024-06-07,32,DPD15-29,109,109,0
2024-06-07,32,DPD3-14,148,148,0
2024-06-07,32,DPD30-59,8,8,0
2024-06-07,32,DPD60-89,0,0,0
2024-06-07,32,DPD90+,0,0,0
2024-06-07,34,Current,0,0,0
2024-06-07,34,DPD15-29,48,48,0
2024-06-07,34,DPD3-14,53,53,0
2024-06-07,34,DPD30-59,2,2,0
2024-06-07,34,DPD60-89,0,0,0
2024-06-07,34,DPD90+,0,0,0
2024-06-07,36,Current,0,0,0
2024-06-07,36,DPD15-29,34,34,0
2024-06-07,36,DPD3-14,43,43,0
2024-06-07,36,DPD30-59,2,2,0
2024-06-07,36,DPD60-89,0,0,0
2024-06-07,36,DPD90+,0,0,0
2024-06-07,38,Current,0,0,0
2024-06-07,38,DPD15-29,29,29,0
2024-06-07,38,DPD3-14,58,58,0
2024-06-07,38,DPD30-59,3,3,0
2024-06-07,38,DPD60-89,0,0,0
2024-06-07,38,DPD90+,0,0,0
2024-06-07,40,Current,0,0,0
2024-06-07,40,DPD15-29,13,13,0
2024-06-07,40,DPD3-14,27,27,0
2024-06-07,40,DPD30-59,4,4,0
2024-06-07,40,DPD60-89,0,0,0
2024-06-07,40,DPD90+,0,0,0
2024-06-07,42,Current,0,0,0
2024-06-07,42,DPD15-29,7,7,0
2024-06-07,42,DPD3-14,18,18,0
2024-06-07,42,DPD30-59,0,0,0
2024-06-07,42,DPD60-89,0,0,0
2024-06-07,42,DPD90+,0,0,0
2024-06-07,44,Current,0,0,0
2024-06-07,44,DPD15-29,29,29,0
2024-06-07,44,DPD3-14,40,40,0
2024-06-07,44,DPD30-59,2,2,0
2024-06-07,44,DPD60-89,0,0,0
2024-06-07,44,DPD90+,0,0,0
2024-06-07,46,Current,0,0,0
2024-06-07,46,DPD3-14,1,1,0
2024-06-07,48,Current,54,54,0
2024-06-07,48,DPD15-29,20,20,0
2024-06-07,48,DPD3-14,33,33,0
2024-06-07,48,DPD30-59,0,0,0
2024-06-07,48,DPD60-89,0,0,0
2024-06-07,48,DPD90+,0,0,0
2024-06-07,6,Current,0,0,0
2024-06-07,6,DPD90+,0,0,0
2024-06-06,100,Current,0,0,0
2024-06-06,100,DPD3-14,0,0,0
2024-06-06,100,DPD30-59,0,0,0
2024-06-06,102,Current,0,0,0
2024-06-06,102,DPD3-14,0,0,0
2024-06-06,102,DPD30-59,1,1,0
2024-06-06,104,Current,0,0,0
2024-06-06,104,DPD30-59,0,0,0
2024-06-06,104,DPD90+,0,0,0
2024-06-06,20,Current,1,1,0
2024-06-06,20,DPD15-29,249,249,0
2024-06-06,20,DPD3-14,264,264,0
2024-06-06,20,DPD30-59,119,119,0
2024-06-06,20,DPD60-89,39,39,0
2024-06-06,20,DPD90+,12,12,0
2024-06-06,22,Current,0,0,0
2024-06-06,22,DPD15-29,0,0,0
2024-06-06,22,DPD3-14,0,0,0
2024-06-06,22,DPD30-59,0,0,0
2024-06-06,22,DPD90+,0,0,0
2024-06-06,24,Current,23,23,0
2024-06-06,24,DPD15-29,130,130,0
2024-06-06,24,DPD3-14,140,140,0
2024-06-06,24,DPD30-59,39,39,0
2024-06-06,24,DPD60-89,0,0,0
2024-06-06,24,DPD90+,0,0,0
2024-06-06,26,Current,0,0,0
2024-06-06,26,DPD15-29,15,15,0
2024-06-06,26,DPD3-14,20,20,0
2024-06-06,26,DPD30-59,7,7,0
2024-06-06,26,DPD60-89,0,0,0
2024-06-06,26,DPD90+,0,0,0
2024-06-06,32,Current,0,0,0
2024-06-06,32,DPD15-29,134,134,0
2024-06-06,32,DPD3-14,123,123,0
2024-06-06,32,DPD30-59,41,41,0
2024-06-06,32,DPD60-89,0,0,0
2024-06-06,32,DPD90+,0,0,0
2024-06-06,34,Current,0,0,0
2024-06-06,34,DPD15-29,52,52,0
2024-06-06,34,DPD3-14,43,43,0
2024-06-06,34,DPD30-59,23,23,0
2024-06-06,34,DPD60-89,0,0,0
2024-06-06,34,DPD90+,0,0,0
2024-06-06,36,Current,0,0,0
2024-06-06,36,DPD15-29,37,37,0
2024-06-06,36,DPD3-14,31,31,0
2024-06-06,36,DPD30-59,22,22,0
2024-06-06,36,DPD60-89,0,0,0
2024-06-06,36,DPD90+,0,0,0
2024-06-06,38,Current,0,0,0
2024-06-06,38,DPD15-29,29,29,0
2024-06-06,38,DPD3-14,35,35,0
2024-06-06,38,DPD30-59,8,8,0
2024-06-06,38,DPD60-89,0,0,0
2024-06-06,38,DPD90+,0,0,0
2024-06-06,40,Current,0,0,0
2024-06-06,40,DPD15-29,16,16,0
2024-06-06,40,DPD3-14,23,23,0
2024-06-06,40,DPD30-59,0,0,0
2024-06-06,40,DPD60-89,0,0,0
2024-06-06,40,DPD90+,0,0,0
2024-06-06,42,Current,0,0,0
2024-06-06,42,DPD15-29,8,8,0
2024-06-06,42,DPD3-14,12,12,0
2024-06-06,42,DPD30-59,4,4,0
2024-06-06,42,DPD60-89,0,0,0
2024-06-06,42,DPD90+,0,0,0
2024-06-06,44,Current,0,0,0
2024-06-06,44,DPD15-29,35,35,0
2024-06-06,44,DPD3-14,42,42,0
2024-06-06,44,DPD30-59,15,15,0
2024-06-06,44,DPD60-89,0,0,0
2024-06-06,44,DPD90+,0,0,0
2024-06-06,46,Current,0,0,0
2024-06-06,46,DPD3-14,0,0,0
2024-06-06,48,Current,11,11,0
2024-06-06,48,DPD15-29,14,14,0
2024-06-06,48,DPD3-14,17,17,0
2024-06-06,48,DPD30-59,9,9,0
2024-06-06,48,DPD60-89,0,0,0
2024-06-06,48,DPD90+,0,0,0
2024-06-06,6,Current,0,0,0
2024-06-06,6,DPD90+,0,0,0
2024-06-05,100,Current,0,0,0
2024-06-05,102,Current,0,0,0
2024-06-05,102,DPD3-14,1,1,0
2024-06-05,102,DPD30-59,0,0,0
2024-06-05,104,Current,0,0,0
2024-06-05,104,DPD3-14,0,0,0
2024-06-05,104,DPD30-59,0,0,0
2024-06-05,104,DPD90+,0,0,0
2024-06-05,20,Current,0,0,0
2024-06-05,20,DPD15-29,205,205,0
2024-06-05,20,DPD3-14,364,364,0
2024-06-05,20,DPD30-59,108,108,0
2024-06-05,20,DPD60-89,50,50,0
2024-06-05,20,DPD90+,49,49,0
2024-06-05,22,Current,0,0,0
2024-06-05,22,DPD15-29,0,0,0
2024-06-05,22,DPD3-14,3,3,0
2024-06-05,22,DPD30-59,1,1,0
2024-06-05,22,DPD90+,0,0,0
2024-06-05,24,Current,22,22,0
2024-06-05,24,DPD15-29,115,115,0
2024-06-05,24,DPD3-14,182,182,0
2024-06-05,24,DPD30-59,61,61,0
2024-06-05,24,DPD60-89,0,0,0
2024-06-05,24,DPD90+,0,0,0
2024-06-05,26,Current,0,0,0
2024-06-05,26,DPD15-29,22,22,0
2024-06-05,26,DPD3-14,36,36,0
2024-06-05,26,DPD30-59,4,4,0
2024-06-05,26,DPD60-89,0,0,0
2024-06-05,26,DPD90+,0,0,0
2024-06-05,32,Current,0,0,0
2024-06-05,32,DPD15-29,119,119,0
2024-06-05,32,DPD3-14,161,161,0
2024-06-05,32,DPD30-59,67,67,0
2024-06-05,32,DPD60-89,0,0,0
2024-06-05,32,DPD90+,0,0,0
2024-06-05,34,Current,0,0,0
2024-06-05,34,DPD15-29,46,46,0
2024-06-05,34,DPD3-14,60,60,0
2024-06-05,34,DPD30-59,34,34,0
2024-06-05,34,DPD60-89,0,0,0
2024-06-05,34,DPD90+,0,0,0
2024-06-05,36,Current,0,0,0
2024-06-05,36,DPD15-29,40,40,0
2024-06-05,36,DPD3-14,47,47,0
2024-06-05,36,DPD30-59,16,16,0
2024-06-05,36,DPD60-89,0,0,0
2024-06-05,36,DPD90+,0,0,0
2024-06-05,38,Current,0,0,0
2024-06-05,38,DPD15-29,28,28,0
2024-06-05,38,DPD3-14,63,63,0
2024-06-05,38,DPD30-59,11,11,0
2024-06-05,38,DPD60-89,0,0,0
2024-06-05,38,DPD90+,0,0,0
2024-06-05,40,Current,0,0,0
2024-06-05,40,DPD15-29,13,13,0
2024-06-05,40,DPD3-14,34,34,0
2024-06-05,40,DPD30-59,12,12,0
2024-06-05,40,DPD60-89,0,0,0
2024-06-05,40,DPD90+,0,0,0
2024-06-05,42,Current,0,0,0
2024-06-05,42,DPD15-29,8,8,0
2024-06-05,42,DPD3-14,19,19,0
2024-06-05,42,DPD30-59,5,5,0
2024-06-05,42,DPD60-89,0,0,0
2024-06-05,42,DPD90+,0,0,0
2024-06-05,44,Current,0,0,0
2024-06-05,44,DPD15-29,30,30,0
2024-06-05,44,DPD3-14,51,51,0
2024-06-05,44,DPD30-59,15,15,0
2024-06-05,44,DPD60-89,0,0,0
2024-06-05,44,DPD90+,0,0,0
2024-06-05,46,Current,0,0,0
2024-06-05,46,DPD3-14,1,1,0
2024-06-05,48,Current,12,12,0
2024-06-05,48,DPD15-29,17,17,0
2024-06-05,48,DPD3-14,35,35,0
2024-06-05,48,DPD30-59,4,4,0
2024-06-05,48,DPD60-89,0,0,0
2024-06-05,48,DPD90+,0,0,0
2024-06-05,6,Current,0,0,0
2024-06-05,6,DPD60-89,0,0,0
2024-06-05,6,DPD90+,0,0,0
2024-06-04,100,Current,0,0,0
2024-06-04,100,DPD30-59,0,0,0
2024-06-04,102,Current,0,0,0
2024-06-04,102,DPD15-29,0,0,0
2024-06-04,102,DPD3-14,0,0,0
2024-06-04,102,DPD30-59,0,0,0
2024-06-04,104,Current,0,0,0
2024-06-04,104,DPD15-29,0,0,0
2024-06-04,104,DPD3-14,0,0,0
2024-06-04,104,DPD90+,0,0,0
2024-06-04,20,Current,0,0,0
2024-06-04,20,DPD15-29,236,236,0
2024-06-04,20,DPD3-14,255,255,0
2024-06-04,20,DPD30-59,149,149,0
2024-06-04,20,DPD60-89,49,49,0
2024-06-04,20,DPD90+,52,52,0
2024-06-04,22,Current,0,0,0
2024-06-04,22,DPD3-14,0,0,0
2024-06-04,22,DPD30-59,0,0,0
2024-06-04,22,DPD90+,0,0,0
2024-06-04,24,Current,29,29,0
2024-06-04,24,DPD15-29,138,138,0
2024-06-04,24,DPD3-14,139,139,0
2024-06-04,24,DPD30-59,71,71,0
2024-06-04,24,DPD60-89,0,0,0
2024-06-04,24,DPD90+,0,0,0
2024-06-04,26,Current,0,0,0
2024-06-04,26,DPD15-29,14,14,0
2024-06-04,26,DPD3-14,24,24,0
2024-06-04,26,DPD30-59,10,10,0
2024-06-04,26,DPD60-89,0,0,0
2024-06-04,26,DPD90+,0,0,0
2024-06-04,32,Current,0,0,0
2024-06-04,32,DPD15-29,134,134,0
2024-06-04,32,DPD3-14,127,127,0
2024-06-04,32,DPD30-59,67,67,0
2024-06-04,32,DPD60-89,0,0,0
2024-06-04,32,DPD90+,0,0,0
2024-06-04,34,Current,0,0,0
2024-06-04,34,DPD15-29,53,53,0
2024-06-04,34,DPD3-14,44,44,0
2024-06-04,34,DPD30-59,27,27,0
2024-06-04,34,DPD60-89,0,0,0
2024-06-04,34,DPD90+,0,0,0
2024-06-04,36,Current,0,0,0
2024-06-04,36,DPD15-29,27,27,0
2024-06-04,36,DPD3-14,37,37,0
2024-06-04,36,DPD30-59,29,29,0
2024-06-04,36,DPD60-89,0,0,0
2024-06-04,36,DPD90+,0,0,0
2024-06-04,38,Current,0,0,0
2024-06-04,38,DPD15-29,26,26,0
2024-06-04,38,DPD3-14,35,35,0
2024-06-04,38,DPD30-59,17,17,0
2024-06-04,38,DPD60-89,0,0,0
2024-06-04,38,DPD90+,0,0,0
2024-06-04,40,Current,0,0,0
2024-06-04,40,DPD15-29,16,16,0
2024-06-04,40,DPD3-14,23,23,0
2024-06-04,40,DPD30-59,7,7,0
2024-06-04,40,DPD60-89,0,0,0
2024-06-04,40,DPD90+,0,0,0
2024-06-04,42,Current,0,0,0
2024-06-04,42,DPD15-29,9,9,0
2024-06-04,42,DPD3-14,9,9,0
2024-06-04,42,DPD30-59,7,7,0
2024-06-04,42,DPD60-89,0,0,0
2024-06-04,42,DPD90+,0,0,0
2024-06-04,44,Current,0,0,0
2024-06-04,44,DPD15-29,39,39,0
2024-06-04,44,DPD3-14,29,29,0
2024-06-04,44,DPD30-59,16,16,0
2024-06-04,44,DPD60-89,0,0,0
2024-06-04,44,DPD90+,0,0,0
2024-06-04,46,Current,0,0,0
2024-06-04,46,DPD15-29,0,0,0
2024-06-04,46,DPD3-14,0,0,0
2024-06-04,48,Current,8,8,0
2024-06-04,48,DPD15-29,15,15,0
2024-06-04,48,DPD3-14,14,14,0
2024-06-04,48,DPD30-59,23,23,0
2024-06-04,48,DPD60-89,0,0,0
2024-06-04,48,DPD90+,0,0,0
2024-06-04,6,Current,0,0,0
2024-06-04,6,DPD60-89,0,0,0
2024-06-04,6,DPD90+,0,0,0
2024-06-03,100,Current,0,0,0
2024-06-03,100,DPD30-59,1,1,0
2024-06-03,102,Current,0,0,0
2024-06-03,102,DPD15-29,0,0,0
2024-06-03,102,DPD30-59,1,1,0
2024-06-03,104,Current,0,0,0
2024-06-03,104,DPD15-29,0,0,0
2024-06-03,104,DPD3-14,0,0,0
2024-06-03,104,DPD90+,0,0,0
2024-06-03,20,Current,0,0,0
2024-06-03,20,DPD15-29,175,175,0
2024-06-03,20,DPD3-14,377,377,0
2024-06-03,20,DPD30-59,116,116,0
2024-06-03,20,DPD60-89,49,49,0
2024-06-03,20,DPD90+,39,39,0
2024-06-03,22,Current,0,0,0
2024-06-03,22,DPD3-14,3,3,0
2024-06-03,22,DPD30-59,0,0,0
2024-06-03,22,DPD90+,0,0,0
2024-06-03,24,Current,30,30,0
2024-06-03,24,DPD15-29,107,107,0
2024-06-03,24,DPD3-14,227,227,0
2024-06-03,24,DPD30-59,44,44,0
2024-06-03,24,DPD60-89,0,0,0
2024-06-03,24,DPD90+,0,0,0
2024-06-03,26,Current,0,0,0
2024-06-03,26,DPD15-29,19,19,0
2024-06-03,26,DPD3-14,44,44,0
2024-06-03,26,DPD30-59,6,6,0
2024-06-03,26,DPD60-89,0,0,0
2024-06-03,26,DPD90+,0,0,0
2024-06-03,32,Current,0,0,0
2024-06-03,32,DPD15-29,99,99,0
2024-06-03,32,DPD3-14,191,191,0
2024-06-03,32,DPD30-59,47,47,0
2024-06-03,32,DPD60-89,0,0,0
2024-06-03,32,DPD90+,0,0,0
2024-06-03,34,Current,0,0,0
2024-06-03,34,DPD15-29,47,47,0
2024-06-03,34,DPD3-14,77,77,0
2024-06-03,34,DPD30-59,26,26,0
2024-06-03,34,DPD60-89,0,0,0
2024-06-03,34,DPD90+,0,0,0
2024-06-03,36,Current,0,0,0
2024-06-03,36,DPD15-29,29,29,0
2024-06-03,36,DPD3-14,65,65,0
2024-06-03,36,DPD30-59,20,20,0
2024-06-03,36,DPD60-89,0,0,0
2024-06-03,36,DPD90+,0,0,0
2024-06-03,38,Current,0,0,0
2024-06-03,38,DPD15-29,22,22,0
2024-06-03,38,DPD3-14,58,58,0
2024-06-03,38,DPD30-59,7,7,0
2024-06-03,38,DPD60-89,0,0,0
2024-06-03,38,DPD90+,0,0,0
2024-06-03,40,Current,0,0,0
2024-06-03,40,DPD15-29,17,17,0
2024-06-03,40,DPD3-14,33,33,0
2024-06-03,40,DPD30-59,5,5,0
2024-06-03,40,DPD60-89,0,0,0
2024-06-03,40,DPD90+,0,0,0
2024-06-03,42,Current,0,0,0
2024-06-03,42,DPD15-29,10,10,0
2024-06-03,42,DPD3-14,22,22,0
2024-06-03,42,DPD30-59,5,5,0
2024-06-03,42,DPD60-89,0,0,0
2024-06-03,42,DPD90+,0,0,0
2024-06-03,44,Current,0,0,0
2024-06-03,44,DPD15-29,29,29,0
2024-06-03,44,DPD3-14,40,40,0
2024-06-03,44,DPD30-59,16,16,0
2024-06-03,44,DPD60-89,0,0,0
2024-06-03,44,DPD90+,0,0,0
2024-06-03,46,Current,0,0,0
2024-06-03,46,DPD15-29,0,0,0
2024-06-03,48,Current,17,17,0
2024-06-03,48,DPD15-29,14,14,0
2024-06-03,48,DPD3-14,42,42,0
2024-06-03,48,DPD30-59,7,7,0
2024-06-03,48,DPD60-89,0,0,0
2024-06-03,48,DPD90+,0,0,0
2024-06-03,6,Current,0,0,0
2024-06-03,6,DPD60-89,0,0,0
2024-06-03,6,DPD90+,0,0,0
2024-06-02,100,Current,0,0,0
2024-06-02,100,DPD3-14,0,0,0
2024-06-02,100,DPD30-59,0,0,0
2024-06-02,102,Current,0,0,0
2024-06-02,102,DPD15-29,0,0,0
2024-06-02,102,DPD30-59,0,0,0
2024-06-02,104,Current,0,0,0
2024-06-02,104,DPD15-29,0,0,0
2024-06-02,104,DPD3-14,0,0,0
2024-06-02,104,DPD30-59,0,0,0
2024-06-02,104,DPD90+,0,0,0
2024-06-02,20,Current,0,0,0
2024-06-02,20,DPD15-29,227,227,0
2024-06-02,20,DPD3-14,332,332,0
2024-06-02,20,DPD30-59,136,136,0
2024-06-02,20,DPD60-89,29,29,0
2024-06-02,20,DPD90+,4,4,0
2024-06-02,22,Current,0,0,0
2024-06-02,22,DPD15-29,0,0,0
2024-06-02,22,DPD3-14,0,0,0
2024-06-02,22,DPD30-59,1,1,0
2024-06-02,22,DPD90+,0,0,0
2024-06-02,24,Current,51,51,0
2024-06-02,24,DPD15-29,133,133,0
2024-06-02,24,DPD3-14,185,185,0
2024-06-02,24,DPD30-59,66,66,0
2024-06-02,24,DPD60-89,0,0,0
2024-06-02,24,DPD90+,0,0,0
2024-06-02,26,Current,0,0,0
2024-06-02,26,DPD15-29,17,17,0
2024-06-02,26,DPD3-14,28,28,0
2024-06-02,26,DPD30-59,3,3,0
2024-06-02,26,DPD60-89,0,0,0
2024-06-02,26,DPD90+,0,0,0
2024-06-02,32,Current,0,0,0
2024-06-02,32,DPD15-29,128,128,0
2024-06-02,32,DPD3-14,168,168,0
2024-06-02,32,DPD30-59,72,72,0
2024-06-02,32,DPD60-89,0,0,0
2024-06-02,32,DPD90+,0,0,0
2024-06-02,34,Current,0,0,0
2024-06-02,34,DPD15-29,53,53,0
2024-06-02,34,DPD3-14,64,64,0
2024-06-02,34,DPD30-59,33,33,0
2024-06-02,34,DPD60-89,0,0,0
2024-06-02,34,DPD90+,0,0,0
2024-06-02,36,Current,0,0,0
2024-06-02,36,DPD15-29,26,26,0
2024-06-02,36,DPD3-14,49,49,0
2024-06-02,36,DPD30-59,15,15,0
2024-06-02,36,DPD60-89,0,0,0
2024-06-02,36,DPD90+,0,0,0
2024-06-02,38,Current,0,0,0
2024-06-02,38,DPD15-29,27,27,0
2024-06-02,38,DPD3-14,51,51,0
2024-06-02,38,DPD30-59,16,16,0
2024-06-02,38,DPD60-89,0,0,0
2024-06-02,38,DPD90+,0,0,0
2024-06-02,40,Current,0,0,0
2024-06-02,40,DPD15-29,14,14,0
2024-06-02,40,DPD3-14,30,30,0
2024-06-02,40,DPD30-59,12,12,0
2024-06-02,40,DPD60-89,0,0,0
2024-06-02,40,DPD90+,0,0,0
2024-06-02,42,Current,0,0,0
2024-06-02,42,DPD15-29,11,11,0
2024-06-02,42,DPD3-14,12,12,0
2024-06-02,42,DPD30-59,4,4,0
2024-06-02,42,DPD60-89,0,0,0
2024-06-02,42,DPD90+,0,0,0
2024-06-02,44,Current,0,0,0
2024-06-02,44,DPD15-29,28,28,0
2024-06-02,44,DPD3-14,48,48,0
2024-06-02,44,DPD30-59,19,19,0
2024-06-02,44,DPD60-89,0,0,0
2024-06-02,44,DPD90+,0,0,0
2024-06-02,46,Current,0,0,0
2024-06-02,46,DPD15-29,0,0,0
2024-06-02,48,Current,26,26,0
2024-06-02,48,DPD15-29,12,12,0
2024-06-02,48,DPD3-14,21,21,0
2024-06-02,48,DPD30-59,4,4,0
2024-06-02,48,DPD60-89,0,0,0
2024-06-02,48,DPD90+,0,0,0
2024-06-02,6,Current,0,0,0
2024-06-02,6,DPD60-89,0,0,0
2024-06-02,6,DPD90+,0,0,0
2024-06-01,100,Current,0,0,0
2024-06-01,100,DPD15-29,1,1,0
2024-06-01,100,DPD3-14,1,1,0
2024-06-01,102,Current,0,0,0
2024-06-01,102,DPD15-29,0,0,0
2024-06-01,102,DPD30-59,0,0,0
2024-06-01,104,Current,0,0,0
2024-06-01,104,DPD15-29,0,0,0
2024-06-01,104,DPD3-14,0,0,0
2024-06-01,104,DPD30-59,0,0,0
2024-06-01,104,DPD90+,0,0,0
2024-06-01,20,Current,4787,4787,0
2024-06-01,20,DPD15-29,203,203,0
2024-06-01,20,DPD3-14,492,492,0
2024-06-01,20,DPD30-59,57,57,0
2024-06-01,20,DPD60-89,31,31,0
2024-06-01,20,DPD90+,45,45,0
2024-06-01,22,Current,0,0,0
2024-06-01,22,DPD15-29,0,0,0
2024-06-01,22,DPD3-14,3,3,0
2024-06-01,22,DPD30-59,0,0,0
2024-06-01,22,DPD90+,0,0,0
2024-06-01,24,Current,3912,3912,0
2024-06-01,24,DPD15-29,116,116,0
2024-06-01,24,DPD3-14,292,292,0
2024-06-01,24,DPD30-59,20,20,0
2024-06-01,24,DPD60-89,16,16,0
2024-06-01,24,DPD90+,12,12,0
2024-06-01,26,Current,0,0,0
2024-06-01,26,DPD15-29,14,14,0
2024-06-01,26,DPD3-14,49,49,0
2024-06-01,26,DPD30-59,0,0,0
2024-06-01,26,DPD60-89,0,0,0
2024-06-01,26,DPD90+,0,0,0
2024-06-01,32,Current,244,244,0
2024-06-01,32,DPD15-29,90,90,0
2024-06-01,32,DPD3-14,221,221,0
2024-06-01,32,DPD30-59,11,11,0
2024-06-01,32,DPD60-89,6,6,0
2024-06-01,32,DPD90+,0,0,0
2024-06-01,34,Current,0,0,0
2024-06-01,34,DPD15-29,40,40,0
2024-06-01,34,DPD3-14,86,86,0
2024-06-01,34,DPD30-59,2,2,0
2024-06-01,34,DPD60-89,0,0,0
2024-06-01,34,DPD90+,0,0,0
2024-06-01,36,Current,261,261,0
2024-06-01,36,DPD15-29,25,25,0
2024-06-01,36,DPD3-14,74,74,0
2024-06-01,36,DPD30-59,4,4,0
2024-06-01,36,DPD60-89,1,1,0
2024-06-01,36,DPD90+,3,3,0
2024-06-01,38,Current,0,0,0
2024-06-01,38,DPD15-29,16,16,0
2024-06-01,38,DPD3-14,64,64,0
2024-06-01,38,DPD30-59,2,2,0
2024-06-01,38,DPD60-89,0,0,0
2024-06-01,38,DPD90+,0,0,0
2024-06-01,40,Current,289,289,0
2024-06-01,40,DPD15-29,18,18,0
2024-06-01,40,DPD3-14,36,36,0
2024-06-01,40,DPD30-59,5,5,0
2024-06-01,40,DPD60-89,0,0,0
2024-06-01,40,DPD90+,0,0,0
2024-06-01,42,Current,0,0,0
2024-06-01,42,DPD15-29,10,10,0
2024-06-01,42,DPD3-14,21,21,0
2024-06-01,42,DPD30-59,1,1,0
2024-06-01,42,DPD60-89,0,0,0
2024-06-01,42,DPD90+,0,0,0
2024-06-01,44,Current,177,177,0
2024-06-01,44,DPD15-29,28,28,0
2024-06-01,44,DPD3-14,49,49,0
2024-06-01,44,DPD30-59,2,2,0
2024-06-01,44,DPD60-89,0,0,0
2024-06-01,44,DPD90+,1,1,0
2024-06-01,46,Current,5,5,0
2024-06-01,46,DPD15-29,0,0,0
2024-06-01,48,Current,4303,4303,0
2024-06-01,48,DPD15-29,34,34,0
2024-06-01,48,DPD3-14,92,92,0
2024-06-01,48,DPD30-59,20,20,0
2024-06-01,48,DPD60-89,14,14,0
2024-06-01,48,DPD90+,10,10,0
2024-06-01,6,Current,0,0,0
2024-06-01,6,DPD60-89,0,0,0
2024-06-01,6,DPD90+,0,0,0
2024-05-31,100,Current,0,0,0
2024-05-31,100,DPD15-29,0,0,0
2024-05-31,100,DPD3-14,0,0,0
2024-05-31,102,Current,0,0,0
2024-05-31,102,DPD15-29,0,0,0
2024-05-31,102,DPD30-59,0,0,0
2024-05-31,104,Current,0,0,0
2024-05-31,104,DPD15-29,0,0,0
2024-05-31,104,DPD3-14,0,0,0
2024-05-31,104,DPD30-59,0,0,0
2024-05-31,104,DPD90+,0,0,0
2024-05-31,20,Current,0,0,0
2024-05-31,20,DPD15-29,248,248,0
2024-05-31,20,DPD3-14,424,424,0
2024-05-31,20,DPD30-59,156,156,0
2024-05-31,20,DPD60-89,58,58,0
2024-05-31,20,DPD90+,93,93,0
2024-05-31,22,Current,0,0,0
2024-05-31,22,DPD15-29,0,0,0
2024-05-31,22,DPD3-14,0,0,0
2024-05-31,22,DPD30-59,0,0,0
2024-05-31,22,DPD90+,0,0,0
2024-05-31,24,Current,71,71,0
2024-05-31,24,DPD15-29,136,136,0
2024-05-31,24,DPD3-14,253,253,0
2024-05-31,24,DPD30-59,70,70,0
2024-05-31,24,DPD60-89,0,0,0
2024-05-31,24,DPD90+,0,0,0
2024-05-31,26,Current,0,0,0
2024-05-31,26,DPD15-29,19,19,0
2024-05-31,26,DPD3-14,32,32,0
2024-05-31,26,DPD30-59,10,10,0
2024-05-31,26,DPD60-89,0,0,0
2024-05-31,26,DPD90+,0,0,0
2024-05-31,32,Current,0,0,0
2024-05-31,32,DPD15-29,138,138,0
2024-05-31,32,DPD3-14,209,209,0
2024-05-31,32,DPD30-59,80,80,0
2024-05-31,32,DPD60-89,0,0,0
2024-05-31,32,DPD90+,0,0,0
2024-05-31,34,Current,0,0,0
2024-05-31,34,DPD15-29,52,52,0
2024-05-31,34,DPD3-14,82,82,0
2024-05-31,34,DPD30-59,25,25,0
2024-05-31,34,DPD60-89,0,0,0
2024-05-31,34,DPD90+,0,0,0
2024-05-31,36,Current,0,0,0
2024-05-31,36,DPD15-29,28,28,0
2024-05-31,36,DPD3-14,58,58,0
2024-05-31,36,DPD30-59,31,31,0
2024-05-31,36,DPD60-89,0,0,0
2024-05-31,36,DPD90+,0,0,0
2024-05-31,38,Current,0,0,0
2024-05-31,38,DPD15-29,35,35,0
2024-05-31,38,DPD3-14,64,64,0
2024-05-31,38,DPD30-59,19,19,0
2024-05-31,38,DPD60-89,0,0,0
2024-05-31,38,DPD90+,0,0,0
2024-05-31,40,Current,0,0,0
2024-05-31,40,DPD15-29,19,19,0
2024-05-31,40,DPD3-14,38,38,0
2024-05-31,40,DPD30-59,7,7,0
2024-05-31,40,DPD60-89,0,0,0
2024-05-31,40,DPD90+,0,0,0
2024-05-31,42,Current,0,0,0
2024-05-31,42,DPD15-29,12,12,0
2024-05-31,42,DPD3-14,13,13,0
2024-05-31,42,DPD30-59,8,8,0
2024-05-31,42,DPD60-89,0,0,0
2024-05-31,42,DPD90+,0,0,0
2024-05-31,44,Current,0,0,0
2024-05-31,44,DPD15-29,32,32,0
2024-05-31,44,DPD3-14,60,60,0
2024-05-31,44,DPD30-59,17,17,0
2024-05-31,44,DPD60-89,0,0,0
2024-05-31,44,DPD90+,0,0,0
2024-05-31,46,Current,0,0,0
2024-05-31,46,DPD15-29,0,0,0
2024-05-31,48,Current,23,23,0
2024-05-31,48,DPD15-29,14,14,0
2024-05-31,48,DPD3-14,33,33,0
2024-05-31,48,DPD30-59,24,24,0
2024-05-31,48,DPD60-89,0,0,0
2024-05-31,48,DPD90+,0,0,0
2024-05-31,6,Current,0,0,0
2024-05-31,6,DPD60-89,0,0,0
2024-05-31,6,DPD90+,0,0,0
2024-05-30,100,Current,0,0,0
2024-05-30,100,DPD15-29,1,1,0
2024-05-30,100,DPD3-14,1,1,0
2024-05-30,102,Current,0,0,0
2024-05-30,102,DPD15-29,0,0,0
2024-05-30,102,DPD3-14,0,0,0
2024-05-30,102,DPD30-59,1,1,0
2024-05-30,104,Current,0,0,0
2024-05-30,104,DPD15-29,0,0,0
2024-05-30,104,DPD3-14,0,0,0
2024-05-30,104,DPD90+,0,0,0
2024-05-30,20,Current,0,0,0
2024-05-30,20,DPD15-29,136,136,0
2024-05-30,20,DPD3-14,326,326,0
2024-05-30,20,DPD30-59,107,107,0
2024-05-30,20,DPD60-89,48,48,0
2024-05-30,20,DPD90+,14,14,0
2024-05-30,22,Current,0,0,0
2024-05-30,22,DPD15-29,0,0,0
2024-05-30,22,DPD3-14,3,3,0
2024-05-30,22,DPD30-59,0,0,0
2024-05-30,22,DPD90+,0,0,0
2024-05-30,24,Current,23,23,0
2024-05-30,24,DPD15-29,81,81,0
2024-05-30,24,DPD3-14,186,186,0
2024-05-30,24,DPD30-59,50,50,0
2024-05-30,24,DPD60-89,0,0,0
2024-05-30,24,DPD90+,0,0,0
2024-05-30,26,Current,0,0,0
2024-05-30,26,DPD15-29,16,16,0
2024-05-30,26,DPD3-14,29,29,0
2024-05-30,26,DPD30-59,6,6,0
2024-05-30,26,DPD60-89,0,0,0
2024-05-30,26,DPD90+,0,0,0
2024-05-30,32,Current,0,0,0
2024-05-30,32,DPD15-29,69,69,0
2024-05-30,32,DPD3-14,163,163,0
2024-05-30,32,DPD30-59,47,47,0
2024-05-30,32,DPD60-89,0,0,0
2024-05-30,32,DPD90+,0,0,0
2024-05-30,34,Current,0,0,0
2024-05-30,34,DPD15-29,39,39,0
2024-05-30,34,DPD3-14,59,59,0
2024-05-30,34,DPD30-59,31,31,0
2024-05-30,34,DPD60-89,0,0,0
2024-05-30,34,DPD90+,0,0,0
2024-05-30,36,Current,0,0,0
2024-05-30,36,DPD15-29,19,19,0
2024-05-30,36,DPD3-14,56,56,0
2024-05-30,36,DPD30-59,21,21,0
2024-05-30,36,DPD60-89,0,0,0
2024-05-30,36,DPD90+,0,0,0
2024-05-30,38,Current,0,0,0
2024-05-30,38,DPD15-29,14,14,0
2024-05-30,38,DPD3-14,50,50,0
2024-05-30,38,DPD30-59,9,9,0
2024-05-30,38,DPD60-89,0,0,0
2024-05-30,38,DPD90+,0,0,0
2024-05-30,40,Current,0,0,0
2024-05-30,40,DPD15-29,13,13,0
2024-05-30,40,DPD3-14,26,26,0
2024-05-30,40,DPD30-59,5,5,0
2024-05-30,40,DPD60-89,0,0,0
2024-05-30,40,DPD90+,0,0,0
2024-05-30,42,Current,0,0,0
2024-05-30,42,DPD15-29,9,9,0
2024-05-30,42,DPD3-14,16,16,0
2024-05-30,42,DPD30-59,6,6,0
2024-05-30,42,DPD60-89,0,0,0
2024-05-30,42,DPD90+,0,0,0
2024-05-30,44,Current,0,0,0
2024-05-30,44,DPD15-29,20,20,0
2024-05-30,44,DPD3-14,42,42,0
2024-05-30,44,DPD30-59,14,14,0
2024-05-30,44,DPD60-89,0,0,0
2024-05-30,44,DPD90+,0,0,0
2024-05-30,46,Current,0,0,0
2024-05-30,46,DPD15-29,0,0,0
2024-05-30,48,Current,11,11,0
2024-05-30,48,DPD15-29,19,19,0
2024-05-30,48,DPD3-14,32,32,0
2024-05-30,48,DPD30-59,3,3,0
2024-05-30,48,DPD60-89,0,0,0
2024-05-30,48,DPD90+,0,0,0
2024-05-30,6,Current,0,0,0
2024-05-30,6,DPD60-89,0,0,0
2024-05-30,6,DPD90+,0,0,0
2024-05-29,100,Current,0,0,0
2024-05-29,100,DPD15-29,0,0,0
2024-05-29,100,DPD3-14,0,0,0
2024-05-29,102,Current,0,0,0
2024-05-29,102,DPD15-29,0,0,0
2024-05-29,102,DPD3-14,1,1,0
2024-05-29,102,DPD30-59,0,0,0
2024-05-29,104,Current,0,0,0
2024-05-29,104,DPD15-29,0,0,0
2024-05-29,104,DPD3-14,0,0,0
2024-05-29,104,DPD90+,0,0,0
2024-05-29,20,Current,0,0,0
2024-05-29,20,DPD15-29,184,184,0
2024-05-29,20,DPD3-14,456,456,0
2024-05-29,20,DPD30-59,112,112,0
2024-05-29,20,DPD60-89,45,45,0
2024-05-29,20,DPD90+,38,38,0
2024-05-29,22,Current,0,0,0
2024-05-29,22,DPD15-29,0,0,0
2024-05-29,22,DPD3-14,0,0,0
2024-05-29,22,DPD30-59,1,1,0
2024-05-29,22,DPD90+,0,0,0
2024-05-29,24,Current,34,34,0
2024-05-29,24,DPD15-29,92,92,0
2024-05-29,24,DPD3-14,280,280,0
2024-05-29,24,DPD30-59,60,60,0
2024-05-29,24,DPD60-89,0,0,0
2024-05-29,24,DPD90+,0,0,0
2024-05-29,26,Current,0,0,0
2024-05-29,26,DPD15-29,12,12,0
2024-05-29,26,DPD3-14,36,36,0
2024-05-29,26,DPD30-59,4,4,0
2024-05-29,26,DPD60-89,0,0,0
2024-05-29,26,DPD90+,0,0,0
2024-05-29,32,Current,0,0,0
2024-05-29,32,DPD15-29,99,99,0
2024-05-29,32,DPD3-14,222,222,0
2024-05-29,32,DPD30-59,61,61,0
2024-05-29,32,DPD60-89,0,0,0
2024-05-29,32,DPD90+,0,0,0
2024-05-29,34,Current,0,0,0
2024-05-29,34,DPD15-29,35,35,0
2024-05-29,34,DPD3-14,89,89,0
2024-05-29,34,DPD30-59,33,33,0
2024-05-29,34,DPD60-89,0,0,0
2024-05-29,34,DPD90+,0,0,0
2024-05-29,36,Current,0,0,0
2024-05-29,36,DPD15-29,19,19,0
2024-05-29,36,DPD3-14,61,61,0
2024-05-29,36,DPD30-59,11,11,0
2024-05-29,36,DPD60-89,0,0,0
2024-05-29,36,DPD90+,0,0,0
2024-05-29,38,Current,0,0,0
2024-05-29,38,DPD15-29,30,30,0
2024-05-29,38,DPD3-14,66,66,0
2024-05-29,38,DPD30-59,13,13,0
2024-05-29,38,DPD60-89,0,0,0
2024-05-29,38,DPD90+,0,0,0
2024-05-29,40,Current,0,0,0
2024-05-29,40,DPD15-29,12,12,0
2024-05-29,40,DPD3-14,42,42,0
2024-05-29,40,DPD30-59,12,12,0
2024-05-29,40,DPD60-89,0,0,0
2024-05-29,40,DPD90+,0,0,0
2024-05-29,42,Current,0,0,0
2024-05-29,42,DPD15-29,7,7,0
2024-05-29,42,DPD3-14,20,20,0
2024-05-29,42,DPD30-59,6,6,0
2024-05-29,42,DPD60-89,0,0,0
2024-05-29,42,DPD90+,0,0,0
2024-05-29,44,Current,0,0,0
2024-05-29,44,DPD15-29,19,19,0
2024-05-29,44,DPD3-14,66,66,0
2024-05-29,44,DPD30-59,19,19,0
2024-05-29,44,DPD60-89,0,0,0
2024-05-29,44,DPD90+,0,0,0
2024-05-29,46,Current,0,0,0
2024-05-29,46,DPD15-29,0,0,0
2024-05-29,48,Current,22,22,0
2024-05-29,48,DPD15-29,11,11,0
2024-05-29,48,DPD3-14,39,39,0
2024-05-29,48,DPD30-59,2,2,0
2024-05-29,48,DPD60-89,0,0,0
2024-05-29,48,DPD90+,0,0,0
2024-05-29,6,Current,0,0,0
2024-05-29,6,DPD60-89,0,0,0
2024-05-28,100,Current,0,0,0
2024-05-28,100,DPD15-29,1,1,0
2024-05-28,102,Current,0,0,0
2024-05-28,102,DPD15-29,0,0,0
2024-05-28,102,DPD3-14,0,0,0
2024-05-28,102,DPD30-59,0,0,0
2024-05-28,104,Current,0,0,0
2024-05-28,104,DPD15-29,0,0,0
2024-05-28,104,DPD3-14,0,0,0
2024-05-28,104,DPD90+,0,0,0
2024-05-28,20,Current,0,0,0
2024-05-28,20,DPD15-29,171,171,0
2024-05-28,20,DPD3-14,411,411,0
2024-05-28,20,DPD30-59,71,71,0
2024-05-28,20,DPD60-89,14,14,0
2024-05-28,20,DPD90+,12,12,0
2024-05-28,22,Current,0,0,0
2024-05-28,22,DPD15-29,0,0,0
2024-05-28,22,DPD3-14,1,1,0
2024-05-28,22,DPD30-59,0,0,0
2024-05-28,22,DPD90+,0,0,0
2024-05-28,24,Current,72,72,0
2024-05-28,24,DPD15-29,105,105,0
2024-05-28,24,DPD3-14,225,225,0
2024-05-28,24,DPD30-59,29,29,0
2024-05-28,24,DPD60-89,0,0,0
2024-05-28,24,DPD90+,0,0,0
2024-05-28,26,Current,0,0,0
2024-05-28,26,DPD15-29,19,19,0
2024-05-28,26,DPD3-14,30,30,0
2024-05-28,26,DPD30-59,4,4,0
2024-05-28,26,DPD60-89,0,0,0
2024-05-28,26,DPD90+,0,0,0
2024-05-28,32,Current,0,0,0
2024-05-28,32,DPD15-29,74,74,0
2024-05-28,32,DPD3-14,195,195,0
2024-05-28,32,DPD30-59,36,36,0
2024-05-28,32,DPD60-89,0,0,0
2024-05-28,32,DPD90+,0,0,0
2024-05-28,34,Current,0,0,0
2024-05-28,34,DPD15-29,46,46,0
2024-05-28,34,DPD3-14,70,70,0
2024-05-28,34,DPD30-59,12,12,0
2024-05-28,34,DPD60-89,0,0,0
2024-05-28,34,DPD90+,0,0,0
2024-05-28,36,Current,0,0,0
2024-05-28,36,DPD15-29,21,21,0
2024-05-28,36,DPD3-14,58,58,0
2024-05-28,36,DPD30-59,13,13,0
2024-05-28,36,DPD60-89,0,0,0
2024-05-28,36,DPD90+,0,0,0
2024-05-28,38,Current,0,0,0
2024-05-28,38,DPD15-29,16,16,0
2024-05-28,38,DPD3-14,69,69,0
2024-05-28,38,DPD30-59,8,8,0
2024-05-28,38,DPD60-89,0,0,0
2024-05-28,38,DPD90+,0,0,0
2024-05-28,40,Current,0,0,0
2024-05-28,40,DPD15-29,16,16,0
2024-05-28,40,DPD3-14,30,30,0
2024-05-28,40,DPD30-59,4,4,0
2024-05-28,40,DPD60-89,0,0,0
2024-05-28,40,DPD90+,0,0,0
2024-05-28,42,Current,0,0,0
2024-05-28,42,DPD15-29,10,10,0
2024-05-28,42,DPD3-14,18,18,0
2024-05-28,42,DPD30-59,2,2,0
2024-05-28,42,DPD60-89,0,0,0
2024-05-28,42,DPD90+,0,0,0
2024-05-28,44,Current,0,0,0
2024-05-28,44,DPD15-29,26,26,0
2024-05-28,44,DPD3-14,47,47,0
2024-05-28,44,DPD30-59,7,7,0
2024-05-28,44,DPD60-89,0,0,0
2024-05-28,44,DPD90+,0,0,0
2024-05-28,46,Current,0,0,0
2024-05-28,46,DPD15-29,0,0,0
2024-05-28,48,Current,25,25,0
2024-05-28,48,DPD15-29,16,16,0
2024-05-28,48,DPD3-14,49,49,0
2024-05-28,48,DPD30-59,26,26,0
2024-05-28,48,DPD60-89,0,0,0
2024-05-28,48,DPD90+,0,0,0
2024-05-28,6,Current,0,0,0
2024-05-28,6,DPD60-89,0,0,0
2024-05-27,100,Current,0,0,0
2024-05-27,100,DPD15-29,0,0,0
2024-05-27,102,Current,0,0,0
2024-05-27,102,DPD15-29,0,0,0
2024-05-27,102,DPD3-14,1,1,0
2024-05-27,102,DPD30-59,0,0,0
2024-05-27,104,Current,0,0,0
2024-05-27,104,DPD15-29,0,0,0
2024-05-27,104,DPD3-14,0,0,0
2024-05-27,104,DPD90+,0,0,0
2024-05-27,20,Current,0,0,0
2024-05-27,20,DPD15-29,185,185,0
2024-05-27,20,DPD3-14,434,434,0
2024-05-27,20,DPD30-59,98,98,0
2024-05-27,20,DPD60-89,64,64,0
2024-05-27,20,DPD90+,41,41,0
2024-05-27,22,Current,0,0,0
2024-05-27,22,DPD15-29,0,0,0
2024-05-27,22,DPD3-14,0,0,0
2024-05-27,22,DPD30-59,0,0,0
2024-05-27,22,DPD90+,0,0,0
2024-05-27,24,Current,81,81,0
2024-05-27,24,DPD15-29,98,98,0
2024-05-27,24,DPD3-14,253,253,0
2024-05-27,24,DPD30-59,45,45,0
2024-05-27,24,DPD60-89,0,0,0
2024-05-27,24,DPD90+,0,0,0
2024-05-27,26,Current,0,0,0
2024-05-27,26,DPD15-29,13,13,0
2024-05-27,26,DPD3-14,36,36,0
2024-05-27,26,DPD30-59,7,7,0
2024-05-27,26,DPD60-89,0,0,0
2024-05-27,26,DPD90+,0,0,0
2024-05-27,32,Current,0,0,0
2024-05-27,32,DPD15-29,92,92,0
2024-05-27,32,DPD3-14,211,211,0
2024-05-27,32,DPD30-59,58,58,0
2024-05-27,32,DPD60-89,0,0,0
2024-05-27,32,DPD90+,0,0,0
2024-05-27,34,Current,0,0,0
2024-05-27,34,DPD15-29,40,40,0
2024-05-27,34,DPD3-14,91,91,0
2024-05-27,34,DPD30-59,15,15,0
2024-05-27,34,DPD60-89,0,0,0
2024-05-27,34,DPD90+,0,0,0
2024-05-27,36,Current,0,0,0
2024-05-27,36,DPD15-29,20,20,0
2024-05-27,36,DPD3-14,57,57,0
2024-05-27,36,DPD30-59,16,16,0
2024-05-27,36,DPD60-89,0,0,0
2024-05-27,36,DPD90+,0,0,0
2024-05-27,38,Current,0,0,0
2024-05-27,38,DPD15-29,28,28,0
2024-05-27,38,DPD3-14,70,70,0
2024-05-27,38,DPD30-59,13,13,0
2024-05-27,38,DPD60-89,0,0,0
2024-05-27,38,DPD90+,0,0,0
2024-05-27,40,Current,0,0,0
2024-05-27,40,DPD15-29,13,13,0
2024-05-27,40,DPD3-14,37,37,0
2024-05-27,40,DPD30-59,5,5,0
2024-05-27,40,DPD60-89,0,0,0
2024-05-27,40,DPD90+,0,0,0
2024-05-27,42,Current,0,0,0
2024-05-27,42,DPD15-29,8,8,0
2024-05-27,42,DPD3-14,23,23,0
2024-05-27,42,DPD30-59,4,4,0
2024-05-27,42,DPD60-89,0,0,0
2024-05-27,42,DPD90+,0,0,0
2024-05-27,44,Current,0,0,0
2024-05-27,44,DPD15-29,22,22,0
2024-05-27,44,DPD3-14,59,59,0
2024-05-27,44,DPD30-59,12,12,0
2024-05-27,44,DPD60-89,0,0,0
2024-05-27,44,DPD90+,0,0,0
2024-05-27,46,Current,0,0,0
2024-05-27,46,DPD15-29,0,0,0
2024-05-27,48,Current,36,36,0
2024-05-27,48,DPD15-29,12,12,0
2024-05-27,48,DPD3-14,29,29,0
2024-05-27,48,DPD30-59,2,2,0
2024-05-27,48,DPD60-89,0,0,0
2024-05-27,48,DPD90+,0,0,0
2024-05-27,6,Current,0,0,0
2024-05-27,6,DPD60-89,0,0,0
2024-05-26,100,Current,0,0,0
2024-05-26,100,DPD15-29,1,1,0
2024-05-26,102,Current,0,0,0
2024-05-26,102,DPD15-29,0,0,0
2024-05-26,102,DPD3-14,0,0,0
2024-05-26,102,DPD30-59,1,1,0
2024-05-26,104,Current,0,0,0
2024-05-26,104,DPD15-29,0,0,0
2024-05-26,104,DPD3-14,0,0,0
2024-05-26,104,DPD90+,0,0,0
2024-05-26,20,Current,0,0,0
2024-05-26,20,DPD15-29,159,159,0
2024-05-26,20,DPD3-14,355,355,0
2024-05-26,20,DPD30-59,113,113,0
2024-05-26,20,DPD60-89,54,54,0
2024-05-26,20,DPD90+,42,42,0
2024-05-26,22,Current,0,0,0
2024-05-26,22,DPD15-29,0,0,0
2024-05-26,22,DPD3-14,1,1,0
2024-05-26,22,DPD30-59,0,0,0
2024-05-26,22,DPD90+,0,0,0
2024-05-26,24,Current,60,60,0
2024-05-26,24,DPD15-29,101,101,0
2024-05-26,24,DPD3-14,205,205,0
2024-05-26,24,DPD30-59,56,56,0
2024-05-26,24,DPD60-89,0,0,0
2024-05-26,24,DPD90+,0,0,0
2024-05-26,26,Current,0,0,0
2024-05-26,26,DPD15-29,18,18,0
2024-05-26,26,DPD3-14,28,28,0
2024-05-26,26,DPD30-59,7,7,0
2024-05-26,26,DPD60-89,0,0,0
2024-05-26,26,DPD90+,0,0,0
2024-05-26,32,Current,0,0,0
2024-05-26,32,DPD15-29,69,69,0
2024-05-26,32,DPD3-14,179,179,0
2024-05-26,32,DPD30-59,43,43,0
2024-05-26,32,DPD60-89,0,0,0
2024-05-26,32,DPD90+,0,0,0
2024-05-26,34,Current,0,0,0
2024-05-26,34,DPD15-29,44,44,0
2024-05-26,34,DPD3-14,59,59,0
2024-05-26,34,DPD30-59,28,28,0
2024-05-26,34,DPD60-89,0,0,0
2024-05-26,34,DPD90+,0,0,0
2024-05-26,36,Current,0,0,0
2024-05-26,36,DPD15-29,20,20,0
2024-05-26,36,DPD3-14,55,55,0
2024-05-26,36,DPD30-59,23,23,0
2024-05-26,36,DPD60-89,0,0,0
2024-05-26,36,DPD90+,0,0,0
2024-05-26,38,Current,0,0,0
2024-05-26,38,DPD15-29,16,16,0
2024-05-26,38,DPD3-14,57,57,0
2024-05-26,38,DPD30-59,5,5,0
2024-05-26,38,DPD60-89,0,0,0
2024-05-26,38,DPD90+,0,0,0
2024-05-26,40,Current,0,0,0
2024-05-26,40,DPD15-29,11,11,0
2024-05-26,40,DPD3-14,32,32,0
2024-05-26,40,DPD30-59,6,6,0
2024-05-26,40,DPD60-89,0,0,0
2024-05-26,40,DPD90+,0,0,0
2024-05-26,42,Current,0,0,0
2024-05-26,42,DPD15-29,8,8,0
2024-05-26,42,DPD3-14,15,15,0
2024-05-26,42,DPD30-59,5,5,0
2024-05-26,42,DPD60-89,0,0,0
2024-05-26,42,DPD90+,0,0,0
2024-05-26,44,Current,0,0,0
2024-05-26,44,DPD15-29,26,26,0
2024-05-26,44,DPD3-14,41,41,0
2024-05-26,44,DPD30-59,12,12,0
2024-05-26,44,DPD60-89,0,0,0
2024-05-26,44,DPD90+,0,0,0
2024-05-26,46,Current,0,0,0
2024-05-26,46,DPD15-29,0,0,0
2024-05-26,48,Current,62,62,0
2024-05-26,48,DPD15-29,9,9,0
2024-05-26,48,DPD3-14,35,35,0
2024-05-26,48,DPD30-59,1,1,0
2024-05-26,48,DPD60-89,0,0,0
2024-05-26,48,DPD90+,0,0,0
2024-05-26,6,Current,0,0,0
2024-05-26,6,DPD60-89,0,0,0
2024-05-25,100,Current,0,0,0
2024-05-25,100,DPD15-29,0,0,0
2024-05-25,102,Current,0,0,0
2024-05-25,102,DPD15-29,0,0,0
2024-05-25,102,DPD3-14,1,1,0
2024-05-25,102,DPD30-59,0,0,0
2024-05-25,104,Current,0,0,0
2024-05-25,104,DPD15-29,0,0,0
2024-05-25,104,DPD3-14,0,0,0
2024-05-25,104,DPD90+,0,0,0
2024-05-25,20,Current,0,0,0
2024-05-25,20,DPD15-29,172,172,0
2024-05-25,20,DPD3-14,390,390,0
2024-05-25,20,DPD30-59,112,112,0
2024-05-25,20,DPD60-89,29,29,0
2024-05-25,20,DPD90+,2,2,0
2024-05-25,22,Current,0,0,0
2024-05-25,22,DPD15-29,0,0,0
2024-05-25,22,DPD3-14,0,0,0
2024-05-25,22,DPD30-59,1,1,0
2024-05-25,22,DPD90+,0,0,0
2024-05-25,24,Current,28,28,0
2024-05-25,24,DPD15-29,90,90,0
2024-05-25,24,DPD3-14,221,221,0
2024-05-25,24,DPD30-59,56,56,0
2024-05-25,24,DPD60-89,0,0,0
2024-05-25,24,DPD90+,0,0,0
2024-05-25,26,Current,0,0,0
2024-05-25,26,DPD15-29,12,12,0
2024-05-25,26,DPD3-14,33,33,0
2024-05-25,26,DPD30-59,5,5,0
2024-05-25,26,DPD60-89,0,0,0
2024-05-25,26,DPD90+,0,0,0
2024-05-25,32,Current,0,0,0
2024-05-25,32,DPD15-29,90,90,0
2024-05-25,32,DPD3-14,187,187,0
2024-05-25,32,DPD30-59,51,51,0
2024-05-25,32,DPD60-89,0,0,0
2024-05-25,32,DPD90+,0,0,0
2024-05-25,34,Current,0,0,0
2024-05-25,34,DPD15-29,34,34,0
2024-05-25,34,DPD3-14,81,81,0
2024-05-25,34,DPD30-59,24,24,0
2024-05-25,34,DPD60-89,0,0,0
2024-05-25,34,DPD90+,0,0,0
2024-05-25,36,Current,0,0,0
2024-05-25,36,DPD15-29,19,19,0
2024-05-25,36,DPD3-14,52,52,0
2024-05-25,36,DPD30-59,14,14,0
2024-05-25,36,DPD60-89,0,0,0
2024-05-25,36,DPD90+,0,0,0
2024-05-25,38,Current,0,0,0
2024-05-25,38,DPD15-29,23,23,0
2024-05-25,38,DPD3-14,63,63,0
2024-05-25,38,DPD30-59,11,11,0
2024-05-25,38,DPD60-89,0,0,0
2024-05-25,38,DPD90+,0,0,0
2024-05-25,40,Current,0,0,0
2024-05-25,40,DPD15-29,12,12,0
2024-05-25,40,DPD3-14,35,35,0
2024-05-25,40,DPD30-59,8,8,0
2024-05-25,40,DPD60-89,0,0,0
2024-05-25,40,DPD90+,0,0,0
2024-05-25,42,Current,0,0,0
2024-05-25,42,DPD15-29,8,8,0
2024-05-25,42,DPD3-14,21,21,0
2024-05-25,42,DPD30-59,5,5,0
2024-05-25,42,DPD60-89,0,0,0
2024-05-25,42,DPD90+,0,0,0
2024-05-25,44,Current,0,0,0
2024-05-25,44,DPD15-29,23,23,0
2024-05-25,44,DPD3-14,52,52,0
2024-05-25,44,DPD30-59,15,15,0
2024-05-25,44,DPD60-89,0,0,0
2024-05-25,44,DPD90+,0,0,0
2024-05-25,46,Current,0,0,0
2024-05-25,46,DPD15-29,0,0,0
2024-05-25,48,Current,15,15,0
2024-05-25,48,DPD15-29,11,11,0
2024-05-25,48,DPD3-14,28,28,0
2024-05-25,48,DPD30-59,1,1,0
2024-05-25,48,DPD60-89,0,0,0
2024-05-25,48,DPD90+,0,0,0
2024-05-25,6,Current,0,0,0
2024-05-25,6,DPD60-89,0,0,0
2024-05-24,100,Current,0,0,0
2024-05-24,100,DPD15-29,1,1,0
2024-05-24,102,Current,0,0,0
2024-05-24,102,DPD15-29,0,0,0
2024-05-24,102,DPD3-14,0,0,0
2024-05-24,102,DPD30-59,0,0,0
2024-05-24,104,Current,0,0,0
2024-05-24,104,DPD15-29,0,0,0
2024-05-24,104,DPD90+,0,0,0
2024-05-24,20,Current,0,0,0
2024-05-24,20,DPD15-29,170,170,0
2024-05-24,20,DPD3-14,348,348,0
2024-05-24,20,DPD30-59,42,42,0
2024-05-24,20,DPD60-89,40,40,0
2024-05-24,20,DPD90+,70,70,0
2024-05-24,22,Current,0,0,0
2024-05-24,22,DPD15-29,0,0,0
2024-05-24,22,DPD30-59,0,0,0
2024-05-24,22,DPD90+,0,0,0
2024-05-24,24,Current,47,47,0
2024-05-24,24,DPD15-29,95,95,0
2024-05-24,24,DPD3-14,214,214,0
2024-05-24,24,DPD30-59,14,14,0
2024-05-24,24,DPD60-89,0,0,0
2024-05-24,24,DPD90+,0,0,0
2024-05-24,26,Current,0,0,0
2024-05-24,26,DPD15-29,15,15,0
2024-05-24,26,DPD3-14,29,29,0
2024-05-24,26,DPD30-59,2,2,0
2024-05-24,26,DPD60-89,0,0,0
2024-05-24,26,DPD90+,0,0,0
2024-05-24,32,Current,0,0,0
2024-05-24,32,DPD15-29,80,80,0
2024-05-24,32,DPD3-14,167,167,0
2024-05-24,32,DPD30-59,19,19,0
2024-05-24,32,DPD60-89,0,0,0
2024-05-24,32,DPD90+,0,0,0
2024-05-24,34,Current,0,0,0
2024-05-24,34,DPD15-29,36,36,0
2024-05-24,34,DPD3-14,62,62,0
2024-05-24,34,DPD30-59,8,8,0
2024-05-24,34,DPD60-89,0,0,0
2024-05-24,34,DPD90+,0,0,0
2024-05-24,36,Current,0,0,0
2024-05-24,36,DPD15-29,27,27,0
2024-05-24,36,DPD3-14,56,56,0
2024-05-24,36,DPD30-59,8,8,0
2024-05-24,36,DPD60-89,0,0,0
2024-05-24,36,DPD90+,0,0,0
2024-05-24,38,Current,0,0,0
2024-05-24,38,DPD15-29,19,19,0
2024-05-24,38,DPD3-14,48,48,0
2024-05-24,38,DPD30-59,6,6,0
2024-05-24,38,DPD60-89,0,0,0
2024-05-24,38,DPD90+,0,0,0
2024-05-24,40,Current,0,0,0
2024-05-24,40,DPD15-29,14,14,0
2024-05-24,40,DPD3-14,33,33,0
2024-05-24,40,DPD30-59,4,4,0
2024-05-24,40,DPD60-89,0,0,0
2024-05-24,40,DPD90+,0,0,0
2024-05-24,42,Current,0,0,0
2024-05-24,42,DPD15-29,8,8,0
2024-05-24,42,DPD3-14,17,17,0
2024-05-24,42,DPD30-59,2,2,0
2024-05-24,42,DPD60-89,0,0,0
2024-05-24,42,DPD90+,0,0,0
2024-05-24,44,Current,0,0,0
2024-05-24,44,DPD15-29,21,21,0
2024-05-24,44,DPD3-14,42,42,0
2024-05-24,44,DPD30-59,6,6,0
2024-05-24,44,DPD60-89,0,0,0
2024-05-24,44,DPD90+,0,0,0
2024-05-24,46,Current,0,0,0
2024-05-24,46,DPD15-29,0,0,0
2024-05-24,48,Current,28,28,0
2024-05-24,48,DPD15-29,13,13,0
2024-05-24,48,DPD3-14,38,38,0
2024-05-24,48,DPD30-59,2,2,0
2024-05-24,48,DPD60-89,0,0,0
2024-05-24,48,DPD90+,0,0,0
2024-05-24,6,Current,0,0,0
2024-05-24,6,DPD60-89,0,0,0
2024-05-23,100,Current,0,0,0
2024-05-23,100,DPD15-29,0,0,0
2024-05-23,102,Current,0,0,0
2024-05-23,102,DPD15-29,0,0,0
2024-05-23,102,DPD3-14,1,1,0
2024-05-23,102,DPD30-59,0,0,0
2024-05-23,104,Current,0,0,0
2024-05-23,104,DPD15-29,1,1,0
2024-05-23,104,DPD3-14,0,0,0
2024-05-23,104,DPD90+,0,0,0
2024-05-23,20,Current,1,1,0
2024-05-23,20,DPD15-29,191,191,0
2024-05-23,20,DPD3-14,375,375,0
2024-05-23,20,DPD30-59,97,97,0
2024-05-23,20,DPD60-89,36,36,0
2024-05-23,20,DPD90+,19,19,0
2024-05-23,22,Current,0,0,0
2024-05-23,22,DPD15-29,0,0,0
2024-05-23,22,DPD3-14,1,1,0
2024-05-23,22,DPD30-59,0,0,0
2024-05-23,22,DPD60-89,0,0,0
2024-05-23,22,DPD90+,0,0,0
2024-05-23,24,Current,36,36,0
2024-05-23,24,DPD15-29,109,109,0
2024-05-23,24,DPD3-14,219,219,0
2024-05-23,24,DPD30-59,35,35,0
2024-05-23,24,DPD60-89,0,0,0
2024-05-23,24,DPD90+,0,0,0
2024-05-23,26,Current,0,0,0
2024-05-23,26,DPD15-29,13,13,0
2024-05-23,26,DPD3-14,31,31,0
2024-05-23,26,DPD30-59,7,7,0
2024-05-23,26,DPD60-89,0,0,0
2024-05-23,26,DPD90+,0,0,0
2024-05-23,32,Current,0,0,0
2024-05-23,32,DPD15-29,91,91,0
2024-05-23,32,DPD3-14,191,191,0
2024-05-23,32,DPD30-59,56,56,0
2024-05-23,32,DPD60-89,0,0,0
2024-05-23,32,DPD90+,0,0,0
2024-05-23,34,Current,0,0,0
2024-05-23,34,DPD15-29,43,43,0
2024-05-23,34,DPD3-14,80,80,0
2024-05-23,34,DPD30-59,15,15,0
2024-05-23,34,DPD60-89,0,0,0
2024-05-23,34,DPD90+,0,0,0
2024-05-23,36,Current,0,0,0
2024-05-23,36,DPD15-29,24,24,0
2024-05-23,36,DPD3-14,53,53,0
2024-05-23,36,DPD30-59,11,11,0
2024-05-23,36,DPD60-89,0,0,0
2024-05-23,36,DPD90+,0,0,0
2024-05-23,38,Current,0,0,0
2024-05-23,38,DPD15-29,26,26,0
2024-05-23,38,DPD3-14,62,62,0
2024-05-23,38,DPD30-59,12,12,0
2024-05-23,38,DPD60-89,0,0,0
2024-05-23,38,DPD90+,0,0,0
2024-05-23,40,Current,0,0,0
2024-05-23,40,DPD15-29,12,12,0
2024-05-23,40,DPD3-14,34,34,0
2024-05-23,40,DPD30-59,4,4,0
2024-05-23,40,DPD60-89,0,0,0
2024-05-23,40,DPD90+,0,0,0
2024-05-23,42,Current,0,0,0
2024-05-23,42,DPD15-29,11,11,0
2024-05-23,42,DPD3-14,22,22,0
2024-05-23,42,DPD30-59,2,2,0
2024-05-23,42,DPD60-89,0,0,0
2024-05-23,42,DPD90+,0,0,0
2024-05-23,44,Current,0,0,0
2024-05-23,44,DPD15-29,31,31,0
2024-05-23,44,DPD3-14,54,54,0
2024-05-23,44,DPD30-59,9,9,0
2024-05-23,44,DPD60-89,0,0,0
2024-05-23,44,DPD90+,0,0,0
2024-05-23,46,Current,0,0,0
2024-05-23,46,DPD15-29,0,0,0
2024-05-23,48,Current,13,13,0
2024-05-23,48,DPD15-29,12,12,0
2024-05-23,48,DPD3-14,32,32,0
2024-05-23,48,DPD30-59,7,7,0
2024-05-23,48,DPD60-89,0,0,0
2024-05-23,48,DPD90+,0,0,0
2024-05-23,6,Current,0,0,0
2024-05-23,6,DPD60-89,0,0,0
2024-05-22,100,Current,0,0,0
2024-05-22,100,DPD15-29,1,1,0
2024-05-22,102,Current,0,0,0
2024-05-22,102,DPD15-29,0,0,0
2024-05-22,102,DPD3-14,0,0,0
2024-05-22,102,DPD30-59,1,1,0
2024-05-22,104,Current,0,0,0
2024-05-22,104,DPD15-29,0,0,0
2024-05-22,104,DPD3-14,0,0,0
2024-05-22,104,DPD90+,0,0,0
2024-05-22,20,Current,0,0,0
2024-05-22,20,DPD15-29,188,188,0
2024-05-22,20,DPD3-14,301,301,0
2024-05-22,20,DPD30-59,124,124,0
2024-05-22,20,DPD60-89,39,39,0
2024-05-22,20,DPD90+,10,10,0
2024-05-22,22,Current,0,0,0
2024-05-22,22,DPD15-29,0,0,0
2024-05-22,22,DPD3-14,0,0,0
2024-05-22,22,DPD30-59,0,0,0
2024-05-22,22,DPD60-89,0,0,0
2024-05-22,22,DPD90+,0,0,0
2024-05-22,24,Current,51,51,0
2024-05-22,24,DPD15-29,92,92,0
2024-05-22,24,DPD3-14,174,174,0
2024-05-22,24,DPD30-59,68,68,0
2024-05-22,24,DPD60-89,0,0,0
2024-05-22,24,DPD90+,0,0,0
2024-05-22,26,Current,0,0,0
2024-05-22,26,DPD15-29,15,15,0
2024-05-22,26,DPD3-14,19,19,0
2024-05-22,26,DPD30-59,8,8,0
2024-05-22,26,DPD60-89,0,0,0
2024-05-22,26,DPD90+,0,0,0
2024-05-22,32,Current,0,0,0
2024-05-22,32,DPD15-29,76,76,0
2024-05-22,32,DPD3-14,130,130,0
2024-05-22,32,DPD30-59,51,51,0
2024-05-22,32,DPD60-89,0,0,0
2024-05-22,32,DPD90+,0,0,0
2024-05-22,34,Current,0,0,0
2024-05-22,34,DPD15-29,34,34,0
2024-05-22,34,DPD3-14,57,57,0
2024-05-22,34,DPD30-59,37,37,0
2024-05-22,34,DPD60-89,0,0,0
2024-05-22,34,DPD90+,0,0,0
2024-05-22,36,Current,0,0,0
2024-05-22,36,DPD15-29,27,27,0
2024-05-22,36,DPD3-14,42,42,0
2024-05-22,36,DPD30-59,23,23,0
2024-05-22,36,DPD60-89,0,0,0
2024-05-22,36,DPD90+,0,0,0
2024-05-22,38,Current,0,0,0
2024-05-22,38,DPD15-29,24,24,0
2024-05-22,38,DPD3-14,34,34,0
2024-05-22,38,DPD30-59,8,8,0
2024-05-22,38,DPD60-89,0,0,0
2024-05-22,38,DPD90+,0,0,0
2024-05-22,40,Current,0,0,0
2024-05-22,40,DPD15-29,11,11,0
2024-05-22,40,DPD3-14,34,34,0
2024-05-22,40,DPD30-59,10,10,0
2024-05-22,40,DPD60-89,0,0,0
2024-05-22,40,DPD90+,0,0,0
2024-05-22,42,Current,0,0,0
2024-05-22,42,DPD15-29,9,9,0
2024-05-22,42,DPD3-14,18,18,0
2024-05-22,42,DPD30-59,7,7,0
2024-05-22,42,DPD60-89,0,0,0
2024-05-22,42,DPD90+,0,0,0
2024-05-22,44,Current,0,0,0
2024-05-22,44,DPD15-29,18,18,0
2024-05-22,44,DPD3-14,40,40,0
2024-05-22,44,DPD30-59,15,15,0
2024-05-22,44,DPD60-89,0,0,0
2024-05-22,44,DPD90+,0,0,0
2024-05-22,46,Current,0,0,0
2024-05-22,46,DPD15-29,0,0,0
2024-05-22,48,Current,31,31,0
2024-05-22,48,DPD15-29,11,11,0
2024-05-22,48,DPD3-14,33,33,0
2024-05-22,48,DPD30-59,22,22,0
2024-05-22,48,DPD60-89,0,0,0
2024-05-22,48,DPD90+,0,0,0
2024-05-22,6,Current,0,0,0
2024-05-22,6,DPD60-89,0,0,0
2024-05-21,100,Current,0,0,0
2024-05-21,100,DPD15-29,0,0,0
2024-05-21,102,Current,0,0,0
2024-05-21,102,DPD15-29,0,0,0
2024-05-21,102,DPD3-14,2,2,0
2024-05-21,102,DPD30-59,0,0,0
2024-05-21,104,Current,0,0,0
2024-05-21,104,DPD15-29,1,1,0
2024-05-21,104,DPD3-14,0,0,0
2024-05-21,104,DPD60-89,0,0,0
2024-05-21,20,Current,0,0,0
2024-05-21,20,DPD15-29,196,196,0
2024-05-21,20,DPD3-14,412,412,0
2024-05-21,20,DPD30-59,133,133,0
2024-05-21,20,DPD60-89,48,48,0
2024-05-21,20,DPD90+,39,39,0
2024-05-21,22,Current,0,0,0
2024-05-21,22,DPD15-29,0,0,0
2024-05-21,22,DPD30-59,0,0,0
2024-05-21,22,DPD60-89,0,0,0
2024-05-21,22,DPD90+,0,0,0
2024-05-21,24,Current,63,63,0
2024-05-21,24,DPD15-29,108,108,0
2024-05-21,24,DPD3-14,245,245,0
2024-05-21,24,DPD30-59,58,58,0
2024-05-21,24,DPD60-89,0,0,0
2024-05-21,24,DPD90+,0,0,0
2024-05-21,26,Current,0,0,0
2024-05-21,26,DPD15-29,12,12,0
2024-05-21,26,DPD3-14,32,32,0
2024-05-21,26,DPD30-59,4,4,0
2024-05-21,26,DPD60-89,0,0,0
2024-05-21,26,DPD90+,0,0,0
2024-05-21,32,Current,0,0,0
2024-05-21,32,DPD15-29,91,91,0
2024-05-21,32,DPD3-14,205,205,0
2024-05-21,32,DPD30-59,60,60,0
2024-05-21,32,DPD60-89,0,0,0
2024-05-21,32,DPD90+,0,0,0
2024-05-21,34,Current,0,0,0
2024-05-21,34,DPD15-29,43,43,0
2024-05-21,34,DPD3-14,86,86,0
2024-05-21,34,DPD30-59,22,22,0
2024-05-21,34,DPD60-89,0,0,0
2024-05-21,34,DPD90+,0,0,0
2024-05-21,36,Current,0,0,0
2024-05-21,36,DPD15-29,24,24,0
2024-05-21,36,DPD3-14,65,65,0
2024-05-21,36,DPD30-59,15,15,0
2024-05-21,36,DPD60-89,0,0,0
2024-05-21,36,DPD90+,0,0,0
2024-05-21,38,Current,0,0,0
2024-05-21,38,DPD15-29,32,32,0
2024-05-21,38,DPD3-14,64,64,0
2024-05-21,38,DPD30-59,12,12,0
2024-05-21,38,DPD60-89,0,0,0
2024-05-21,38,DPD90+,0,0,0
2024-05-21,40,Current,0,0,0
2024-05-21,40,DPD15-29,12,12,0
2024-05-21,40,DPD3-14,27,27,0
2024-05-21,40,DPD30-59,8,8,0
2024-05-21,40,DPD60-89,0,0,0
2024-05-21,40,DPD90+,0,0,0
2024-05-21,42,Current,0,0,0
2024-05-21,42,DPD15-29,11,11,0
2024-05-21,42,DPD3-14,27,27,0
2024-05-21,42,DPD30-59,5,5,0
2024-05-21,42,DPD60-89,0,0,0
2024-05-21,42,DPD90+,0,0,0
2024-05-21,44,Current,0,0,0
2024-05-21,44,DPD15-29,35,35,0
2024-05-21,44,DPD3-14,57,57,0
2024-05-21,44,DPD30-59,13,13,0
2024-05-21,44,DPD60-89,0,0,0
2024-05-21,44,DPD90+,0,0,0
2024-05-21,46,Current,0,0,0
2024-05-21,46,DPD3-14,0,0,0
2024-05-21,48,Current,21,21,0
2024-05-21,48,DPD15-29,8,8,0
2024-05-21,48,DPD3-14,37,37,0
2024-05-21,48,DPD30-59,3,3,0
2024-05-21,48,DPD60-89,0,0,0
2024-05-21,48,DPD90+,0,0,0
2024-05-21,6,Current,0,0,0
2024-05-21,6,DPD60-89,0,0,0
2024-05-20,100,Current,0,0,0
2024-05-20,100,DPD15-29,1,1,0
2024-05-20,100,DPD3-14,0,0,0
2024-05-20,102,Current,0,0,0
2024-05-20,102,DPD3-14,0,0,0
2024-05-20,102,DPD30-59,0,0,0
2024-05-20,104,Current,0,0,0
2024-05-20,104,DPD15-29,0,0,0
2024-05-20,104,DPD3-14,0,0,0
2024-05-20,104,DPD60-89,0,0,0
2024-05-20,20,Current,35,35,0
2024-05-20,20,DPD15-29,214,214,0
2024-05-20,20,DPD3-14,314,314,0
2024-05-20,20,DPD30-59,37,37,0
2024-05-20,20,DPD60-89,20,20,0
2024-05-20,20,DPD90+,20,20,0
2024-05-20,22,Current,0,0,0
2024-05-20,22,DPD15-29,1,1,0
2024-05-20,22,DPD30-59,0,0,0
2024-05-20,22,DPD60-89,0,0,0
2024-05-20,22,DPD90+,0,0,0
2024-05-20,24,Current,105,105,0
2024-05-20,24,DPD15-29,101,101,0
2024-05-20,24,DPD3-14,207,207,0
2024-05-20,24,DPD30-59,18,18,0
2024-05-20,24,DPD60-89,1,1,0
2024-05-20,24,DPD90+,0,0,0
2024-05-20,26,Current,7,7,0
2024-05-20,26,DPD15-29,17,17,0
2024-05-20,26,DPD3-14,26,26,0
2024-05-20,26,DPD30-59,2,2,0
2024-05-20,26,DPD60-89,0,0,0
2024-05-20,26,DPD90+,0,0,0
2024-05-20,32,Current,11,11,0
2024-05-20,32,DPD15-29,93,93,0
2024-05-20,32,DPD3-14,141,141,0
2024-05-20,32,DPD30-59,20,20,0
2024-05-20,32,DPD60-89,0,0,0
2024-05-20,32,DPD90+,0,0,0
2024-05-20,34,Current,3,3,0
2024-05-20,34,DPD15-29,40,40,0
2024-05-20,34,DPD3-14,65,65,0
2024-05-20,34,DPD30-59,7,7,0
2024-05-20,34,DPD60-89,0,0,0
2024-05-20,34,DPD90+,0,0,0
2024-05-20,36,Current,10,10,0
2024-05-20,36,DPD15-29,29,29,0
2024-05-20,36,DPD3-14,47,47,0
2024-05-20,36,DPD30-59,4,4,0
2024-05-20,36,DPD60-89,0,0,0
2024-05-20,36,DPD90+,0,0,0
2024-05-20,38,Current,8,8,0
2024-05-20,38,DPD15-29,26,26,0
2024-05-20,38,DPD3-14,42,42,0
2024-05-20,38,DPD30-59,4,4,0
2024-05-20,38,DPD60-89,0,0,0
2024-05-20,38,DPD90+,0,0,0
2024-05-20,40,Current,5,5,0
2024-05-20,40,DPD15-29,15,15,0
2024-05-20,40,DPD3-14,33,33,0
2024-05-20,40,DPD30-59,4,4,0
2024-05-20,40,DPD60-89,0,0,0
2024-05-20,40,DPD90+,0,0,0
2024-05-20,42,Current,2,2,0
2024-05-20,42,DPD15-29,11,11,0
2024-05-20,42,DPD3-14,17,17,0
2024-05-20,42,DPD30-59,1,1,0
2024-05-20,42,DPD60-89,0,0,0
2024-05-20,42,DPD90+,0,0,0
2024-05-20,44,Current,14,14,0
2024-05-20,44,DPD15-29,18,18,0
2024-05-20,44,DPD3-14,49,49,0
2024-05-20,44,DPD30-59,6,6,0
2024-05-20,44,DPD60-89,0,0,0
2024-05-20,44,DPD90+,0,0,0
2024-05-20,46,Current,0,0,0
2024-05-20,46,DPD3-14,0,0,0
2024-05-20,48,Current,29,29,0
2024-05-20,48,DPD15-29,9,9,0
2024-05-20,48,DPD3-14,37,37,0
2024-05-20,48,DPD30-59,2,2,0
2024-05-20,48,DPD60-89,0,0,0
2024-05-20,48,DPD90+,0,0,0
2024-05-20,6,Current,0,0,0
2024-05-20,6,DPD60-89,0,0,0
2024-05-19,100,Current,0,0,0
2024-05-19,100,DPD15-29,0,0,0
2024-05-19,102,Current,0,0,0
2024-05-19,102,DPD3-14,1,1,0
2024-05-19,102,DPD30-59,0,0,0
2024-05-19,104,Current,0,0,0
2024-05-19,104,DPD15-29,1,1,0
2024-05-19,104,DPD3-14,0,0,0
2024-05-19,104,DPD90+,0,0,0
2024-05-19,20,Current,52,52,0
2024-05-19,20,DPD15-29,200,200,0
2024-05-19,20,DPD3-14,397,397,0
2024-05-19,20,DPD30-59,85,85,0
2024-05-19,20,DPD60-89,59,59,0
2024-05-19,20,DPD90+,30,30,0
2024-05-19,22,Current,0,0,0
2024-05-19,22,DPD15-29,0,0,0
2024-05-19,22,DPD30-59,0,0,0
2024-05-19,22,DPD90+,0,0,0
2024-05-19,24,Current,150,150,0
2024-05-19,24,DPD15-29,110,110,0
2024-05-19,24,DPD3-14,223,223,0
2024-05-19,24,DPD30-59,34,34,0
2024-05-19,24,DPD60-89,0,0,0
2024-05-19,24,DPD90+,0,0,0
2024-05-19,26,Current,0,0,0
2024-05-19,26,DPD15-29,14,14,0
2024-05-19,26,DPD3-14,29,29,0
2024-05-19,26,DPD30-59,8,8,0
2024-05-19,26,DPD60-89,0,0,0
2024-05-19,26,DPD90+,0,0,0
2024-05-19,32,Current,0,0,0
2024-05-19,32,DPD15-29,92,92,0
2024-05-19,32,DPD3-14,175,175,0
2024-05-19,32,DPD30-59,54,54,0
2024-05-19,32,DPD60-89,0,0,0
2024-05-19,32,DPD90+,0,0,0
2024-05-19,34,Current,0,0,0
2024-05-19,34,DPD15-29,44,44,0
2024-05-19,34,DPD3-14,83,83,0
2024-05-19,34,DPD30-59,20,20,0
2024-05-19,34,DPD60-89,0,0,0
2024-05-19,34,DPD90+,0,0,0
2024-05-19,36,Current,0,0,0
2024-05-19,36,DPD15-29,30,30,0
2024-05-19,36,DPD3-14,57,57,0
2024-05-19,36,DPD30-59,11,11,0
2024-05-19,36,DPD60-89,0,0,0
2024-05-19,36,DPD90+,0,0,0
2024-05-19,38,Current,0,0,0
2024-05-19,38,DPD15-29,31,31,0
2024-05-19,38,DPD3-14,61,61,0
2024-05-19,38,DPD30-59,11,11,0
2024-05-19,38,DPD60-89,0,0,0
2024-05-19,38,DPD90+,0,0,0
2024-05-19,40,Current,0,0,0
2024-05-19,40,DPD15-29,12,12,0
2024-05-19,40,DPD3-14,28,28,0
2024-05-19,40,DPD30-59,3,3,0
2024-05-19,40,DPD60-89,0,0,0
2024-05-19,40,DPD90+,0,0,0
2024-05-19,42,Current,0,0,0
2024-05-19,42,DPD15-29,11,11,0
2024-05-19,42,DPD3-14,30,30,0
2024-05-19,42,DPD30-59,3,3,0
2024-05-19,42,DPD60-89,0,0,0
2024-05-19,42,DPD90+,0,0,0
2024-05-19,44,Current,0,0,0
2024-05-19,44,DPD15-29,33,33,0
2024-05-19,44,DPD3-14,62,62,0
2024-05-19,44,DPD30-59,7,7,0
2024-05-19,44,DPD60-89,0,0,0
2024-05-19,44,DPD90+,0,0,0
2024-05-19,46,Current,0,0,0
2024-05-19,46,DPD3-14,0,0,0
2024-05-19,48,Current,136,136,0
2024-05-19,48,DPD15-29,6,6,0
2024-05-19,48,DPD3-14,41,41,0
2024-05-19,48,DPD30-59,3,3,0
2024-05-19,48,DPD60-89,0,0,0
2024-05-19,48,DPD90+,0,0,0
2024-05-19,6,Current,0,0,0
2024-05-19,6,DPD60-89,0,0,0
2024-05-18,100,Current,0,0,0
2024-05-18,100,DPD15-29,0,0,0
2024-05-18,102,Current,0,0,0
2024-05-18,102,DPD3-14,0,0,0
2024-05-18,102,DPD30-59,1,1,0
2024-05-18,104,Current,0,0,0
2024-05-18,104,DPD15-29,0,0,0
2024-05-18,104,DPD3-14,0,0,0
2024-05-18,104,DPD90+,0,0,0
2024-05-18,20,Current,0,0,0
2024-05-18,20,DPD15-29,198,198,0
2024-05-18,20,DPD3-14,217,217,0
2024-05-18,20,DPD30-59,133,133,0
2024-05-18,20,DPD60-89,45,45,0
2024-05-18,20,DPD90+,47,47,0
2024-05-18,22,Current,0,0,0
2024-05-18,22,DPD15-29,1,1,0
2024-05-18,22,DPD3-14,0,0,0
2024-05-18,22,DPD30-59,1,1,0
2024-05-18,22,DPD90+,0,0,0
2024-05-18,24,Current,72,72,0
2024-05-18,24,DPD15-29,87,87,0
2024-05-18,24,DPD3-14,149,149,0
2024-05-18,24,DPD30-59,67,67,0
2024-05-18,24,DPD60-89,0,0,0
2024-05-18,24,DPD90+,0,0,0
2024-05-18,26,Current,0,0,0
2024-05-18,26,DPD15-29,14,14,0
2024-05-18,26,DPD3-14,25,25,0
2024-05-18,26,DPD30-59,10,10,0
2024-05-18,26,DPD60-89,0,0,0
2024-05-18,26,DPD90+,0,0,0
2024-05-18,32,Current,0,0,0
2024-05-18,32,DPD15-29,91,91,0
2024-05-18,32,DPD3-14,93,93,0
2024-05-18,32,DPD30-59,52,52,0
2024-05-18,32,DPD60-89,0,0,0
2024-05-18,32,DPD90+,0,0,0
2024-05-18,34,Current,0,0,0
2024-05-18,34,DPD15-29,39,39,0
2024-05-18,34,DPD3-14,55,55,0
2024-05-18,34,DPD30-59,36,36,0
2024-05-18,34,DPD60-89,0,0,0
2024-05-18,34,DPD90+,0,0,0
2024-05-18,36,Current,0,0,0
2024-05-18,36,DPD15-29,30,30,0
2024-05-18,36,DPD3-14,29,29,0
2024-05-18,36,DPD30-59,22,22,0
2024-05-18,36,DPD60-89,0,0,0
2024-05-18,36,DPD90+,0,0,0
2024-05-18,38,Current,0,0,0
2024-05-18,38,DPD15-29,25,25,0
2024-05-18,38,DPD3-14,24,24,0
2024-05-18,38,DPD30-59,10,10,0
2024-05-18,38,DPD60-89,0,0,0
2024-05-18,38,DPD90+,0,0,0
2024-05-18,40,Current,0,0,0
2024-05-18,40,DPD15-29,14,14,0
2024-05-18,40,DPD3-14,24,24,0
2024-05-18,40,DPD30-59,5,5,0
2024-05-18,40,DPD60-89,0,0,0
2024-05-18,40,DPD90+,0,0,0
2024-05-18,42,Current,0,0,0
2024-05-18,42,DPD15-29,11,11,0
2024-05-18,42,DPD3-14,14,14,0
2024-05-18,42,DPD30-59,8,8,0
2024-05-18,42,DPD60-89,0,0,0
2024-05-18,42,DPD90+,0,0,0
2024-05-18,44,Current,0,0,0
2024-05-18,44,DPD15-29,19,19,0
2024-05-18,44,DPD3-14,32,32,0
2024-05-18,44,DPD30-59,18,18,0
2024-05-18,44,DPD60-89,0,0,0
2024-05-18,44,DPD90+,0,0,0
2024-05-18,46,Current,0,0,0
2024-05-18,46,DPD3-14,0,0,0
2024-05-18,48,Current,31,31,0
2024-05-18,48,DPD15-29,14,14,0
2024-05-18,48,DPD3-14,32,32,0
2024-05-18,48,DPD30-59,8,8,0
2024-05-18,48,DPD60-89,0,0,0
2024-05-18,48,DPD90+,0,0,0
2024-05-18,6,Current,0,0,0
2024-05-18,6,DPD60-89,0,0,0
2024-05-17,100,Current,0,0,0
2024-05-17,100,DPD3-14,0,0,0
2024-05-17,102,Current,0,0,0
2024-05-17,102,DPD3-14,0,0,0
2024-05-17,102,DPD30-59,0,0,0
2024-05-17,104,Current,0,0,0
2024-05-17,104,DPD15-29,1,1,0
2024-05-17,104,DPD3-14,0,0,0
2024-05-17,104,DPD60-89,0,0,0
2024-05-17,20,Current,0,0,0
2024-05-17,20,DPD15-29,204,204,0
2024-05-17,20,DPD3-14,225,225,0
2024-05-17,20,DPD30-59,138,138,0
2024-05-17,20,DPD60-89,10,10,0
2024-05-17,20,DPD90+,2,2,0
2024-05-17,22,Current,0,0,0
2024-05-17,22,DPD15-29,0,0,0
2024-05-17,22,DPD3-14,0,0,0
2024-05-17,22,DPD30-59,0,0,0
2024-05-17,22,DPD60-89,0,0,0
2024-05-17,24,Current,121,121,0
2024-05-17,24,DPD15-29,114,114,0
2024-05-17,24,DPD3-14,137,137,0
2024-05-17,24,DPD30-59,65,65,0
2024-05-17,24,DPD60-89,0,0,0
2024-05-17,24,DPD90+,0,0,0
2024-05-17,26,Current,0,0,0
2024-05-17,26,DPD15-29,15,15,0
2024-05-17,26,DPD3-14,21,21,0
2024-05-17,26,DPD30-59,4,4,0
2024-05-17,26,DPD60-89,0,0,0
2024-05-17,26,DPD90+,0,0,0
2024-05-17,32,Current,0,0,0
2024-05-17,32,DPD15-29,98,98,0
2024-05-17,32,DPD3-14,83,83,0
2024-05-17,32,DPD30-59,59,59,0
2024-05-17,32,DPD60-89,0,0,0
2024-05-17,32,DPD90+,0,0,0
2024-05-17,34,Current,0,0,0
2024-05-17,34,DPD15-29,50,50,0
2024-05-17,34,DPD3-14,40,40,0
2024-05-17,34,DPD30-59,22,22,0
2024-05-17,34,DPD60-89,0,0,0
2024-05-17,34,DPD90+,0,0,0
2024-05-17,36,Current,0,0,0
2024-05-17,36,DPD15-29,39,39,0
2024-05-17,36,DPD3-14,31,31,0
2024-05-17,36,DPD30-59,15,15,0
2024-05-17,36,DPD60-89,0,0,0
2024-05-17,36,DPD90+,0,0,0
2024-05-17,38,Current,3,3,0
2024-05-17,38,DPD15-29,39,39,0
2024-05-17,38,DPD3-14,32,32,0
2024-05-17,38,DPD30-59,11,11,0
2024-05-17,38,DPD60-89,0,0,0
2024-05-17,38,DPD90+,0,0,0
2024-05-17,40,Current,0,0,0
2024-05-17,40,DPD15-29,16,16,0
2024-05-17,40,DPD3-14,17,17,0
2024-05-17,40,DPD30-59,12,12,0
2024-05-17,40,DPD60-89,0,0,0
2024-05-17,40,DPD90+,0,0,0
2024-05-17,42,Current,0,0,0
2024-05-17,42,DPD15-29,13,13,0
2024-05-17,42,DPD3-14,10,10,0
2024-05-17,42,DPD30-59,5,5,0
2024-05-17,42,DPD60-89,0,0,0
2024-05-17,42,DPD90+,0,0,0
2024-05-17,44,Current,0,0,0
2024-05-17,44,DPD15-29,33,33,0
2024-05-17,44,DPD3-14,37,37,0
2024-05-17,44,DPD30-59,17,17,0
2024-05-17,44,DPD60-89,0,0,0
2024-05-17,44,DPD90+,0,0,0
2024-05-17,46,Current,0,0,0
2024-05-17,46,DPD3-14,0,0,0
2024-05-17,48,Current,62,62,0
2024-05-17,48,DPD15-29,11,11,0
2024-05-17,48,DPD3-14,29,29,0
2024-05-17,48,DPD30-59,4,4,0
2024-05-17,48,DPD60-89,0,0,0
2024-05-17,48,DPD90+,0,0,0
2024-05-17,6,Current,0,0,0
2024-05-17,6,DPD60-89,0,0,0
2024-05-16,100,Current,0,0,0
2024-05-16,100,DPD3-14,1,1,0
2024-05-16,102,Current,0,0,0
2024-05-16,102,DPD3-14,0,0,0
2024-05-16,102,DPD30-59,0,0,0
2024-05-16,104,Current,0,0,0
2024-05-16,104,DPD15-29,0,0,0
2024-05-16,104,DPD3-14,0,0,0
2024-05-16,104,DPD60-89,0,0,0
2024-05-16,20,Current,0,0,0
2024-05-16,20,DPD15-29,222,222,0
2024-05-16,20,DPD3-14,228,228,0
2024-05-16,20,DPD30-59,20,20,0
2024-05-16,20,DPD60-89,64,64,0
2024-05-16,20,DPD90+,70,70,0
2024-05-16,22,Current,0,0,0
2024-05-16,22,DPD15-29,1,1,0
2024-05-16,22,DPD3-14,0,0,0
2024-05-16,22,DPD30-59,0,0,0
2024-05-16,22,DPD60-89,0,0,0
2024-05-16,24,Current,92,92,0
2024-05-16,24,DPD15-29,105,105,0
2024-05-16,24,DPD3-14,157,157,0
2024-05-16,24,DPD30-59,10,10,0
2024-05-16,24,DPD60-89,0,0,0
2024-05-16,24,DPD90+,0,0,0
2024-05-16,26,Current,0,0,0
2024-05-16,26,DPD15-29,14,14,0
2024-05-16,26,DPD3-14,25,25,0
2024-05-16,26,DPD30-59,2,2,0
2024-05-16,26,DPD60-89,0,0,0
2024-05-16,26,DPD90+,0,0,0
2024-05-16,32,Current,0,0,0
2024-05-16,32,DPD15-29,111,111,0
2024-05-16,32,DPD3-14,90,90,0
2024-05-16,32,DPD30-59,13,13,0
2024-05-16,32,DPD60-89,0,0,0
2024-05-16,32,DPD90+,0,0,0
2024-05-16,34,Current,0,0,0
2024-05-16,34,DPD15-29,45,45,0
2024-05-16,34,DPD3-14,53,53,0
2024-05-16,34,DPD30-59,5,5,0
2024-05-16,34,DPD60-89,0,0,0
2024-05-16,34,DPD90+,0,0,0
2024-05-16,36,Current,0,0,0
2024-05-16,36,DPD15-29,37,37,0
2024-05-16,36,DPD3-14,32,32,0
2024-05-16,36,DPD30-59,3,3,0
2024-05-16,36,DPD60-89,0,0,0
2024-05-16,36,DPD90+,0,0,0
2024-05-16,38,Current,0,0,0
2024-05-16,38,DPD15-29,31,31,0
2024-05-16,38,DPD3-14,26,26,0
2024-05-16,38,DPD30-59,0,0,0
2024-05-16,38,DPD60-89,0,0,0
2024-05-16,38,DPD90+,0,0,0
2024-05-16,40,Current,0,0,0
2024-05-16,40,DPD15-29,19,19,0
2024-05-16,40,DPD3-14,17,17,0
2024-05-16,40,DPD30-59,2,2,0
2024-05-16,40,DPD60-89,0,0,0
2024-05-16,40,DPD90+,0,0,0
2024-05-16,42,Current,0,0,0
2024-05-16,42,DPD15-29,11,11,0
2024-05-16,42,DPD3-14,15,15,0
2024-05-16,42,DPD30-59,1,1,0
2024-05-16,42,DPD60-89,0,0,0
2024-05-16,42,DPD90+,0,0,0
2024-05-16,44,Current,0,0,0
2024-05-16,44,DPD15-29,23,23,0
2024-05-16,44,DPD3-14,30,30,0
2024-05-16,44,DPD30-59,2,2,0
2024-05-16,44,DPD60-89,0,0,0
2024-05-16,44,DPD90+,0,0,0
2024-05-16,46,Current,0,0,0
2024-05-16,46,DPD3-14,0,0,0
2024-05-16,48,Current,30,30,0
2024-05-16,48,DPD15-29,11,11,0
2024-05-16,48,DPD3-14,29,29,0
2024-05-16,48,DPD30-59,6,6,0
2024-05-16,48,DPD60-89,0,0,0
2024-05-16,48,DPD90+,0,0,0
2024-05-16,6,Current,0,0,0
2024-05-16,6,DPD60-89,0,0,0
2024-05-15,100,Current,0,0,0
2024-05-15,100,DPD3-14,0,0,0
2024-05-15,102,Current,0,0,0
2024-05-15,102,DPD3-14,0,0,0
2024-05-15,102,DPD30-59,0,0,0
2024-05-15,104,Current,0,0,0
2024-05-15,104,DPD3-14,2,2,0
2024-05-15,104,DPD60-89,0,0,0
2024-05-15,20,Current,4880,4880,0
2024-05-15,20,DPD15-29,264,264,0
2024-05-15,20,DPD3-14,347,347,0
2024-05-15,20,DPD30-59,130,130,0
2024-05-15,20,DPD60-89,85,85,0
2024-05-15,20,DPD90+,28,28,0
2024-05-15,22,Current,0,0,0
2024-05-15,22,DPD15-29,0,0,0
2024-05-15,22,DPD3-14,0,0,0
2024-05-15,22,DPD30-59,0,0,0
2024-05-15,22,DPD60-89,0,0,0
2024-05-15,24,Current,3823,3823,0
2024-05-15,24,DPD15-29,130,130,0
2024-05-15,24,DPD3-14,204,204,0
2024-05-15,24,DPD30-59,43,43,0
2024-05-15,24,DPD60-89,17,17,0
2024-05-15,24,DPD90+,7,7,0
2024-05-15,26,Current,0,0,0
2024-05-15,26,DPD15-29,14,14,0
2024-05-15,26,DPD3-14,21,21,0
2024-05-15,26,DPD30-59,4,4,0
2024-05-15,26,DPD60-89,0,0,0
2024-05-15,26,DPD90+,0,0,0
2024-05-15,32,Current,250,250,0
2024-05-15,32,DPD15-29,99,99,0
2024-05-15,32,DPD3-14,121,121,0
2024-05-15,32,DPD30-59,58,58,0
2024-05-15,32,DPD60-89,4,4,0
2024-05-15,32,DPD90+,0,0,0
2024-05-15,34,Current,0,0,0
2024-05-15,34,DPD15-29,57,57,0
2024-05-15,34,DPD3-14,45,45,0
2024-05-15,34,DPD30-59,15,15,0
2024-05-15,34,DPD60-89,0,0,0
2024-05-15,34,DPD90+,0,0,0
2024-05-15,36,Current,271,271,0
2024-05-15,36,DPD15-29,43,43,0
2024-05-15,36,DPD3-14,39,39,0
2024-05-15,36,DPD30-59,11,11,0
2024-05-15,36,DPD60-89,3,3,0
2024-05-15,36,DPD90+,0,0,0
2024-05-15,38,Current,0,0,0
2024-05-15,38,DPD15-29,36,36,0
2024-05-15,38,DPD3-14,39,39,0
2024-05-15,38,DPD30-59,10,10,0
2024-05-15,38,DPD60-89,0,0,0
2024-05-15,38,DPD90+,0,0,0
2024-05-15,40,Current,298,298,0
2024-05-15,40,DPD15-29,17,17,0
2024-05-15,40,DPD3-14,23,23,0
2024-05-15,40,DPD30-59,11,11,0
2024-05-15,40,DPD60-89,0,0,0
2024-05-15,40,DPD90+,0,0,0
2024-05-15,42,Current,0,0,0
2024-05-15,42,DPD15-29,15,15,0
2024-05-15,42,DPD3-14,11,11,0
2024-05-15,42,DPD30-59,2,2,0
2024-05-15,42,DPD60-89,0,0,0
2024-05-15,42,DPD90+,0,0,0
2024-05-15,44,Current,185,185,0
2024-05-15,44,DPD15-29,40,40,0
2024-05-15,44,DPD3-14,44,44,0
2024-05-15,44,DPD30-59,8,8,0
2024-05-15,44,DPD60-89,1,1,0
2024-05-15,44,DPD90+,0,0,0
2024-05-15,46,Current,5,5,0
2024-05-15,46,DPD3-14,0,0,0
2024-05-15,48,Current,4307,4307,0
2024-05-15,48,DPD15-29,30,30,0
2024-05-15,48,DPD3-14,76,76,0
2024-05-15,48,DPD30-59,29,29,0
2024-05-15,48,DPD60-89,14,14,0
2024-05-15,48,DPD90+,6,6,0
2024-05-15,6,Current,1,1,0
2024-05-15,6,DPD60-89,0,0,0
2024-05-14,100,Current,0,0,0
2024-05-14,100,DPD3-14,1,1,0
2024-05-14,102,Current,0,0,0
2024-05-14,102,DPD3-14,0,0,0
2024-05-14,102,DPD30-59,1,1,0
2024-05-14,104,Current,0,0,0
2024-05-14,104,DPD3-14,1,1,0
2024-05-14,104,DPD60-89,0,0,0
2024-05-14,20,Current,0,0,0
2024-05-14,20,DPD15-29,280,280,0
2024-05-14,20,DPD3-14,220,220,0
2024-05-14,20,DPD30-59,138,138,0
2024-05-14,20,DPD60-89,23,23,0
2024-05-14,20,DPD90+,7,7,0
2024-05-14,22,Current,0,0,0
2024-05-14,22,DPD15-29,2,2,0
2024-05-14,22,DPD3-14,0,0,0
2024-05-14,22,DPD30-59,1,1,0
2024-05-14,22,DPD60-89,0,0,0
2024-05-14,24,Current,74,74,0
2024-05-14,24,DPD15-29,147,147,0
2024-05-14,24,DPD3-14,146,146,0
2024-05-14,24,DPD30-59,69,69,0
2024-05-14,24,DPD60-89,0,0,0
2024-05-14,24,DPD90+,0,0,0
2024-05-14,26,Current,0,0,0
2024-05-14,26,DPD15-29,18,18,0
2024-05-14,26,DPD3-14,21,21,0
2024-05-14,26,DPD30-59,11,11,0
2024-05-14,26,DPD60-89,0,0,0
2024-05-14,26,DPD90+,0,0,0
2024-05-14,32,Current,0,0,0
2024-05-14,32,DPD15-29,137,137,0
2024-05-14,32,DPD3-14,85,85,0
2024-05-14,32,DPD30-59,55,55,0
2024-05-14,32,DPD60-89,0,0,0
2024-05-14,32,DPD90+,0,0,0
2024-05-14,34,Current,0,0,0
2024-05-14,34,DPD15-29,54,54,0
2024-05-14,34,DPD3-14,51,51,0
2024-05-14,34,DPD30-59,36,36,0
2024-05-14,34,DPD60-89,0,0,0
2024-05-14,34,DPD90+,0,0,0
2024-05-14,36,Current,0,0,0
2024-05-14,36,DPD15-29,43,43,0
2024-05-14,36,DPD3-14,30,30,0
2024-05-14,36,DPD30-59,20,20,0
2024-05-14,36,DPD60-89,0,0,0
2024-05-14,36,DPD90+,0,0,0
2024-05-14,38,Current,0,0,0
2024-05-14,38,DPD15-29,34,34,0
2024-05-14,38,DPD3-14,24,24,0
2024-05-14,38,DPD30-59,12,12,0
2024-05-14,38,DPD60-89,0,0,0
2024-05-14,38,DPD90+,0,0,0
2024-05-14,40,Current,0,0,0
2024-05-14,40,DPD15-29,22,22,0
2024-05-14,40,DPD3-14,16,16,0
2024-05-14,40,DPD30-59,7,7,0
2024-05-14,40,DPD60-89,0,0,0
2024-05-14,40,DPD90+,0,0,0
2024-05-14,42,Current,0,0,0
2024-05-14,42,DPD15-29,13,13,0
2024-05-14,42,DPD3-14,17,17,0
2024-05-14,42,DPD30-59,7,7,0
2024-05-14,42,DPD60-89,0,0,0
2024-05-14,42,DPD90+,0,0,0
2024-05-14,44,Current,0,0,0
2024-05-14,44,DPD15-29,29,29,0
2024-05-14,44,DPD3-14,37,37,0
2024-05-14,44,DPD30-59,15,15,0
2024-05-14,44,DPD60-89,0,0,0
2024-05-14,44,DPD90+,0,0,0
2024-05-14,46,Current,0,0,0
2024-05-14,46,DPD3-14,0,0,0
2024-05-14,48,Current,17,17,0
2024-05-14,48,DPD15-29,19,19,0
2024-05-14,48,DPD3-14,32,32,0
2024-05-14,48,DPD30-59,13,13,0
2024-05-14,48,DPD60-89,0,0,0
2024-05-14,48,DPD90+,0,0,0
2024-05-14,6,Current,0,0,0
2024-05-14,6,DPD60-89,0,0,0
2024-05-13,100,Current,0,0,0
2024-05-13,100,DPD3-14,0,0,0
2024-05-13,102,Current,0,0,0
2024-05-13,102,DPD3-14,0,0,0
2024-05-13,102,DPD30-59,0,0,0
2024-05-13,104,Current,0,0,0
2024-05-13,104,DPD3-14,2,2,0
2024-05-13,104,DPD60-89,0,0,0
2024-05-13,20,Current,0,0,0
2024-05-13,20,DPD15-29,241,241,0
2024-05-13,20,DPD3-14,303,303,0
2024-05-13,20,DPD30-59,144,144,0
2024-05-13,20,DPD60-89,43,43,0
2024-05-13,20,DPD90+,36,36,0
2024-05-13,22,Current,0,0,0
2024-05-13,22,DPD15-29,0,0,0
2024-05-13,22,DPD3-14,1,1,0
2024-05-13,22,DPD30-59,0,0,0
2024-05-13,22,DPD60-89,0,0,0
2024-05-13,24,Current,103,103,0
2024-05-13,24,DPD15-29,125,125,0
2024-05-13,24,DPD3-14,171,171,0
2024-05-13,24,DPD30-59,73,73,0
2024-05-13,24,DPD60-89,0,0,0
2024-05-13,24,DPD90+,0,0,0
2024-05-13,26,Current,0,0,0
2024-05-13,26,DPD15-29,17,17,0
2024-05-13,26,DPD3-14,25,25,0
2024-05-13,26,DPD30-59,4,4,0
2024-05-13,26,DPD60-89,0,0,0
2024-05-13,26,DPD90+,0,0,0
2024-05-13,32,Current,0,0,0
2024-05-13,32,DPD15-29,119,119,0
2024-05-13,32,DPD3-14,128,128,0
2024-05-13,32,DPD30-59,69,69,0
2024-05-13,32,DPD60-89,0,0,0
2024-05-13,32,DPD90+,0,0,0
2024-05-13,34,Current,0,0,0
2024-05-13,34,DPD15-29,63,63,0
2024-05-13,34,DPD3-14,47,47,0
2024-05-13,34,DPD30-59,20,20,0
2024-05-13,34,DPD60-89,0,0,0
2024-05-13,34,DPD90+,0,0,0
2024-05-13,36,Current,0,0,0
2024-05-13,36,DPD15-29,46,46,0
2024-05-13,36,DPD3-14,38,38,0
2024-05-13,36,DPD30-59,13,13,0
2024-05-13,36,DPD60-89,0,0,0
2024-05-13,36,DPD90+,0,0,0
2024-05-13,38,Current,0,0,0
2024-05-13,38,DPD15-29,45,45,0
2024-05-13,38,DPD3-14,47,47,0
2024-05-13,38,DPD30-59,14,14,0
2024-05-13,38,DPD60-89,0,0,0
2024-05-13,38,DPD90+,0,0,0
2024-05-13,40,Current,0,0,0
2024-05-13,40,DPD15-29,18,18,0
2024-05-13,40,DPD3-14,31,31,0
2024-05-13,40,DPD30-59,19,19,0
2024-05-13,40,DPD60-89,0,0,0
2024-05-13,40,DPD90+,0,0,0
2024-05-13,42,Current,0,0,0
2024-05-13,42,DPD15-29,14,14,0
2024-05-13,42,DPD3-14,12,12,0
2024-05-13,42,DPD30-59,8,8,0
2024-05-13,42,DPD60-89,0,0,0
2024-05-13,42,DPD90+,0,0,0
2024-05-13,44,Current,0,0,0
2024-05-13,44,DPD15-29,44,44,0
2024-05-13,44,DPD3-14,55,55,0
2024-05-13,44,DPD30-59,12,12,0
2024-05-13,44,DPD60-89,0,0,0
2024-05-13,44,DPD90+,0,0,0
2024-05-13,46,Current,0,0,0
2024-05-13,46,DPD3-14,0,0,0
2024-05-13,48,Current,23,23,0
2024-05-13,48,DPD15-29,14,14,0
2024-05-13,48,DPD3-14,26,26,0
2024-05-13,48,DPD30-59,4,4,0
2024-05-13,48,DPD60-89,0,0,0
2024-05-13,48,DPD90+,0,0,0
2024-05-13,6,Current,0,0,0
2024-05-13,6,DPD60-89,0,0,0
2024-05-12,100,Current,0,0,0
2024-05-12,100,DPD3-14,1,1,0
2024-05-12,102,Current,0,0,0
2024-05-12,102,DPD3-14,0,0,0
2024-05-12,102,DPD30-59,0,0,0
2024-05-12,104,Current,0,0,0
2024-05-12,104,DPD3-14,0,0,0
2024-05-12,104,DPD60-89,0,0,0
2024-05-12,20,Current,74,74,0
2024-05-12,20,DPD15-29,211,211,0
2024-05-12,20,DPD3-14,265,265,0
2024-05-12,20,DPD30-59,91,91,0
2024-05-12,20,DPD60-89,48,48,0
2024-05-12,20,DPD90+,23,23,0
2024-05-12,22,Current,0,0,0
2024-05-12,22,DPD15-29,1,1,0
2024-05-12,22,DPD3-14,1,1,0
2024-05-12,22,DPD30-59,0,0,0
2024-05-12,22,DPD60-89,0,0,0
2024-05-12,24,Current,242,242,0
2024-05-12,24,DPD15-29,112,112,0
2024-05-12,24,DPD3-14,160,160,0
2024-05-12,24,DPD30-59,42,42,0
2024-05-12,24,DPD60-89,0,0,0
2024-05-12,24,DPD90+,0,0,0
2024-05-12,26,Current,0,0,0
2024-05-12,26,DPD15-29,11,11,0
2024-05-12,26,DPD3-14,25,25,0
2024-05-12,26,DPD30-59,7,7,0
2024-05-12,26,DPD60-89,0,0,0
2024-05-12,26,DPD90+,0,0,0
2024-05-12,32,Current,0,0,0
2024-05-12,32,DPD15-29,109,109,0
2024-05-12,32,DPD3-14,116,116,0
2024-05-12,32,DPD30-59,48,48,0
2024-05-12,32,DPD60-89,0,0,0
2024-05-12,32,DPD90+,0,0,0
2024-05-12,34,Current,0,0,0
2024-05-12,34,DPD15-29,40,40,0
2024-05-12,34,DPD3-14,56,56,0
2024-05-12,34,DPD30-59,22,22,0
2024-05-12,34,DPD60-89,0,0,0
2024-05-12,34,DPD90+,0,0,0
2024-05-12,36,Current,0,0,0
2024-05-12,36,DPD15-29,35,35,0
2024-05-12,36,DPD3-14,35,35,0
2024-05-12,36,DPD30-59,16,16,0
2024-05-12,36,DPD60-89,0,0,0
2024-05-12,36,DPD90+,0,0,0
2024-05-12,38,Current,0,0,0
2024-05-12,38,DPD15-29,21,21,0
2024-05-12,38,DPD3-14,35,35,0
2024-05-12,38,DPD30-59,15,15,0
2024-05-12,38,DPD60-89,0,0,0
2024-05-12,38,DPD90+,0,0,0
2024-05-12,40,Current,0,0,0
2024-05-12,40,DPD15-29,16,16,0
2024-05-12,40,DPD3-14,21,21,0
2024-05-12,40,DPD30-59,4,4,0
2024-05-12,40,DPD60-89,0,0,0
2024-05-12,40,DPD90+,0,0,0
2024-05-12,42,Current,0,0,0
2024-05-12,42,DPD15-29,9,9,0
2024-05-12,42,DPD3-14,18,18,0
2024-05-12,42,DPD30-59,3,3,0
2024-05-12,42,DPD60-89,0,0,0
2024-05-12,42,DPD90+,0,0,0
2024-05-12,44,Current,0,0,0
2024-05-12,44,DPD15-29,22,22,0
2024-05-12,44,DPD3-14,38,38,0
2024-05-12,44,DPD30-59,8,8,0
2024-05-12,44,DPD60-89,0,0,0
2024-05-12,44,DPD90+,0,0,0
2024-05-12,46,Current,0,0,0
2024-05-12,46,DPD3-14,0,0,0
2024-05-12,48,Current,202,202,0
2024-05-12,48,DPD15-29,17,17,0
2024-05-12,48,DPD3-14,30,30,0
2024-05-12,48,DPD30-59,9,9,0
2024-05-12,48,DPD60-89,0,0,0
2024-05-12,48,DPD90+,0,0,0
2024-05-12,6,Current,0,0,0
2024-05-12,6,DPD60-89,0,0,0
2024-05-11,100,Current,0,0,0
2024-05-11,100,DPD3-14,0,0,0
2024-05-11,102,Current,0,0,0
2024-05-11,102,DPD3-14,0,0,0
2024-05-11,102,DPD30-59,0,0,0
2024-05-11,104,Current,0,0,0
2024-05-11,104,DPD3-14,1,1,0
2024-05-11,104,DPD60-89,0,0,0
2024-05-11,20,Current,0,0,0
2024-05-11,20,DPD15-29,211,211,0
2024-05-11,20,DPD3-14,278,278,0
2024-05-11,20,DPD30-59,143,143,0
2024-05-11,20,DPD60-89,59,59,0
2024-05-11,20,DPD90+,18,18,0
2024-05-11,22,Current,0,0,0
2024-05-11,22,DPD15-29,0,0,0
2024-05-11,22,DPD3-14,0,0,0
2024-05-11,22,DPD30-59,1,1,0
2024-05-11,22,DPD60-89,0,0,0
2024-05-11,24,Current,94,94,0
2024-05-11,24,DPD15-29,111,111,0
2024-05-11,24,DPD3-14,166,166,0
2024-05-11,24,DPD30-59,68,68,0
2024-05-11,24,DPD60-89,0,0,0
2024-05-11,24,DPD90+,0,0,0
2024-05-11,26,Current,0,0,0
2024-05-11,26,DPD15-29,14,14,0
2024-05-11,26,DPD3-14,25,25,0
2024-05-11,26,DPD30-59,13,13,0
2024-05-11,26,DPD60-89,0,0,0
2024-05-11,26,DPD90+,0,0,0
2024-05-11,32,Current,0,0,0
2024-05-11,32,DPD15-29,107,107,0
2024-05-11,32,DPD3-14,114,114,0
2024-05-11,32,DPD30-59,47,47,0
2024-05-11,32,DPD60-89,0,0,0
2024-05-11,32,DPD90+,0,0,0
2024-05-11,34,Current,0,0,0
2024-05-11,34,DPD15-29,53,53,0
2024-05-11,34,DPD3-14,51,51,0
2024-05-11,34,DPD30-59,36,36,0
2024-05-11,34,DPD60-89,0,0,0
2024-05-11,34,DPD90+,0,0,0
2024-05-11,36,Current,0,0,0
2024-05-11,36,DPD15-29,40,40,0
2024-05-11,36,DPD3-14,36,36,0
2024-05-11,36,DPD30-59,18,18,0
2024-05-11,36,DPD60-89,0,0,0
2024-05-11,36,DPD90+,0,0,0
2024-05-11,38,Current,0,0,0
2024-05-11,38,DPD15-29,39,39,0
2024-05-11,38,DPD3-14,46,46,0
2024-05-11,38,DPD30-59,9,9,0
2024-05-11,38,DPD60-89,0,0,0
2024-05-11,38,DPD90+,0,0,0
2024-05-11,40,Current,0,0,0
2024-05-11,40,DPD15-29,16,16,0
2024-05-11,40,DPD3-14,24,24,0
2024-05-11,40,DPD30-59,7,7,0
2024-05-11,40,DPD60-89,0,0,0
2024-05-11,40,DPD90+,0,0,0
2024-05-11,42,Current,0,0,0
2024-05-11,42,DPD15-29,11,11,0
2024-05-11,42,DPD3-14,13,13,0
2024-05-11,42,DPD30-59,5,5,0
2024-05-11,42,DPD60-89,0,0,0
2024-05-11,42,DPD90+,0,0,0
2024-05-11,44,Current,0,0,0
2024-05-11,44,DPD15-29,36,36,0
2024-05-11,44,DPD3-14,58,58,0
2024-05-11,44,DPD30-59,12,12,0
2024-05-11,44,DPD60-89,0,0,0
2024-05-11,44,DPD90+,0,0,0
2024-05-11,46,Current,0,0,0
2024-05-11,46,DPD3-14,0,0,0
2024-05-11,48,Current,31,31,0
2024-05-11,48,DPD15-29,11,11,0
2024-05-11,48,DPD3-14,27,27,0
2024-05-11,48,DPD30-59,13,13,0
2024-05-11,48,DPD60-89,0,0,0
2024-05-11,48,DPD90+,0,0,0
2024-05-11,6,Current,0,0,0
2024-05-11,6,DPD60-89,0,0,0
2024-05-10,100,Current,0,0,0
2024-05-10,100,DPD3-14,1,1,0
2024-05-10,102,Current,0,0,0
2024-05-10,102,DPD3-14,1,1,0
2024-05-10,102,DPD30-59,0,0,0
2024-05-10,104,Current,0,0,0
2024-05-10,104,DPD3-14,0,0,0
2024-05-10,104,DPD60-89,0,0,0
2024-05-10,20,Current,0,0,0
2024-05-10,20,DPD15-29,217,217,0
2024-05-10,20,DPD3-14,266,266,0
2024-05-10,20,DPD30-59,77,77,0
2024-05-10,20,DPD60-89,28,28,0
2024-05-10,20,DPD90+,46,46,0
2024-05-10,22,Current,0,0,0
2024-05-10,22,DPD15-29,0,0,0
2024-05-10,22,DPD3-14,2,2,0
2024-05-10,22,DPD30-59,0,0,0
2024-05-10,22,DPD60-89,0,0,0
2024-05-10,24,Current,65,65,0
2024-05-10,24,DPD15-29,110,110,0
2024-05-10,24,DPD3-14,166,166,0
2024-05-10,24,DPD30-59,30,30,0
2024-05-10,24,DPD60-89,0,0,0
2024-05-10,24,DPD90+,0,0,0
2024-05-10,26,Current,0,0,0
2024-05-10,26,DPD15-29,11,11,0
2024-05-10,26,DPD3-14,21,21,0
2024-05-10,26,DPD30-59,1,1,0
2024-05-10,26,DPD60-89,0,0,0
2024-05-10,26,DPD90+,0,0,0
2024-05-10,32,Current,0,0,0
2024-05-10,32,DPD15-29,109,109,0
2024-05-10,32,DPD3-14,114,114,0
2024-05-10,32,DPD30-59,32,32,0
2024-05-10,32,DPD60-89,0,0,0
2024-05-10,32,DPD90+,0,0,0
2024-05-10,34,Current,0,0,0
2024-05-10,34,DPD15-29,40,40,0
2024-05-10,34,DPD3-14,51,51,0
2024-05-10,34,DPD30-59,12,12,0
2024-05-10,34,DPD60-89,0,0,0
2024-05-10,34,DPD90+,0,0,0
2024-05-10,36,Current,0,0,0
2024-05-10,36,DPD15-29,33,33,0
2024-05-10,36,DPD3-14,35,35,0
2024-05-10,36,DPD30-59,7,7,0
2024-05-10,36,DPD60-89,0,0,0
2024-05-10,36,DPD90+,0,0,0
2024-05-10,38,Current,0,0,0
2024-05-10,38,DPD15-29,23,23,0
2024-05-10,38,DPD3-14,31,31,0
2024-05-10,38,DPD30-59,8,8,0
2024-05-10,38,DPD60-89,0,0,0
2024-05-10,38,DPD90+,0,0,0
2024-05-10,40,Current,0,0,0
2024-05-10,40,DPD15-29,17,17,0
2024-05-10,40,DPD3-14,22,22,0
2024-05-10,40,DPD30-59,7,7,0
2024-05-10,40,DPD60-89,0,0,0
2024-05-10,40,DPD90+,0,0,0
2024-05-10,42,Current,0,0,0
2024-05-10,42,DPD15-29,9,9,0
2024-05-10,42,DPD3-14,18,18,0
2024-05-10,42,DPD30-59,5,5,0
2024-05-10,42,DPD60-89,0,0,0
2024-05-10,42,DPD90+,0,0,0
2024-05-10,44,Current,0,0,0
2024-05-10,44,DPD15-29,22,22,0
2024-05-10,44,DPD3-14,26,26,0
2024-05-10,44,DPD30-59,3,3,0
2024-05-10,44,DPD60-89,0,0,0
2024-05-10,44,DPD90+,0,0,0
2024-05-10,46,Current,0,0,0
2024-05-10,46,DPD3-14,0,0,0
2024-05-10,48,Current,63,63,0
2024-05-10,48,DPD15-29,15,15,0
2024-05-10,48,DPD3-14,23,23,0
2024-05-10,48,DPD30-59,3,3,0
2024-05-10,48,DPD60-89,0,0,0
2024-05-10,48,DPD90+,0,0,0
2024-05-10,6,Current,0,0,0
2024-05-10,6,DPD60-89,0,0,0
2024-05-09,100,Current,0,0,0
2024-05-09,100,DPD3-14,1,1,0
2024-05-09,102,Current,0,0,0
2024-05-09,102,DPD15-29,0,0,0
2024-05-09,102,DPD3-14,0,0,0
2024-05-09,102,DPD30-59,0,0,0
2024-05-09,104,Current,0,0,0
2024-05-09,104,DPD3-14,1,1,0
2024-05-09,104,DPD60-89,0,0,0
2024-05-09,20,Current,0,0,0
2024-05-09,20,DPD15-29,230,230,0
2024-05-09,20,DPD3-14,317,317,0
2024-05-09,20,DPD30-59,66,66,0
2024-05-09,20,DPD60-89,2,2,0
2024-05-09,20,DPD90+,0,0,0
2024-05-09,22,Current,0,0,0
2024-05-09,22,DPD15-29,0,0,0
2024-05-09,22,DPD3-14,0,0,0
2024-05-09,22,DPD60-89,0,0,0
2024-05-09,24,Current,39,39,0
2024-05-09,24,DPD15-29,114,114,0
2024-05-09,24,DPD3-14,167,167,0
2024-05-09,24,DPD30-59,39,39,0
2024-05-09,24,DPD60-89,0,0,0
2024-05-09,24,DPD90+,1,1,0
2024-05-09,26,Current,0,0,0
2024-05-09,26,DPD15-29,16,16,0
2024-05-09,26,DPD3-14,27,27,0
2024-05-09,26,DPD30-59,2,2,0
2024-05-09,26,DPD60-89,0,0,0
2024-05-09,26,DPD90+,0,0,0
2024-05-09,32,Current,0,0,0
2024-05-09,32,DPD15-29,118,118,0
2024-05-09,32,DPD3-14,128,128,0
2024-05-09,32,DPD30-59,31,31,0
2024-05-09,32,DPD60-89,0,0,0
2024-05-09,32,DPD90+,0,0,0
2024-05-09,34,Current,0,0,0
2024-05-09,34,DPD15-29,52,52,0
2024-05-09,34,DPD3-14,52,52,0
2024-05-09,34,DPD30-59,9,9,0
2024-05-09,34,DPD60-89,0,0,0
2024-05-09,34,DPD90+,0,0,0
2024-05-09,36,Current,0,0,0
2024-05-09,36,DPD15-29,35,35,0
2024-05-09,36,DPD3-14,38,38,0
2024-05-09,36,DPD30-59,5,5,0
2024-05-09,36,DPD60-89,0,0,0
2024-05-09,36,DPD90+,0,0,0
2024-05-09,38,Current,0,0,0
2024-05-09,38,DPD15-29,42,42,0
2024-05-09,38,DPD3-14,49,49,0
2024-05-09,38,DPD30-59,4,4,0
2024-05-09,38,DPD60-89,0,0,0
2024-05-09,38,DPD90+,0,0,0
2024-05-09,40,Current,0,0,0
2024-05-09,40,DPD15-29,15,15,0
2024-05-09,40,DPD3-14,29,29,0
2024-05-09,40,DPD30-59,5,5,0
2024-05-09,40,DPD60-89,0,0,0
2024-05-09,40,DPD90+,0,0,0
2024-05-09,42,Current,0,0,0
2024-05-09,42,DPD15-29,12,12,0
2024-05-09,42,DPD3-14,12,12,0
2024-05-09,42,DPD30-59,3,3,0
2024-05-09,42,DPD60-89,0,0,0
2024-05-09,42,DPD90+,0,0,0
2024-05-09,44,Current,0,0,0
2024-05-09,44,DPD15-29,37,37,0
2024-05-09,44,DPD3-14,46,46,0
2024-05-09,44,DPD30-59,8,8,0
2024-05-09,44,DPD60-89,0,0,0
2024-05-09,44,DPD90+,0,0,0
2024-05-09,46,Current,0,0,0
2024-05-09,48,Current,17,17,0
2024-05-09,48,DPD15-29,11,11,0
2024-05-09,48,DPD3-14,29,29,0
2024-05-09,48,DPD30-59,2,2,0
2024-05-09,48,DPD60-89,0,0,0
2024-05-09,48,DPD90+,0,0,0
2024-05-09,6,Current,0,0,0
2024-05-09,6,DPD60-89,0,0,0
2024-05-08,100,Current,0,0,0
2024-05-08,100,DPD3-14,1,1,0
2024-05-08,102,Current,0,0,0
2024-05-08,102,DPD15-29,0,0,0
2024-05-08,102,DPD30-59,0,0,0
2024-05-08,104,Current,0,0,0
2024-05-08,104,DPD15-29,1,1,0
2024-05-08,104,DPD3-14,0,0,0
2024-05-08,104,DPD60-89,0,0,0
2024-05-08,20,Current,0,0,0
2024-05-08,20,DPD15-29,226,226,0
2024-05-08,20,DPD3-14,271,271,0
2024-05-08,20,DPD30-59,93,93,0
2024-05-08,20,DPD60-89,96,96,0
2024-05-08,20,DPD90+,59,59,0
2024-05-08,22,Current,0,0,0
2024-05-08,22,DPD15-29,0,0,0
2024-05-08,22,DPD3-14,2,2,0
2024-05-08,22,DPD30-59,0,0,0
2024-05-08,22,DPD60-89,0,0,0
2024-05-08,24,Current,45,45,0
2024-05-08,24,DPD15-29,110,110,0
2024-05-08,24,DPD3-14,157,157,0
2024-05-08,24,DPD30-59,47,47,0
2024-05-08,24,DPD60-89,0,0,0
2024-05-08,24,DPD90+,0,0,0
2024-05-08,26,Current,0,0,0
2024-05-08,26,DPD15-29,11,11,0
2024-05-08,26,DPD3-14,20,20,0
2024-05-08,26,DPD30-59,8,8,0
2024-05-08,26,DPD60-89,0,0,0
2024-05-08,26,DPD90+,0,0,0
2024-05-08,32,Current,0,0,0
2024-05-08,32,DPD15-29,115,115,0
2024-05-08,32,DPD3-14,122,122,0
2024-05-08,32,DPD30-59,52,52,0
2024-05-08,32,DPD60-89,0,0,0
2024-05-08,32,DPD90+,0,0,0
2024-05-08,34,Current,0,0,0
2024-05-08,34,DPD15-29,41,41,0
2024-05-08,34,DPD3-14,53,53,0
2024-05-08,34,DPD30-59,26,26,0
2024-05-08,34,DPD60-89,0,0,0
2024-05-08,34,DPD90+,0,0,0
2024-05-08,36,Current,0,0,0
2024-05-08,36,DPD15-29,32,32,0
2024-05-08,36,DPD3-14,38,38,0
2024-05-08,36,DPD30-59,15,15,0
2024-05-08,36,DPD60-89,0,0,0
2024-05-08,36,DPD90+,0,0,0
2024-05-08,38,Current,0,0,0
2024-05-08,38,DPD15-29,21,21,0
2024-05-08,38,DPD3-14,34,34,0
2024-05-08,38,DPD30-59,17,17,0
2024-05-08,38,DPD60-89,0,0,0
2024-05-08,38,DPD90+,0,0,0
2024-05-08,40,Current,0,0,0
2024-05-08,40,DPD15-29,18,18,0
2024-05-08,40,DPD3-14,24,24,0
2024-05-08,40,DPD30-59,3,3,0
2024-05-08,40,DPD60-89,0,0,0
2024-05-08,40,DPD90+,0,0,0
2024-05-08,42,Current,0,0,0
2024-05-08,42,DPD15-29,8,8,0
2024-05-08,42,DPD3-14,18,18,0
2024-05-08,42,DPD30-59,4,4,0
2024-05-08,42,DPD60-89,0,0,0
2024-05-08,42,DPD90+,0,0,0
2024-05-08,44,Current,0,0,0
2024-05-08,44,DPD15-29,22,22,0
2024-05-08,44,DPD3-14,24,24,0
2024-05-08,44,DPD30-59,10,10,0
2024-05-08,44,DPD60-89,0,0,0
2024-05-08,44,DPD90+,0,0,0
2024-05-08,46,Current,0,0,0
2024-05-08,48,Current,15,15,0
2024-05-08,48,DPD15-29,19,19,0
2024-05-08,48,DPD3-14,20,20,0
2024-05-08,48,DPD30-59,13,13,0
2024-05-08,48,DPD60-89,0,0,0
2024-05-08,48,DPD90+,0,0,0
2024-05-08,6,Current,0,0,0
2024-05-08,6,DPD60-89,0,0,0
2024-05-07,100,Current,0,0,0
2024-05-07,100,DPD3-14,1,1,0
2024-05-07,102,Current,0,0,0
2024-05-07,102,DPD15-29,1,1,0
2024-05-07,104,Current,0,0,0
2024-05-07,104,DPD15-29,0,0,0
2024-05-07,104,DPD3-14,1,1,0
2024-05-07,104,DPD60-89,0,0,0
2024-05-07,20,Current,0,0,0
2024-05-07,20,DPD15-29,243,243,0
2024-05-07,20,DPD3-14,328,328,0
2024-05-07,20,DPD30-59,159,159,0
2024-05-07,20,DPD60-89,37,37,0
2024-05-07,20,DPD90+,13,13,0
2024-05-07,22,Current,0,0,0
2024-05-07,22,DPD15-29,0,0,0
2024-05-07,22,DPD3-14,0,0,0
2024-05-07,22,DPD30-59,0,0,0
2024-05-07,22,DPD60-89,0,0,0
2024-05-07,24,Current,51,51,0
2024-05-07,24,DPD15-29,113,113,0
2024-05-07,24,DPD3-14,198,198,0
2024-05-07,24,DPD30-59,84,84,0
2024-05-07,24,DPD60-89,0,0,0
2024-05-07,24,DPD90+,0,0,0
2024-05-07,26,Current,0,0,0
2024-05-07,26,DPD15-29,16,16,0
2024-05-07,26,DPD3-14,34,34,0
2024-05-07,26,DPD30-59,13,13,0
2024-05-07,26,DPD60-89,0,0,0
2024-05-07,26,DPD90+,0,0,0
2024-05-07,32,Current,0,0,0
2024-05-07,32,DPD15-29,122,122,0
2024-05-07,32,DPD3-14,161,161,0
2024-05-07,32,DPD30-59,68,68,0
2024-05-07,32,DPD60-89,0,0,0
2024-05-07,32,DPD90+,0,0,0
2024-05-07,34,Current,0,0,0
2024-05-07,34,DPD15-29,46,46,0
2024-05-07,34,DPD3-14,64,64,0
2024-05-07,34,DPD30-59,43,43,0
2024-05-07,34,DPD60-89,0,0,0
2024-05-07,34,DPD90+,0,0,0
2024-05-07,36,Current,0,0,0
2024-05-07,36,DPD15-29,36,36,0
2024-05-07,36,DPD3-14,43,43,0
2024-05-07,36,DPD30-59,21,21,0
2024-05-07,36,DPD60-89,0,0,0
2024-05-07,36,DPD90+,0,0,0
2024-05-07,38,Current,0,0,0
2024-05-07,38,DPD15-29,42,42,0
2024-05-07,38,DPD3-14,57,57,0
2024-05-07,38,DPD30-59,17,17,0
2024-05-07,38,DPD60-89,0,0,0
2024-05-07,38,DPD90+,0,0,0
2024-05-07,40,Current,0,0,0
2024-05-07,40,DPD15-29,13,13,0
2024-05-07,40,DPD3-14,33,33,0
2024-05-07,40,DPD30-59,13,13,0
2024-05-07,40,DPD60-89,0,0,0
2024-05-07,40,DPD90+,0,0,0
2024-05-07,42,Current,0,0,0
2024-05-07,42,DPD15-29,11,11,0
2024-05-07,42,DPD3-14,14,14,0
2024-05-07,42,DPD30-59,5,5,0
2024-05-07,42,DPD60-89,0,0,0
2024-05-07,42,DPD90+,0,0,0
2024-05-07,44,Current,0,0,0
2024-05-07,44,DPD15-29,32,32,0
2024-05-07,44,DPD3-14,62,62,0
2024-05-07,44,DPD30-59,13,13,0
2024-05-07,44,DPD60-89,0,0,0
2024-05-07,44,DPD90+,0,0,0
2024-05-07,46,Current,0,0,0
2024-05-07,48,Current,31,31,0
2024-05-07,48,DPD15-29,16,16,0
2024-05-07,48,DPD3-14,29,29,0
2024-05-07,48,DPD30-59,16,16,0
2024-05-07,48,DPD60-89,0,0,0
2024-05-07,48,DPD90+,0,0,0
2024-05-07,6,Current,0,0,0
2024-05-07,6,DPD60-89,0,0,0
2024-05-06,100,Current,0,0,0
2024-05-06,100,DPD3-14,0,0,0
2024-05-06,102,Current,0,0,0
2024-05-06,102,DPD15-29,0,0,0
2024-05-06,102,DPD3-14,0,0,0
2024-05-06,104,Current,0,0,0
2024-05-06,104,DPD15-29,1,1,0
2024-05-06,104,DPD3-14,0,0,0
2024-05-06,104,DPD60-89,0,0,0
2024-05-06,20,Current,1,1,0
2024-05-06,20,DPD15-29,222,222,0
2024-05-06,20,DPD3-14,357,357,0
2024-05-06,20,DPD30-59,64,64,0
2024-05-06,20,DPD60-89,9,9,0
2024-05-06,20,DPD90+,0,0,0
2024-05-06,22,Current,0,0,0
2024-05-06,22,DPD15-29,0,0,0
2024-05-06,22,DPD3-14,2,2,0
2024-05-06,22,DPD30-59,0,0,0
2024-05-06,22,DPD60-89,0,0,0
2024-05-06,24,Current,69,69,0
2024-05-06,24,DPD15-29,109,109,0
2024-05-06,24,DPD3-14,187,187,0
2024-05-06,24,DPD30-59,27,27,0
2024-05-06,24,DPD60-89,0,0,0
2024-05-06,24,DPD90+,0,0,0
2024-05-06,26,Current,0,0,0
2024-05-06,26,DPD15-29,12,12,0
2024-05-06,26,DPD3-14,22,22,0
2024-05-06,26,DPD30-59,2,2,0
2024-05-06,26,DPD60-89,0,0,0
2024-05-06,26,DPD90+,0,0,0
2024-05-06,32,Current,0,0,0
2024-05-06,32,DPD15-29,118,118,0
2024-05-06,32,DPD3-14,166,166,0
2024-05-06,32,DPD30-59,23,23,0
2024-05-06,32,DPD60-89,0,0,0
2024-05-06,32,DPD90+,0,0,0
2024-05-06,34,Current,0,0,0
2024-05-06,34,DPD15-29,43,43,0
2024-05-06,34,DPD3-14,64,64,0
2024-05-06,34,DPD30-59,11,11,0
2024-05-06,34,DPD60-89,0,0,0
2024-05-06,34,DPD90+,0,0,0
2024-05-06,36,Current,0,0,0
2024-05-06,36,DPD15-29,35,35,0
2024-05-06,36,DPD3-14,53,53,0
2024-05-06,36,DPD30-59,3,3,0
2024-05-06,36,DPD60-89,0,0,0
2024-05-06,36,DPD90+,0,0,0
2024-05-06,38,Current,0,0,0
2024-05-06,38,DPD15-29,23,23,0
2024-05-06,38,DPD3-14,47,47,0
2024-05-06,38,DPD30-59,4,4,0
2024-05-06,38,DPD60-89,0,0,0
2024-05-06,38,DPD90+,0,0,0
2024-05-06,40,Current,0,0,0
2024-05-06,40,DPD15-29,23,23,0
2024-05-06,40,DPD3-14,29,29,0
2024-05-06,40,DPD30-59,7,7,0
2024-05-06,40,DPD60-89,0,0,0
2024-05-06,40,DPD90+,0,0,0
2024-05-06,42,Current,0,0,0
2024-05-06,42,DPD15-29,6,6,0
2024-05-06,42,DPD3-14,21,21,0
2024-05-06,42,DPD30-59,6,6,0
2024-05-06,42,DPD60-89,0,0,0
2024-05-06,42,DPD90+,0,0,0
2024-05-06,44,Current,0,0,0
2024-05-06,44,DPD15-29,27,27,0
2024-05-06,44,DPD3-14,37,37,0
2024-05-06,44,DPD30-59,1,1,0
2024-05-06,44,DPD60-89,0,0,0
2024-05-06,44,DPD90+,0,0,0
2024-05-06,46,Current,0,0,0
2024-05-06,48,Current,37,37,0
2024-05-06,48,DPD15-29,5,5,0
2024-05-06,48,DPD3-14,19,19,0
2024-05-06,48,DPD30-59,5,5,0
2024-05-06,48,DPD60-89,0,0,0
2024-05-06,48,DPD90+,0,0,0
2024-05-06,6,Current,0,0,0
2024-05-06,6,DPD30-59,0,0,0
2024-05-06,6,DPD60-89,0,0,0
2024-05-05,100,Current,0,0,0
2024-05-05,102,Current,0,0,0
2024-05-05,102,DPD15-29,1,1,0
2024-05-05,102,DPD3-14,0,0,0
2024-05-05,104,Current,0,0,0
2024-05-05,104,DPD15-29,0,0,0
2024-05-05,104,DPD3-14,1,1,0
2024-05-05,104,DPD60-89,0,0,0
2024-05-05,20,Current,172,172,0
2024-05-05,20,DPD15-29,210,210,0
2024-05-05,20,DPD3-14,360,360,0
2024-05-05,20,DPD30-59,70,70,0
2024-05-05,20,DPD60-89,42,42,0
2024-05-05,20,DPD90+,38,38,0
2024-05-05,22,Current,0,0,0
2024-05-05,22,DPD3-14,0,0,0
2024-05-05,22,DPD30-59,0,0,0
2024-05-05,22,DPD60-89,0,0,0
2024-05-05,24,Current,354,354,0
2024-05-05,24,DPD15-29,101,101,0
2024-05-05,24,DPD3-14,194,194,0
2024-05-05,24,DPD30-59,34,34,0
2024-05-05,24,DPD60-89,0,0,0
2024-05-05,24,DPD90+,0,0,0
2024-05-05,26,Current,0,0,0
2024-05-05,26,DPD15-29,13,13,0
2024-05-05,26,DPD3-14,35,35,0
2024-05-05,26,DPD30-59,1,1,0
2024-05-05,26,DPD60-89,0,0,0
2024-05-05,26,DPD90+,0,0,0
2024-05-05,32,Current,0,0,0
2024-05-05,32,DPD15-29,116,116,0
2024-05-05,32,DPD3-14,166,166,0
2024-05-05,32,DPD30-59,33,33,0
2024-05-05,32,DPD60-89,0,0,0
2024-05-05,32,DPD90+,0,0,0
2024-05-05,34,Current,0,0,0
2024-05-05,34,DPD15-29,46,46,0
2024-05-05,34,DPD3-14,67,67,0
2024-05-05,34,DPD30-59,13,13,0
2024-05-05,34,DPD60-89,0,0,0
2024-05-05,34,DPD90+,0,0,0
2024-05-05,36,Current,0,0,0
2024-05-05,36,DPD15-29,30,30,0
2024-05-05,36,DPD3-14,52,52,0
2024-05-05,36,DPD30-59,8,8,0
2024-05-05,36,DPD60-89,0,0,0
2024-05-05,36,DPD90+,0,0,0
2024-05-05,38,Current,0,0,0
2024-05-05,38,DPD15-29,33,33,0
2024-05-05,38,DPD3-14,67,67,0
2024-05-05,38,DPD30-59,3,3,0
2024-05-05,38,DPD60-89,0,0,0
2024-05-05,38,DPD90+,0,0,0
2024-05-05,40,Current,0,0,0
2024-05-05,40,DPD15-29,15,15,0
2024-05-05,40,DPD3-14,37,37,0
2024-05-05,40,DPD30-59,8,8,0
2024-05-05,40,DPD60-89,0,0,0
2024-05-05,40,DPD90+,0,0,0
2024-05-05,42,Current,0,0,0
2024-05-05,42,DPD15-29,10,10,0
2024-05-05,42,DPD3-14,11,11,0
2024-05-05,42,DPD30-59,2,2,0
2024-05-05,42,DPD60-89,0,0,0
2024-05-05,42,DPD90+,0,0,0
2024-05-05,44,Current,0,0,0
2024-05-05,44,DPD15-29,33,33,0
2024-05-05,44,DPD3-14,58,58,0
2024-05-05,44,DPD30-59,8,8,0
2024-05-05,44,DPD60-89,0,0,0
2024-05-05,44,DPD90+,0,0,0
2024-05-05,46,Current,0,0,0
2024-05-05,48,Current,339,339,0
2024-05-05,48,DPD15-29,11,11,0
2024-05-05,48,DPD3-14,29,29,0
2024-05-05,48,DPD30-59,1,1,0
2024-05-05,48,DPD60-89,0,0,0
2024-05-05,48,DPD90+,0,0,0
2024-05-05,6,Current,0,0,0
2024-05-05,6,DPD30-59,1,1,0
2024-05-05,6,DPD60-89,0,0,0
2024-05-04,100,Current,0,0,0
2024-05-04,102,Current,0,0,0
2024-05-04,102,DPD15-29,0,0,0
2024-05-04,102,DPD3-14,0,0,0
2024-05-04,104,Current,0,0,0
2024-05-04,104,DPD15-29,1,1,0
2024-05-04,104,DPD3-14,0,0,0
2024-05-04,104,DPD60-89,0,0,0
2024-05-04,20,Current,0,0,0
2024-05-04,20,DPD15-29,184,184,0
2024-05-04,20,DPD3-14,338,338,0
2024-05-04,20,DPD30-59,102,102,0
2024-05-04,20,DPD60-89,54,54,0
2024-05-04,20,DPD90+,17,17,0
2024-05-04,22,Current,0,0,0
2024-05-04,22,DPD3-14,2,2,0
2024-05-04,22,DPD30-59,0,0,0
2024-05-04,22,DPD60-89,0,0,0
2024-05-04,24,Current,57,57,0
2024-05-04,24,DPD15-29,83,83,0
2024-05-04,24,DPD3-14,193,193,0
2024-05-04,24,DPD30-59,50,50,0
2024-05-04,24,DPD60-89,0,0,0
2024-05-04,24,DPD90+,0,0,0
2024-05-04,26,Current,0,0,0
2024-05-04,26,DPD15-29,8,8,0
2024-05-04,26,DPD3-14,23,23,0
2024-05-04,26,DPD30-59,6,6,0
2024-05-04,26,DPD60-89,0,0,0
2024-05-04,26,DPD90+,0,0,0
2024-05-04,32,Current,0,0,0
2024-05-04,32,DPD15-29,91,91,0
2024-05-04,32,DPD3-14,171,171,0
2024-05-04,32,DPD30-59,43,43,0
2024-05-04,32,DPD60-89,0,0,0
2024-05-04,32,DPD90+,0,0,0
2024-05-04,34,Current,0,0,0
2024-05-04,34,DPD15-29,30,30,0
2024-05-04,34,DPD3-14,65,65,0
2024-05-04,34,DPD30-59,23,23,0
2024-05-04,34,DPD60-89,0,0,0
2024-05-04,34,DPD90+,0,0,0
2024-05-04,36,Current,0,0,0
2024-05-04,36,DPD15-29,23,23,0
2024-05-04,36,DPD3-14,57,57,0
2024-05-04,36,DPD30-59,13,13,0
2024-05-04,36,DPD60-89,0,0,0
2024-05-04,36,DPD90+,0,0,0
2024-05-04,38,Current,0,0,0
2024-05-04,38,DPD15-29,15,15,0
2024-05-04,38,DPD3-14,49,49,0
2024-05-04,38,DPD30-59,16,16,0
2024-05-04,38,DPD60-89,0,0,0
2024-05-04,38,DPD90+,0,0,0
2024-05-04,40,Current,0,0,0
2024-05-04,40,DPD15-29,19,19,0
2024-05-04,40,DPD3-14,31,31,0
2024-05-04,40,DPD30-59,3,3,0
2024-05-04,40,DPD60-89,0,0,0
2024-05-04,40,DPD90+,0,0,0
2024-05-04,42,Current,0,0,0
2024-05-04,42,DPD15-29,7,7,0
2024-05-04,42,DPD3-14,18,18,0
2024-05-04,42,DPD30-59,4,4,0
2024-05-04,42,DPD60-89,0,0,0
2024-05-04,42,DPD90+,0,0,0
2024-05-04,44,Current,0,0,0
2024-05-04,44,DPD15-29,21,21,0
2024-05-04,44,DPD3-14,35,35,0
2024-05-04,44,DPD30-59,9,9,0
2024-05-04,44,DPD60-89,0,0,0
2024-05-04,44,DPD90+,0,0,0
2024-05-04,46,Current,0,0,0
2024-05-04,48,Current,27,27,0
2024-05-04,48,DPD15-29,6,6,0
2024-05-04,48,DPD3-14,13,13,0
2024-05-04,48,DPD30-59,10,10,0
2024-05-04,48,DPD60-89,0,0,0
2024-05-04,48,DPD90+,0,0,0
2024-05-04,6,Current,0,0,0
2024-05-04,6,DPD30-59,0,0,0
2024-05-04,6,DPD60-89,0,0,0
2024-05-03,100,Current,0,0,0
2024-05-03,102,Current,0,0,0
2024-05-03,102,DPD15-29,1,1,0
2024-05-03,102,DPD3-14,0,0,0
2024-05-03,104,Current,0,0,0
2024-05-03,104,DPD15-29,0,0,0
2024-05-03,104,DPD60-89,0,0,0
2024-05-03,20,Current,0,0,0
2024-05-03,20,DPD15-29,218,218,0
2024-05-03,20,DPD3-14,259,259,0
2024-05-03,20,DPD30-59,163,163,0
2024-05-03,20,DPD60-89,56,56,0
2024-05-03,20,DPD90+,18,18,0
2024-05-03,22,Current,0,0,0
2024-05-03,22,DPD15-29,0,0,0
2024-05-03,22,DPD3-14,0,0,0
2024-05-03,22,DPD30-59,0,0,0
2024-05-03,22,DPD60-89,0,0,0
2024-05-03,24,Current,84,84,0
2024-05-03,24,DPD15-29,100,100,0
2024-05-03,24,DPD3-14,137,137,0
2024-05-03,24,DPD30-59,88,88,0
2024-05-03,24,DPD60-89,0,0,0
2024-05-03,24,DPD90+,0,0,0
2024-05-03,26,Current,0,0,0
2024-05-03,26,DPD15-29,12,12,0
2024-05-03,26,DPD3-14,23,23,0
2024-05-03,26,DPD30-59,13,13,0
2024-05-03,26,DPD60-89,0,0,0
2024-05-03,26,DPD90+,0,0,0
2024-05-03,32,Current,0,0,0
2024-05-03,32,DPD15-29,124,124,0
2024-05-03,32,DPD3-14,120,120,0
2024-05-03,32,DPD30-59,65,65,0
2024-05-03,32,DPD60-89,0,0,0
2024-05-03,32,DPD90+,0,0,0
2024-05-03,34,Current,0,0,0
2024-05-03,34,DPD15-29,47,47,0
2024-05-03,34,DPD3-14,61,61,0
2024-05-03,34,DPD30-59,47,47,0
2024-05-03,34,DPD60-89,0,0,0
2024-05-03,34,DPD90+,0,0,0
2024-05-03,36,Current,0,0,0
2024-05-03,36,DPD15-29,28,28,0
2024-05-03,36,DPD3-14,41,41,0
2024-05-03,36,DPD30-59,24,24,0
2024-05-03,36,DPD60-89,0,0,0
2024-05-03,36,DPD90+,0,0,0
2024-05-03,38,Current,0,0,0
2024-05-03,38,DPD15-29,31,31,0
2024-05-03,38,DPD3-14,51,51,0
2024-05-03,38,DPD30-59,16,16,0
2024-05-03,38,DPD60-89,0,0,0
2024-05-03,38,DPD90+,0,0,0
2024-05-03,40,Current,0,0,0
2024-05-03,40,DPD15-29,16,16,0
2024-05-03,40,DPD3-14,26,26,0
2024-05-03,40,DPD30-59,13,13,0
2024-05-03,40,DPD60-89,0,0,0
2024-05-03,40,DPD90+,0,0,0
2024-05-03,42,Current,0,0,0
2024-05-03,42,DPD15-29,8,8,0
2024-05-03,42,DPD3-14,9,9,0
2024-05-03,42,DPD30-59,6,6,0
2024-05-03,42,DPD60-89,0,0,0
2024-05-03,42,DPD90+,0,0,0
2024-05-03,44,Current,0,0,0
2024-05-03,44,DPD15-29,28,28,0
2024-05-03,44,DPD3-14,40,40,0
2024-05-03,44,DPD30-59,12,12,0
2024-05-03,44,DPD60-89,0,0,0
2024-05-03,44,DPD90+,0,0,0
2024-05-03,46,Current,0,0,0
2024-05-03,48,Current,48,48,0
2024-05-03,48,DPD15-29,15,15,0
2024-05-03,48,DPD3-14,22,22,0
2024-05-03,48,DPD30-59,15,15,0
2024-05-03,48,DPD60-89,0,0,0
2024-05-03,48,DPD90+,0,0,0
2024-05-03,6,Current,0,0,0
2024-05-03,6,DPD30-59,0,0,0
2024-05-03,6,DPD60-89,0,0,0
2024-05-02,100,Current,0,0,0
2024-05-02,102,Current,0,0,0
2024-05-02,102,DPD15-29,0,0,0
2024-05-02,102,DPD3-14,0,0,0
2024-05-02,104,Current,0,0,0
2024-05-02,104,DPD3-14,1,1,0
2024-05-02,104,DPD60-89,0,0,0
2024-05-02,20,Current,0,0,0
2024-05-02,20,DPD15-29,180,180,0
2024-05-02,20,DPD3-14,466,466,0
2024-05-02,20,DPD30-59,122,122,0
2024-05-02,20,DPD60-89,30,30,0
2024-05-02,20,DPD90+,50,50,0
2024-05-02,22,Current,0,0,0
2024-05-02,22,DPD15-29,0,0,0
2024-05-02,22,DPD3-14,3,3,0
2024-05-02,22,DPD30-59,0,0,0
2024-05-02,22,DPD60-89,0,0,0
2024-05-02,24,Current,37,37,0
2024-05-02,24,DPD15-29,92,92,0
2024-05-02,24,DPD3-14,272,272,0
2024-05-02,24,DPD30-59,50,50,0
2024-05-02,24,DPD60-89,0,0,0
2024-05-02,24,DPD90+,0,0,0
2024-05-02,26,Current,0,0,0
2024-05-02,26,DPD15-29,9,9,0
2024-05-02,26,DPD3-14,35,35,0
2024-05-02,26,DPD30-59,3,3,0
2024-05-02,26,DPD60-89,0,0,0
2024-05-02,26,DPD90+,0,0,0
2024-05-02,32,Current,0,0,0
2024-05-02,32,DPD15-29,93,93,0
2024-05-02,32,DPD3-14,221,221,0
2024-05-02,32,DPD30-59,60,60,0
2024-05-02,32,DPD60-89,0,0,0
2024-05-02,32,DPD90+,0,0,0
2024-05-02,34,Current,0,0,0
2024-05-02,34,DPD15-29,29,29,0
2024-05-02,34,DPD3-14,86,86,0
2024-05-02,34,DPD30-59,27,27,0
2024-05-02,34,DPD60-89,0,0,0
2024-05-02,34,DPD90+,0,0,0
2024-05-02,36,Current,0,0,0
2024-05-02,36,DPD15-29,19,19,0
2024-05-02,36,DPD3-14,75,75,0
2024-05-02,36,DPD30-59,7,7,0
2024-05-02,36,DPD60-89,0,0,0
2024-05-02,36,DPD90+,0,0,0
2024-05-02,38,Current,0,0,0
2024-05-02,38,DPD15-29,15,15,0
2024-05-02,38,DPD3-14,59,59,0
2024-05-02,38,DPD30-59,7,7,0
2024-05-02,38,DPD60-89,0,0,0
2024-05-02,38,DPD90+,0,0,0
2024-05-02,40,Current,0,0,0
2024-05-02,40,DPD15-29,25,25,0
2024-05-02,40,DPD3-14,38,38,0
2024-05-02,40,DPD30-59,13,13,0
2024-05-02,40,DPD60-89,0,0,0
2024-05-02,40,DPD90+,0,0,0
2024-05-02,42,Current,0,0,0
2024-05-02,42,DPD15-29,7,7,0
2024-05-02,42,DPD3-14,26,26,0
2024-05-02,42,DPD30-59,8,8,0
2024-05-02,42,DPD60-89,0,0,0
2024-05-02,42,DPD90+,0,0,0
2024-05-02,44,Current,0,0,0
2024-05-02,44,DPD15-29,20,20,0
2024-05-02,44,DPD3-14,48,48,0
2024-05-02,44,DPD30-59,7,7,0
2024-05-02,44,DPD60-89,0,0,0
2024-05-02,44,DPD90+,0,0,0
2024-05-02,46,Current,0,0,0
2024-05-02,48,Current,8,8,0
2024-05-02,48,DPD15-29,15,15,0
2024-05-02,48,DPD3-14,27,27,0
2024-05-02,48,DPD30-59,6,6,0
2024-05-02,48,DPD60-89,0,0,0
2024-05-02,48,DPD90+,0,0,0
2024-05-02,6,Current,0,0,0
2024-05-02,6,DPD30-59,1,1,0
2024-05-02,6,DPD60-89,0,0,0
2024-05-01,100,Current,0,0,0
2024-05-01,102,Current,0,0,0
2024-05-01,102,DPD15-29,1,1,0
2024-05-01,102,DPD3-14,0,0,0
2024-05-01,104,Current,0,0,0
2024-05-01,104,DPD3-14,0,0,0
2024-05-01,104,DPD60-89,0,0,0
2024-05-01,20,Current,4950,4950,0
2024-05-01,20,DPD15-29,293,293,0
2024-05-01,20,DPD3-14,401,401,0
2024-05-01,20,DPD30-59,157,157,0
2024-05-01,20,DPD60-89,62,62,0
2024-05-01,20,DPD90+,27,27,0
2024-05-01,22,Current,0,0,0
2024-05-01,22,DPD15-29,0,0,0
2024-05-01,22,DPD3-14,0,0,0
2024-05-01,22,DPD30-59,0,0,0
2024-05-01,22,DPD60-89,0,0,0
2024-05-01,24,Current,3794,3794,0
2024-05-01,24,DPD15-29,130,130,0
2024-05-01,24,DPD3-14,243,243,0
2024-05-01,24,DPD30-59,67,67,0
2024-05-01,24,DPD60-89,17,17,0
2024-05-01,24,DPD90+,8,8,0
2024-05-01,26,Current,0,0,0
2024-05-01,26,DPD15-29,15,15,0
2024-05-01,26,DPD3-14,26,26,0
2024-05-01,26,DPD30-59,6,6,0
2024-05-01,26,DPD60-89,0,0,0
2024-05-01,26,DPD90+,0,0,0
2024-05-01,32,Current,254,254,0
2024-05-01,32,DPD15-29,138,138,0
2024-05-01,32,DPD3-14,169,169,0
2024-05-01,32,DPD30-59,44,44,0
2024-05-01,32,DPD60-89,3,3,0
2024-05-01,32,DPD90+,1,1,0
2024-05-01,34,Current,0,0,0
2024-05-01,34,DPD15-29,47,47,0
2024-05-01,34,DPD3-14,67,67,0
2024-05-01,34,DPD30-59,22,22,0
2024-05-01,34,DPD60-89,0,0,0
2024-05-01,34,DPD90+,0,0,0
2024-05-01,36,Current,278,278,0
2024-05-01,36,DPD15-29,33,33,0
2024-05-01,36,DPD3-14,55,55,0
2024-05-01,36,DPD30-59,15,15,0
2024-05-01,36,DPD60-89,2,2,0
2024-05-01,36,DPD90+,2,2,0
2024-05-01,38,Current,0,0,0
2024-05-01,38,DPD15-29,38,38,0
2024-05-01,38,DPD3-14,70,70,0
2024-05-01,38,DPD30-59,17,17,0
2024-05-01,38,DPD60-89,0,0,0
2024-05-01,38,DPD90+,0,0,0
2024-05-01,40,Current,300,300,0
2024-05-01,40,DPD15-29,24,24,0
2024-05-01,40,DPD3-14,37,37,0
2024-05-01,40,DPD30-59,4,4,0
2024-05-01,40,DPD60-89,1,1,0
2024-05-01,40,DPD90+,0,0,0
2024-05-01,42,Current,0,0,0
2024-05-01,42,DPD15-29,7,7,0
2024-05-01,42,DPD3-14,10,10,0
2024-05-01,42,DPD30-59,5,5,0
2024-05-01,42,DPD60-89,0,0,0
2024-05-01,42,DPD90+,0,0,0
2024-05-01,44,Current,188,188,0
2024-05-01,44,DPD15-29,27,27,0
2024-05-01,44,DPD3-14,60,60,0
2024-05-01,44,DPD30-59,9,9,0
2024-05-01,44,DPD60-89,2,2,0
2024-05-01,44,DPD90+,1,1,0
2024-05-01,46,Current,5,5,0
2024-05-01,46,DPD15-29,1,1,0
2024-05-01,48,Current,4271,4271,0
2024-05-01,48,DPD15-29,46,46,0
2024-05-01,48,DPD3-14,64,64,0
2024-05-01,48,DPD30-59,28,28,0
2024-05-01,48,DPD60-89,17,17,0
2024-05-01,48,DPD90+,10,10,0
2024-05-01,6,Current,2,2,0
2024-05-01,6,DPD3-14,1,1,0
2024-05-01,6,DPD30-59,1,1,0
2024-05-01,6,DPD60-89,0,0,0
2024-04-30,100,Current,0,0,0
2024-04-30,102,Current,0,0,0
2024-04-30,102,DPD15-29,0,0,0
2024-04-30,102,DPD3-14,0,0,0
2024-04-30,104,Current,0,0,0
2024-04-30,104,DPD3-14,1,1,0
2024-04-30,104,DPD60-89,0,0,0
2024-04-30,20,Current,0,0,0
2024-04-30,20,DPD15-29,164,164,0
2024-04-30,20,DPD3-14,366,366,0
2024-04-30,20,DPD30-59,74,74,0
2024-04-30,20,DPD60-89,90,90,0
2024-04-30,20,DPD90+,48,48,0
2024-04-30,22,Current,0,0,0
2024-04-30,22,DPD15-29,0,0,0
2024-04-30,22,DPD3-14,2,2,0
2024-04-30,22,DPD30-59,0,0,0
2024-04-30,22,DPD60-89,0,0,0
2024-04-30,24,Current,72,72,0
2024-04-30,24,DPD15-29,83,83,0
2024-04-30,24,DPD3-14,210,210,0
2024-04-30,24,DPD30-59,40,40,0
2024-04-30,24,DPD60-89,0,0,0
2024-04-30,24,DPD90+,0,0,0
2024-04-30,26,Current,0,0,0
2024-04-30,26,DPD15-29,9,9,0
2024-04-30,26,DPD3-14,21,21,0
2024-04-30,26,DPD30-59,4,4,0
2024-04-30,26,DPD60-89,0,0,0
2024-04-30,26,DPD90+,0,0,0
2024-04-30,32,Current,0,0,0
2024-04-30,32,DPD15-29,78,78,0
2024-04-30,32,DPD3-14,174,174,0
2024-04-30,32,DPD30-59,38,38,0
2024-04-30,32,DPD60-89,0,0,0
2024-04-30,32,DPD90+,0,0,0
2024-04-30,34,Current,0,0,0
2024-04-30,34,DPD15-29,25,25,0
2024-04-30,34,DPD3-14,62,62,0
2024-04-30,34,DPD30-59,19,19,0
2024-04-30,34,DPD60-89,0,0,0
2024-04-30,34,DPD90+,0,0,0
2024-04-30,36,Current,0,0,0
2024-04-30,36,DPD15-29,16,16,0
2024-04-30,36,DPD3-14,59,59,0
2024-04-30,36,DPD30-59,8,8,0
2024-04-30,36,DPD60-89,0,0,0
2024-04-30,36,DPD90+,0,0,0
2024-04-30,38,Current,0,0,0
2024-04-30,38,DPD15-29,14,14,0
2024-04-30,38,DPD3-14,54,54,0
2024-04-30,38,DPD30-59,3,3,0
2024-04-30,38,DPD60-89,0,0,0
2024-04-30,38,DPD90+,0,0,0
2024-04-30,40,Current,0,0,0
2024-04-30,40,DPD15-29,25,25,0
2024-04-30,40,DPD3-14,28,28,0
2024-04-30,40,DPD30-59,4,4,0
2024-04-30,40,DPD60-89,0,0,0
2024-04-30,40,DPD90+,0,0,0
2024-04-30,42,Current,0,0,0
2024-04-30,42,DPD15-29,7,7,0
2024-04-30,42,DPD3-14,17,17,0
2024-04-30,42,DPD30-59,3,3,0
2024-04-30,42,DPD60-89,0,0,0
2024-04-30,42,DPD90+,0,0,0
2024-04-30,44,Current,0,0,0
2024-04-30,44,DPD15-29,14,14,0
2024-04-30,44,DPD3-14,44,44,0
2024-04-30,44,DPD30-59,13,13,0
2024-04-30,44,DPD60-89,0,0,0
2024-04-30,44,DPD90+,0,0,0
2024-04-30,46,Current,0,0,0
2024-04-30,46,DPD15-29,0,0,0
2024-04-30,48,Current,23,23,0
2024-04-30,48,DPD15-29,18,18,0
2024-04-30,48,DPD3-14,29,29,0
2024-04-30,48,DPD30-59,2,2,0
2024-04-30,48,DPD60-89,0,0,0
2024-04-30,48,DPD90+,0,0,0
2024-04-30,6,Current,0,0,0
2024-04-30,6,DPD3-14,0,0,0
2024-04-30,6,DPD30-59,0,0,0
2024-04-30,6,DPD60-89,0,0,0
2024-04-29,100,Current,0,0,0
2024-04-29,102,Current,0,0,0
2024-04-29,102,DPD15-29,1,1,0
2024-04-29,102,DPD3-14,0,0,0
2024-04-29,104,Current,0,0,0
2024-04-29,104,DPD3-14,0,0,0
2024-04-29,104,DPD60-89,0,0,0
2024-04-29,20,Current,0,0,0
2024-04-29,20,DPD15-29,166,166,0
2024-04-29,20,DPD3-14,462,462,0
2024-04-29,20,DPD30-59,123,123,0
2024-04-29,20,DPD60-89,40,40,0
2024-04-29,20,DPD90+,2,2,0
2024-04-29,22,Current,0,0,0
2024-04-29,22,DPD15-29,0,0,0
2024-04-29,22,DPD3-14,0,0,0
2024-04-29,22,DPD30-59,0,0,0
2024-04-29,22,DPD60-89,0,0,0
2024-04-29,24,Current,62,62,0
2024-04-29,24,DPD15-29,90,90,0
2024-04-29,24,DPD3-14,259,259,0
2024-04-29,24,DPD30-59,57,57,0
2024-04-29,24,DPD60-89,0,0,0
2024-04-29,24,DPD90+,0,0,0
2024-04-29,26,Current,0,0,0
2024-04-29,26,DPD15-29,14,14,0
2024-04-29,26,DPD3-14,27,27,0
2024-04-29,26,DPD30-59,11,11,0
2024-04-29,26,DPD60-89,0,0,0
2024-04-29,26,DPD90+,0,0,0
2024-04-29,32,Current,0,0,0
2024-04-29,32,DPD15-29,84,84,0
2024-04-29,32,DPD3-14,210,210,0
2024-04-29,32,DPD30-59,47,47,0
2024-04-29,32,DPD60-89,0,0,0
2024-04-29,32,DPD90+,0,0,0
2024-04-29,34,Current,0,0,0
2024-04-29,34,DPD15-29,34,34,0
2024-04-29,34,DPD3-14,94,94,0
2024-04-29,34,DPD30-59,40,40,0
2024-04-29,34,DPD60-89,0,0,0
2024-04-29,34,DPD90+,0,0,0
2024-04-29,36,Current,0,0,0
2024-04-29,36,DPD15-29,21,21,0
2024-04-29,36,DPD3-14,68,68,0
2024-04-29,36,DPD30-59,17,17,0
2024-04-29,36,DPD60-89,0,0,0
2024-04-29,36,DPD90+,0,0,0
2024-04-29,38,Current,0,0,0
2024-04-29,38,DPD15-29,28,28,0
2024-04-29,38,DPD3-14,83,83,0
2024-04-29,38,DPD30-59,15,15,0
2024-04-29,38,DPD60-89,0,0,0
2024-04-29,38,DPD90+,0,0,0
2024-04-29,40,Current,0,0,0
2024-04-29,40,DPD15-29,12,12,0
2024-04-29,40,DPD3-14,42,42,0
2024-04-29,40,DPD30-59,9,9,0
2024-04-29,40,DPD60-89,0,0,0
2024-04-29,40,DPD90+,0,0,0
2024-04-29,42,Current,0,0,0
2024-04-29,42,DPD15-29,2,2,0
2024-04-29,42,DPD3-14,23,23,0
2024-04-29,42,DPD30-59,7,7,0
2024-04-29,42,DPD60-89,0,0,0
2024-04-29,42,DPD90+,0,0,0
2024-04-29,44,Current,0,0,0
2024-04-29,44,DPD15-29,15,15,0
2024-04-29,44,DPD3-14,77,77,0
2024-04-29,44,DPD30-59,10,10,0
2024-04-29,44,DPD60-89,0,0,0
2024-04-29,44,DPD90+,0,0,0
2024-04-29,46,Current,0,0,0
2024-04-29,46,DPD15-29,1,1,0
2024-04-29,46,DPD90+,0,0,0
2024-04-29,48,Current,31,31,0
2024-04-29,48,DPD15-29,20,20,0
2024-04-29,48,DPD3-14,37,37,0
2024-04-29,48,DPD30-59,9,9,0
2024-04-29,48,DPD60-89,0,0,0
2024-04-29,48,DPD90+,0,0,0
2024-04-29,6,Current,0,0,0
2024-04-29,6,DPD30-59,0,0,0
2024-04-28,100,Current,0,0,0
2024-04-28,102,Current,0,0,0
2024-04-28,102,DPD15-29,0,0,0
2024-04-28,102,DPD3-14,0,0,0
2024-04-28,104,Current,0,0,0
2024-04-28,104,DPD3-14,1,1,0
2024-04-28,104,DPD60-89,0,0,0
2024-04-28,104,DPD90+,0,0,0
2024-04-28,20,Current,0,0,0
2024-04-28,20,DPD15-29,126,126,0
2024-04-28,20,DPD3-14,365,365,0
2024-04-28,20,DPD30-59,137,137,0
2024-04-28,20,DPD60-89,11,11,0
2024-04-28,20,DPD90+,0,0,0
2024-04-28,22,Current,0,0,0
2024-04-28,22,DPD15-29,0,0,0
2024-04-28,22,DPD3-14,1,1,0
2024-04-28,22,DPD30-59,0,0,0
2024-04-28,22,DPD60-89,0,0,0
2024-04-28,24,Current,103,103,0
2024-04-28,24,DPD15-29,67,67,0
2024-04-28,24,DPD3-14,201,201,0
2024-04-28,24,DPD30-59,57,57,0
2024-04-28,24,DPD60-89,0,0,0
2024-04-28,24,DPD90+,0,0,0
2024-04-28,26,Current,0,0,0
2024-04-28,26,DPD15-29,8,8,0
2024-04-28,26,DPD3-14,20,20,0
2024-04-28,26,DPD30-59,3,3,0
2024-04-28,26,DPD60-89,0,0,0
2024-04-28,26,DPD90+,0,0,0
2024-04-28,32,Current,0,0,0
2024-04-28,32,DPD15-29,61,61,0
2024-04-28,32,DPD3-14,159,159,0
2024-04-28,32,DPD30-59,58,58,0
2024-04-28,32,DPD60-89,0,0,0
2024-04-28,32,DPD90+,0,0,0
2024-04-28,34,Current,0,0,0
2024-04-28,34,DPD15-29,21,21,0
2024-04-28,34,DPD3-14,63,63,0
2024-04-28,34,DPD30-59,28,28,0
2024-04-28,34,DPD60-89,0,0,0
2024-04-28,34,DPD90+,0,0,0
2024-04-28,36,Current,0,0,0
2024-04-28,36,DPD15-29,12,12,0
2024-04-28,36,DPD3-14,53,53,0
2024-04-28,36,DPD30-59,10,10,0
2024-04-28,36,DPD60-89,0,0,0
2024-04-28,36,DPD90+,0,0,0
2024-04-28,38,Current,0,0,0
2024-04-28,38,DPD15-29,12,12,0
2024-04-28,38,DPD3-14,49,49,0
2024-04-28,38,DPD30-59,8,8,0
2024-04-28,38,DPD60-89,0,0,0
2024-04-28,38,DPD90+,0,0,0
2024-04-28,40,Current,0,0,0
2024-04-28,40,DPD15-29,20,20,0
2024-04-28,40,DPD3-14,34,34,0
2024-04-28,40,DPD30-59,15,15,0
2024-04-28,40,DPD60-89,0,0,0
2024-04-28,40,DPD90+,0,0,0
2024-04-28,42,Current,0,0,0
2024-04-28,42,DPD15-29,9,9,0
2024-04-28,42,DPD3-14,14,14,0
2024-04-28,42,DPD30-59,9,9,0
2024-04-28,42,DPD60-89,0,0,0
2024-04-28,42,DPD90+,0,0,0
2024-04-28,44,Current,0,0,0
2024-04-28,44,DPD15-29,9,9,0
2024-04-28,44,DPD3-14,43,43,0
2024-04-28,44,DPD30-59,8,8,0
2024-04-28,44,DPD60-89,0,0,0
2024-04-28,44,DPD90+,0,0,0
2024-04-28,46,Current,0,0,0
2024-04-28,46,DPD15-29,0,0,0
2024-04-28,46,DPD90+,0,0,0
2024-04-28,48,Current,30,30,0
2024-04-28,48,DPD15-29,13,13,0
2024-04-28,48,DPD3-14,30,30,0
2024-04-28,48,DPD30-59,8,8,0
2024-04-28,48,DPD60-89,0,0,0
2024-04-28,48,DPD90+,0,0,0
2024-04-28,6,Current,0,0,0
2024-04-28,6,DPD30-59,1,1,0
2024-04-27,100,Current,0,0,0
2024-04-27,102,Current,0,0,0
2024-04-27,102,DPD15-29,1,1,0
2024-04-27,102,DPD3-14,0,0,0
2024-04-27,104,Current,0,0,0
2024-04-27,104,DPD3-14,0,0,0
2024-04-27,104,DPD60-89,0,0,0
2024-04-27,104,DPD90+,0,0,0
2024-04-27,20,Current,0,0,0
2024-04-27,20,DPD15-29,169,169,0
2024-04-27,20,DPD3-14,400,400,0
2024-04-27,20,DPD30-59,102,102,0
2024-04-27,20,DPD60-89,44,44,0
2024-04-27,20,DPD90+,31,31,0
2024-04-27,22,Current,0,0,0
2024-04-27,22,DPD15-29,0,0,0
2024-04-27,22,DPD3-14,0,0,0
2024-04-27,22,DPD30-59,0,0,0
2024-04-27,22,DPD60-89,0,0,0
2024-04-27,24,Current,67,67,0
2024-04-27,24,DPD15-29,92,92,0
2024-04-27,24,DPD3-14,226,226,0
2024-04-27,24,DPD30-59,54,54,0
2024-04-27,24,DPD60-89,0,0,0
2024-04-27,24,DPD90+,0,0,0
2024-04-27,26,Current,0,0,0
2024-04-27,26,DPD15-29,18,18,0
2024-04-27,26,DPD3-14,22,22,0
2024-04-27,26,DPD30-59,8,8,0
2024-04-27,26,DPD60-89,0,0,0
2024-04-27,26,DPD90+,0,0,0
2024-04-27,32,Current,0,0,0
2024-04-27,32,DPD15-29,80,80,0
2024-04-27,32,DPD3-14,184,184,0
2024-04-27,32,DPD30-59,52,52,0
2024-04-27,32,DPD60-89,0,0,0
2024-04-27,32,DPD90+,0,0,0
2024-04-27,34,Current,0,0,0
2024-04-27,34,DPD15-29,41,41,0
2024-04-27,34,DPD3-14,86,86,0
2024-04-27,34,DPD30-59,30,30,0
2024-04-27,34,DPD60-89,0,0,0
2024-04-27,34,DPD90+,0,0,0
2024-04-27,36,Current,0,0,0
2024-04-27,36,DPD15-29,23,23,0
2024-04-27,36,DPD3-14,53,53,0
2024-04-27,36,DPD30-59,14,14,0
2024-04-27,36,DPD60-89,0,0,0
2024-04-27,36,DPD90+,0,0,0
2024-04-27,38,Current,0,0,0
2024-04-27,38,DPD15-29,26,26,0
2024-04-27,38,DPD3-14,71,71,0
2024-04-27,38,DPD30-59,20,20,0
2024-04-27,38,DPD60-89,0,0,0
2024-04-27,38,DPD90+,0,0,0
2024-04-27,40,Current,0,0,0
2024-04-27,40,DPD15-29,15,15,0
2024-04-27,40,DPD3-14,33,33,0
2024-04-27,40,DPD30-59,6,6,0
2024-04-27,40,DPD60-89,0,0,0
2024-04-27,40,DPD90+,0,0,0
2024-04-27,42,Current,0,0,0
2024-04-27,42,DPD15-29,4,4,0
2024-04-27,42,DPD3-14,21,21,0
2024-04-27,42,DPD30-59,6,6,0
2024-04-27,42,DPD60-89,0,0,0
2024-04-27,42,DPD90+,0,0,0
2024-04-27,44,Current,0,0,0
2024-04-27,44,DPD15-29,18,18,0
2024-04-27,44,DPD3-14,60,60,0
2024-04-27,44,DPD30-59,7,7,0
2024-04-27,44,DPD60-89,0,0,0
2024-04-27,44,DPD90+,0,0,0
2024-04-27,46,Current,0,0,0
2024-04-27,46,DPD15-29,1,1,0
2024-04-27,46,DPD90+,0,0,0
2024-04-27,48,Current,25,25,0
2024-04-27,48,DPD15-29,17,17,0
2024-04-27,48,DPD3-14,36,36,0
2024-04-27,48,DPD30-59,12,12,0
2024-04-27,48,DPD60-89,0,0,0
2024-04-27,48,DPD90+,0,0,0
2024-04-27,6,Current,0,0,0
2024-04-27,6,DPD30-59,0,0,0
2024-04-26,100,Current,0,0,0
2024-04-26,102,Current,0,0,0
2024-04-26,102,DPD15-29,0,0,0
2024-04-26,102,DPD3-14,1,1,0
2024-04-26,104,Current,0,0,0
2024-04-26,104,DPD3-14,1,1,0
2024-04-26,104,DPD60-89,0,0,0
2024-04-26,104,DPD90+,0,0,0
2024-04-26,20,Current,0,0,0
2024-04-26,20,DPD15-29,146,146,0
2024-04-26,20,DPD3-14,360,360,0
2024-04-26,20,DPD30-59,165,165,0
2024-04-26,20,DPD60-89,85,85,0
2024-04-26,20,DPD90+,22,22,0
2024-04-26,22,Current,0,0,0
2024-04-26,22,DPD15-29,0,0,0
2024-04-26,22,DPD3-14,1,1,0
2024-04-26,22,DPD30-59,0,0,0
2024-04-26,22,DPD60-89,0,0,0
2024-04-26,24,Current,84,84,0
2024-04-26,24,DPD15-29,68,68,0
2024-04-26,24,DPD3-14,210,210,0
2024-04-26,24,DPD30-59,69,69,0
2024-04-26,24,DPD60-89,0,0,0
2024-04-26,24,DPD90+,0,0,0
2024-04-26,26,Current,0,0,0
2024-04-26,26,DPD15-29,6,6,0
2024-04-26,26,DPD3-14,23,23,0
2024-04-26,26,DPD30-59,10,10,0
2024-04-26,26,DPD60-89,0,0,0
2024-04-26,26,DPD90+,0,0,0
2024-04-26,32,Current,0,0,0
2024-04-26,32,DPD15-29,84,84,0
2024-04-26,32,DPD3-14,151,151,0
2024-04-26,32,DPD30-59,59,59,0
2024-04-26,32,DPD60-89,0,0,0
2024-04-26,32,DPD90+,0,0,0
2024-04-26,34,Current,0,0,0
2024-04-26,34,DPD15-29,28,28,0
2024-04-26,34,DPD3-14,54,54,0
2024-04-26,34,DPD30-59,38,38,0
2024-04-26,34,DPD60-89,0,0,0
2024-04-26,34,DPD90+,0,0,0
2024-04-26,36,Current,0,0,0
2024-04-26,36,DPD15-29,13,13,0
2024-04-26,36,DPD3-14,59,59,0
2024-04-26,36,DPD30-59,16,16,0
2024-04-26,36,DPD60-89,0,0,0
2024-04-26,36,DPD90+,0,0,0
2024-04-26,38,Current,0,0,0
2024-04-26,38,DPD15-29,15,15,0
2024-04-26,38,DPD3-14,48,48,0
2024-04-26,38,DPD30-59,18,18,0
2024-04-26,38,DPD60-89,0,0,0
2024-04-26,38,DPD90+,0,0,0
2024-04-26,40,Current,0,0,0
2024-04-26,40,DPD15-29,20,20,0
2024-04-26,40,DPD3-14,41,41,0
2024-04-26,40,DPD30-59,9,9,0
2024-04-26,40,DPD60-89,0,0,0
2024-04-26,40,DPD90+,0,0,0
2024-04-26,42,Current,0,0,0
2024-04-26,42,DPD15-29,6,6,0
2024-04-26,42,DPD3-14,17,17,0
2024-04-26,42,DPD30-59,6,6,0
2024-04-26,42,DPD60-89,0,0,0
2024-04-26,42,DPD90+,0,0,0
2024-04-26,44,Current,0,0,0
2024-04-26,44,DPD15-29,10,10,0
2024-04-26,44,DPD3-14,46,46,0
2024-04-26,44,DPD30-59,15,15,0
2024-04-26,44,DPD60-89,0,0,0
2024-04-26,44,DPD90+,0,0,0
2024-04-26,46,Current,0,0,0
2024-04-26,46,DPD15-29,0,0,0
2024-04-26,46,DPD90+,0,0,0
2024-04-26,48,Current,50,50,0
2024-04-26,48,DPD15-29,11,11,0
2024-04-26,48,DPD3-14,33,33,0
2024-04-26,48,DPD30-59,4,4,0
2024-04-26,48,DPD60-89,0,0,0
2024-04-26,48,DPD90+,0,0,0
2024-04-26,6,Current,0,0,0
2024-04-26,6,DPD30-59,0,0,0
2024-04-25,100,Current,0,0,0
2024-04-25,102,Current,0,0,0
2024-04-25,102,DPD15-29,1,1,0
2024-04-25,102,DPD3-14,0,0,0
2024-04-25,102,DPD30-59,0,0,0
2024-04-25,102,DPD90+,0,0,0
2024-04-25,104,Current,0,0,0
2024-04-25,104,DPD3-14,0,0,0
2024-04-25,104,DPD60-89,0,0,0
2024-04-25,104,DPD90+,0,0,0
2024-04-25,20,Current,0,0,0
2024-04-25,20,DPD15-29,189,189,0
2024-04-25,20,DPD3-14,397,397,0
2024-04-25,20,DPD30-59,25,25,0
2024-04-25,20,DPD60-89,3,3,0
2024-04-25,20,DPD90+,4,4,0
2024-04-25,22,Current,0,0,0
2024-04-25,22,DPD15-29,0,0,0
2024-04-25,22,DPD3-14,0,0,0
2024-04-25,22,DPD30-59,0,0,0
2024-04-25,22,DPD60-89,0,0,0
2024-04-25,24,Current,47,47,0
2024-04-25,24,DPD15-29,109,109,0
2024-04-25,24,DPD3-14,216,216,0
2024-04-25,24,DPD30-59,16,16,0
2024-04-25,24,DPD60-89,0,0,0
2024-04-25,24,DPD90+,0,0,0
2024-04-25,26,Current,0,0,0
2024-04-25,26,DPD15-29,17,17,0
2024-04-25,26,DPD3-14,27,27,0
2024-04-25,26,DPD30-59,1,1,0
2024-04-25,26,DPD60-89,0,0,0
2024-04-25,26,DPD90+,0,0,0
2024-04-25,32,Current,0,0,0
2024-04-25,32,DPD15-29,99,99,0
2024-04-25,32,DPD3-14,172,172,0
2024-04-25,32,DPD30-59,11,11,0
2024-04-25,32,DPD60-89,0,0,0
2024-04-25,32,DPD90+,0,0,0
2024-04-25,34,Current,0,0,0
2024-04-25,34,DPD15-29,39,39,0
2024-04-25,34,DPD3-14,84,84,0
2024-04-25,34,DPD30-59,9,9,0
2024-04-25,34,DPD60-89,0,0,0
2024-04-25,34,DPD90+,0,0,0
2024-04-25,36,Current,0,0,0
2024-04-25,36,DPD15-29,28,28,0
2024-04-25,36,DPD3-14,58,58,0
2024-04-25,36,DPD30-59,5,5,0
2024-04-25,36,DPD60-89,0,0,0
2024-04-25,36,DPD90+,0,0,0
2024-04-25,38,Current,0,0,0
2024-04-25,38,DPD15-29,28,28,0
2024-04-25,38,DPD3-14,68,68,0
2024-04-25,38,DPD30-59,1,1,0
2024-04-25,38,DPD60-89,0,0,0
2024-04-25,38,DPD90+,0,0,0
2024-04-25,40,Current,0,0,0
2024-04-25,40,DPD15-29,17,17,0
2024-04-25,40,DPD3-14,33,33,0
2024-04-25,40,DPD30-59,1,1,0
2024-04-25,40,DPD60-89,0,0,0
2024-04-25,40,DPD90+,0,0,0
2024-04-25,42,Current,0,0,0
2024-04-25,42,DPD15-29,5,5,0
2024-04-25,42,DPD3-14,23,23,0
2024-04-25,42,DPD30-59,1,1,0
2024-04-25,42,DPD60-89,0,0,0
2024-04-25,42,DPD90+,0,0,0
2024-04-25,44,Current,0,0,0
2024-04-25,44,DPD15-29,22,22,0
2024-04-25,44,DPD3-14,56,56,0
2024-04-25,44,DPD30-59,1,1,0
2024-04-25,44,DPD60-89,0,0,0
2024-04-25,44,DPD90+,0,0,0
2024-04-25,46,Current,0,0,0
2024-04-25,46,DPD15-29,1,1,0
2024-04-25,46,DPD90+,0,0,0
2024-04-25,48,Current,30,30,0
2024-04-25,48,DPD15-29,18,18,0
2024-04-25,48,DPD3-14,42,42,0
2024-04-25,48,DPD30-59,4,4,0
2024-04-25,48,DPD60-89,0,0,0
2024-04-25,48,DPD90+,0,0,0
2024-04-25,6,Current,0,0,0
2024-04-25,6,DPD30-59,0,0,0
2024-04-24,100,Current,0,0,0
2024-04-24,102,Current,0,0,0
2024-04-24,102,DPD15-29,0,0,0
2024-04-24,102,DPD3-14,0,0,0
2024-04-24,102,DPD30-59,0,0,0
2024-04-24,102,DPD90+,0,0,0
2024-04-24,104,Current,0,0,0
2024-04-24,104,DPD3-14,1,1,0
2024-04-24,104,DPD60-89,0,0,0
2024-04-24,104,DPD90+,0,0,0
2024-04-24,20,Current,0,0,0
2024-04-24,20,DPD15-29,147,147,0
2024-04-24,20,DPD3-14,355,355,0
2024-04-24,20,DPD30-59,118,118,0
2024-04-24,20,DPD60-89,48,48,0
2024-04-24,20,DPD90+,49,49,0
2024-04-24,22,Current,0,0,0
2024-04-24,22,DPD15-29,1,1,0
2024-04-24,22,DPD3-14,0,0,0
2024-04-24,22,DPD60-89,0,0,0
2024-04-24,24,Current,46,46,0
2024-04-24,24,DPD15-29,61,61,0
2024-04-24,24,DPD3-14,223,223,0
2024-04-24,24,DPD30-59,55,55,0
2024-04-24,24,DPD60-89,0,0,0
2024-04-24,24,DPD90+,0,0,0
2024-04-24,26,Current,0,0,0
2024-04-24,26,DPD15-29,7,7,0
2024-04-24,26,DPD3-14,29,29,0
2024-04-24,26,DPD30-59,2,2,0
2024-04-24,26,DPD60-89,0,0,0
2024-04-24,26,DPD90+,0,0,0
2024-04-24,32,Current,0,0,0
2024-04-24,32,DPD15-29,88,88,0
2024-04-24,32,DPD3-14,155,155,0
2024-04-24,32,DPD30-59,47,47,0
2024-04-24,32,DPD60-89,0,0,0
2024-04-24,32,DPD90+,0,0,0
2024-04-24,34,Current,0,0,0
2024-04-24,34,DPD15-29,26,26,0
2024-04-24,34,DPD3-14,55,55,0
2024-04-24,34,DPD30-59,30,30,0
2024-04-24,34,DPD60-89,0,0,0
2024-04-24,34,DPD90+,0,0,0
2024-04-24,36,Current,0,0,0
2024-04-24,36,DPD15-29,13,13,0
2024-04-24,36,DPD3-14,61,61,0
2024-04-24,36,DPD30-59,15,15,0
2024-04-24,36,DPD60-89,0,0,0
2024-04-24,36,DPD90+,0,0,0
2024-04-24,38,Current,0,0,0
2024-04-24,38,DPD15-29,15,15,0
2024-04-24,38,DPD3-14,46,46,0
2024-04-24,38,DPD30-59,7,7,0
2024-04-24,38,DPD60-89,0,0,0
2024-04-24,38,DPD90+,0,0,0
2024-04-24,40,Current,0,0,0
2024-04-24,40,DPD15-29,23,23,0
2024-04-24,40,DPD3-14,44,44,0
2024-04-24,40,DPD30-59,10,10,0
2024-04-24,40,DPD60-89,0,0,0
2024-04-24,40,DPD90+,0,0,0
2024-04-24,42,Current,0,0,0
2024-04-24,42,DPD15-29,6,6,0
2024-04-24,42,DPD3-14,15,15,0
2024-04-24,42,DPD30-59,10,10,0
2024-04-24,42,DPD60-89,0,0,0
2024-04-24,42,DPD90+,0,0,0
2024-04-24,44,Current,0,0,0
2024-04-24,44,DPD15-29,11,11,0
2024-04-24,44,DPD3-14,57,57,0
2024-04-24,44,DPD30-59,5,5,0
2024-04-24,44,DPD60-89,0,0,0
2024-04-24,44,DPD90+,0,0,0
2024-04-24,46,Current,0,0,0
2024-04-24,46,DPD15-29,0,0,0
2024-04-24,46,DPD90+,0,0,0
2024-04-24,48,Current,35,35,0
2024-04-24,48,DPD15-29,10,10,0
2024-04-24,48,DPD3-14,39,39,0
2024-04-24,48,DPD30-59,9,9,0
2024-04-24,48,DPD60-89,0,0,0
2024-04-24,48,DPD90+,0,0,0
2024-04-24,6,Current,0,0,0
2024-04-24,6,DPD30-59,1,1,0
2024-04-23,100,Current,0,0,0
2024-04-23,102,Current,0,0,0
2024-04-23,102,DPD15-29,0,0,0
2024-04-23,102,DPD3-14,0,0,0
2024-04-23,102,DPD30-59,0,0,0
2024-04-23,102,DPD90+,0,0,0
2024-04-23,104,Current,0,0,0
2024-04-23,104,DPD3-14,0,0,0
2024-04-23,104,DPD60-89,0,0,0
2024-04-23,104,DPD90+,0,0,0
2024-04-23,20,Current,1,1,0
2024-04-23,20,DPD15-29,198,198,0
2024-04-23,20,DPD3-14,388,388,0
2024-04-23,20,DPD30-59,121,121,0
2024-04-23,20,DPD60-89,8,8,0
2024-04-23,20,DPD90+,2,2,0
2024-04-23,22,Current,0,0,0
2024-04-23,22,DPD15-29,0,0,0
2024-04-23,22,DPD60-89,0,0,0
2024-04-23,24,Current,52,52,0
2024-04-23,24,DPD15-29,106,106,0
2024-04-23,24,DPD3-14,220,220,0
2024-04-23,24,DPD30-59,63,63,0
2024-04-23,24,DPD60-89,0,0,0
2024-04-23,24,DPD90+,0,0,0
2024-04-23,26,Current,0,0,0
2024-04-23,26,DPD15-29,16,16,0
2024-04-23,26,DPD3-14,34,34,0
2024-04-23,26,DPD30-59,11,11,0
2024-04-23,26,DPD60-89,0,0,0
2024-04-23,26,DPD90+,0,0,0
2024-04-23,32,Current,0,0,0
2024-04-23,32,DPD15-29,100,100,0
2024-04-23,32,DPD3-14,182,182,0
2024-04-23,32,DPD30-59,61,61,0
2024-04-23,32,DPD60-89,0,0,0
2024-04-23,32,DPD90+,0,0,0
2024-04-23,34,Current,0,0,0
2024-04-23,34,DPD15-29,45,45,0
2024-04-23,34,DPD3-14,77,77,0
2024-04-23,34,DPD30-59,34,34,0
2024-04-23,34,DPD60-89,0,0,0
2024-04-23,34,DPD90+,0,0,0
2024-04-23,36,Current,0,0,0
2024-04-23,36,DPD15-29,34,34,0
2024-04-23,36,DPD3-14,50,50,0
2024-04-23,36,DPD30-59,13,13,0
2024-04-23,36,DPD60-89,0,0,0
2024-04-23,36,DPD90+,0,0,0
2024-04-23,38,Current,0,0,0
2024-04-23,38,DPD15-29,31,31,0
2024-04-23,38,DPD3-14,59,59,0
2024-04-23,38,DPD30-59,19,19,0
2024-04-23,38,DPD60-89,0,0,0
2024-04-23,38,DPD90+,0,0,0
2024-04-23,40,Current,0,0,0
2024-04-23,40,DPD15-29,18,18,0
2024-04-23,40,DPD3-14,28,28,0
2024-04-23,40,DPD30-59,7,7,0
2024-04-23,40,DPD60-89,0,0,0
2024-04-23,40,DPD90+,0,0,0
2024-04-23,42,Current,0,0,0
2024-04-23,42,DPD15-29,5,5,0
2024-04-23,42,DPD3-14,22,22,0
2024-04-23,42,DPD30-59,6,6,0
2024-04-23,42,DPD60-89,0,0,0
2024-04-23,42,DPD90+,0,0,0
2024-04-23,44,Current,0,0,0
2024-04-23,44,DPD15-29,20,20,0
2024-04-23,44,DPD3-14,59,59,0
2024-04-23,44,DPD30-59,6,6,0
2024-04-23,44,DPD60-89,0,0,0
2024-04-23,44,DPD90+,0,0,0
2024-04-23,46,Current,0,0,0
2024-04-23,46,DPD15-29,1,1,0
2024-04-23,46,DPD90+,0,0,0
2024-04-23,48,Current,30,30,0
2024-04-23,48,DPD15-29,18,18,0
2024-04-23,48,DPD3-14,35,35,0
2024-04-23,48,DPD30-59,16,16,0
2024-04-23,48,DPD60-89,0,0,0
2024-04-23,48,DPD90+,0,0,0
2024-04-23,6,Current,0,0,0
2024-04-23,6,DPD30-59,0,0,0
2024-04-22,100,Current,0,0,0
2024-04-22,100,DPD3-14,0,0,0
2024-04-22,102,Current,0,0,0
2024-04-22,102,DPD3-14,0,0,0
2024-04-22,102,DPD30-59,0,0,0
2024-04-22,102,DPD90+,0,0,0
2024-04-22,104,Current,0,0,0
2024-04-22,104,DPD3-14,1,1,0
2024-04-22,104,DPD60-89,0,0,0
2024-04-22,104,DPD90+,0,0,0
2024-04-22,20,Current,0,0,0
2024-04-22,20,DPD15-29,140,140,0
2024-04-22,20,DPD3-14,377,377,0
2024-04-22,20,DPD30-59,186,186,0
2024-04-22,20,DPD60-89,92,92,0
2024-04-22,20,DPD90+,68,68,0
2024-04-22,22,Current,0,0,0
2024-04-22,22,DPD15-29,1,1,0
2024-04-22,22,DPD60-89,0,0,0
2024-04-22,24,Current,41,41,0
2024-04-22,24,DPD15-29,66,66,0
2024-04-22,24,DPD3-14,232,232,0
2024-04-22,24,DPD30-59,76,76,0
2024-04-22,24,DPD60-89,0,0,0
2024-04-22,24,DPD90+,0,0,0
2024-04-22,26,Current,0,0,0
2024-04-22,26,DPD15-29,10,10,0
2024-04-22,26,DPD3-14,20,20,0
2024-04-22,26,DPD30-59,10,10,0
2024-04-22,26,DPD60-89,0,0,0
2024-04-22,26,DPD90+,0,0,0
2024-04-22,32,Current,0,0,0
2024-04-22,32,DPD15-29,79,79,0
2024-04-22,32,DPD3-14,150,150,0
2024-04-22,32,DPD30-59,73,73,0
2024-04-22,32,DPD60-89,0,0,0
2024-04-22,32,DPD90+,0,0,0
2024-04-22,34,Current,0,0,0
2024-04-22,34,DPD15-29,37,37,0
2024-04-22,34,DPD3-14,67,67,0
2024-04-22,34,DPD30-59,48,48,0
2024-04-22,34,DPD60-89,0,0,0
2024-04-22,34,DPD90+,0,0,0
2024-04-22,36,Current,0,0,0
2024-04-22,36,DPD15-29,17,17,0
2024-04-22,36,DPD3-14,53,53,0
2024-04-22,36,DPD30-59,17,17,0
2024-04-22,36,DPD60-89,0,0,0
2024-04-22,36,DPD90+,0,0,0
2024-04-22,38,Current,0,0,0
2024-04-22,38,DPD15-29,16,16,0
2024-04-22,38,DPD3-14,48,48,0
2024-04-22,38,DPD30-59,24,24,0
2024-04-22,38,DPD60-89,0,0,0
2024-04-22,38,DPD90+,0,0,0
2024-04-22,40,Current,0,0,0
2024-04-22,40,DPD15-29,20,20,0
2024-04-22,40,DPD3-14,44,44,0
2024-04-22,40,DPD30-59,9,9,0
2024-04-22,40,DPD60-89,0,0,0
2024-04-22,40,DPD90+,0,0,0
2024-04-22,42,Current,0,0,0
2024-04-22,42,DPD15-29,9,9,0
2024-04-22,42,DPD3-14,16,16,0
2024-04-22,42,DPD30-59,7,7,0
2024-04-22,42,DPD60-89,0,0,0
2024-04-22,42,DPD90+,0,0,0
2024-04-22,44,Current,0,0,0
2024-04-22,44,DPD15-29,14,14,0
2024-04-22,44,DPD3-14,58,58,0
2024-04-22,44,DPD30-59,18,18,0
2024-04-22,44,DPD60-89,0,0,0
2024-04-22,44,DPD90+,0,0,0
2024-04-22,46,Current,0,0,0
2024-04-22,46,DPD15-29,0,0,0
2024-04-22,46,DPD90+,0,0,0
2024-04-22,48,Current,41,41,0
2024-04-22,48,DPD15-29,9,9,0
2024-04-22,48,DPD3-14,47,47,0
2024-04-22,48,DPD30-59,5,5,0
2024-04-22,48,DPD60-89,0,0,0
2024-04-22,48,DPD90+,0,0,0
2024-04-22,6,Current,0,0,0
2024-04-22,6,DPD30-59,0,0,0
2024-04-21,100,Current,0,0,0
2024-04-21,100,DPD3-14,1,1,0
2024-04-21,102,Current,0,0,0
2024-04-21,102,DPD15-29,0,0,0
2024-04-21,102,DPD3-14,1,1,0
2024-04-21,102,DPD30-59,0,0,0
2024-04-21,102,DPD90+,0,0,0
2024-04-21,104,Current,0,0,0
2024-04-21,104,DPD3-14,0,0,0
2024-04-21,104,DPD30-59,0,0,0
2024-04-21,104,DPD90+,0,0,0
2024-04-21,20,Current,0,0,0
2024-04-21,20,DPD15-29,187,187,0
2024-04-21,20,DPD3-14,397,397,0
2024-04-21,20,DPD30-59,106,106,0
2024-04-21,20,DPD60-89,32,32,0
2024-04-21,20,DPD90+,2,2,0
2024-04-21,22,Current,0,0,0
2024-04-21,22,DPD15-29,0,0,0
2024-04-21,22,DPD60-89,0,0,0
2024-04-21,24,Current,95,95,0
2024-04-21,24,DPD15-29,108,108,0
2024-04-21,24,DPD3-14,216,216,0
2024-04-21,24,DPD30-59,58,58,0
2024-04-21,24,DPD60-89,0,0,0
2024-04-21,24,DPD90+,0,0,0
2024-04-21,26,Current,0,0,0
2024-04-21,26,DPD15-29,15,15,0
2024-04-21,26,DPD3-14,34,34,0
2024-04-21,26,DPD30-59,3,3,0
2024-04-21,26,DPD60-89,0,0,0
2024-04-21,26,DPD90+,0,0,0
2024-04-21,32,Current,0,0,0
2024-04-21,32,DPD15-29,102,102,0
2024-04-21,32,DPD3-14,186,186,0
2024-04-21,32,DPD30-59,50,50,0
2024-04-21,32,DPD60-89,0,0,0
2024-04-21,32,DPD90+,0,0,0
2024-04-21,34,Current,0,0,0
2024-04-21,34,DPD15-29,45,45,0
2024-04-21,34,DPD3-14,80,80,0
2024-04-21,34,DPD30-59,23,23,0
2024-04-21,34,DPD60-89,0,0,0
2024-04-21,34,DPD90+,0,0,0
2024-04-21,36,Current,0,0,0
2024-04-21,36,DPD15-29,26,26,0
2024-04-21,36,DPD3-14,50,50,0
2024-04-21,36,DPD30-59,16,16,0
2024-04-21,36,DPD60-89,0,0,0
2024-04-21,36,DPD90+,0,0,0
2024-04-21,38,Current,0,0,0
2024-04-21,38,DPD15-29,33,33,0
2024-04-21,38,DPD3-14,61,61,0
2024-04-21,38,DPD30-59,11,11,0
2024-04-21,38,DPD60-89,0,0,0
2024-04-21,38,DPD90+,0,0,0
2024-04-21,40,Current,0,0,0
2024-04-21,40,DPD15-29,18,18,0
2024-04-21,40,DPD3-14,28,28,0
2024-04-21,40,DPD30-59,7,7,0
2024-04-21,40,DPD60-89,0,0,0
2024-04-21,40,DPD90+,0,0,0
2024-04-21,42,Current,0,0,0
2024-04-21,42,DPD15-29,5,5,0
2024-04-21,42,DPD3-14,27,27,0
2024-04-21,42,DPD30-59,6,6,0
2024-04-21,42,DPD60-89,0,0,0
2024-04-21,42,DPD90+,0,0,0
2024-04-21,44,Current,0,0,0
2024-04-21,44,DPD15-29,19,19,0
2024-04-21,44,DPD3-14,54,54,0
2024-04-21,44,DPD30-59,6,6,0
2024-04-21,44,DPD60-89,0,0,0
2024-04-21,44,DPD90+,0,0,0
2024-04-21,46,Current,0,0,0
2024-04-21,46,DPD3-14,1,1,0
2024-04-21,46,DPD90+,0,0,0
2024-04-21,48,Current,70,70,0
2024-04-21,48,DPD15-29,14,14,0
2024-04-21,48,DPD3-14,30,30,0
2024-04-21,48,DPD30-59,11,11,0
2024-04-21,48,DPD60-89,0,0,0
2024-04-21,48,DPD90+,0,0,0
2024-04-21,6,Current,0,0,0
2024-04-21,6,DPD30-59,1,1,0
2024-04-20,100,Current,0,0,0
2024-04-20,100,DPD3-14,0,0,0
2024-04-20,102,Current,0,0,0
2024-04-20,102,DPD3-14,0,0,0
2024-04-20,102,DPD30-59,0,0,0
2024-04-20,102,DPD90+,0,0,0
2024-04-20,104,Current,0,0,0
2024-04-20,104,DPD30-59,0,0,0
2024-04-20,104,DPD60-89,0,0,0
2024-04-20,20,Current,0,0,0
2024-04-20,20,DPD15-29,149,149,0
2024-04-20,20,DPD3-14,306,306,0
2024-04-20,20,DPD30-59,24,24,0
2024-04-20,20,DPD60-89,2,2,0
2024-04-20,20,DPD90+,1,1,0
2024-04-20,22,Current,0,0,0
2024-04-20,22,DPD15-29,1,1,0
2024-04-20,22,DPD30-59,0,0,0
2024-04-20,22,DPD60-89,0,0,0
2024-04-20,24,Current,66,66,0
2024-04-20,24,DPD15-29,61,61,0
2024-04-20,24,DPD3-14,187,187,0
2024-04-20,24,DPD30-59,10,10,0
2024-04-20,24,DPD60-89,0,0,0
2024-04-20,24,DPD90+,0,0,0
2024-04-20,26,Current,0,0,0
2024-04-20,26,DPD15-29,9,9,0
2024-04-20,26,DPD3-14,17,17,0
2024-04-20,26,DPD30-59,0,0,0
2024-04-20,26,DPD60-89,0,0,0
2024-04-20,26,DPD90+,0,0,0
2024-04-20,32,Current,0,0,0
2024-04-20,32,DPD15-29,79,79,0
2024-04-20,32,DPD3-14,131,131,0
2024-04-20,32,DPD30-59,8,8,0
2024-04-20,32,DPD60-89,0,0,0
2024-04-20,32,DPD90+,0,0,0
2024-04-20,34,Current,0,0,0
2024-04-20,34,DPD15-29,35,35,0
2024-04-20,34,DPD3-14,57,57,0
2024-04-20,34,DPD30-59,4,4,0
2024-04-20,34,DPD60-89,0,0,0
2024-04-20,34,DPD90+,0,0,0
2024-04-20,36,Current,0,0,0
2024-04-20,36,DPD15-29,15,15,0
2024-04-20,36,DPD3-14,44,44,0
2024-04-20,36,DPD30-59,4,4,0
2024-04-20,36,DPD60-89,0,0,0
2024-04-20,36,DPD90+,0,0,0
2024-04-20,38,Current,0,0,0
2024-04-20,38,DPD15-29,17,17,0
2024-04-20,38,DPD3-14,36,36,0
2024-04-20,38,DPD30-59,0,0,0
2024-04-20,38,DPD60-89,0,0,0
2024-04-20,38,DPD90+,0,0,0
2024-04-20,40,Current,0,0,0
2024-04-20,40,DPD15-29,18,18,0
2024-04-20,40,DPD3-14,41,41,0
2024-04-20,40,DPD30-59,3,3,0
2024-04-20,40,DPD60-89,0,0,0
2024-04-20,40,DPD90+,0,0,0
2024-04-20,42,Current,0,0,0
2024-04-20,42,DPD15-29,8,8,0
2024-04-20,42,DPD3-14,14,14,0
2024-04-20,42,DPD30-59,2,2,0
2024-04-20,42,DPD60-89,0,0,0
2024-04-20,42,DPD90+,0,0,0
2024-04-20,44,Current,0,0,0
2024-04-20,44,DPD15-29,11,11,0
2024-04-20,44,DPD3-14,47,47,0
2024-04-20,44,DPD30-59,1,1,0
2024-04-20,44,DPD60-89,0,0,0
2024-04-20,44,DPD90+,0,0,0
2024-04-20,46,Current,0,0,0
2024-04-20,46,DPD3-14,0,0,0
2024-04-20,46,DPD90+,0,0,0
2024-04-20,48,Current,49,49,0
2024-04-20,48,DPD15-29,7,7,0
2024-04-20,48,DPD3-14,40,40,0
2024-04-20,48,DPD30-59,2,2,0
2024-04-20,48,DPD60-89,0,0,0
2024-04-20,48,DPD90+,0,0,0
2024-04-20,6,Current,0,0,0
2024-04-20,6,DPD30-59,0,0,0
2024-04-19,100,Current,0,0,0
2024-04-19,102,Current,0,0,0
2024-04-19,102,DPD3-14,1,1,0
2024-04-19,102,DPD30-59,0,0,0
2024-04-19,102,DPD90+,0,0,0
2024-04-19,104,Current,0,0,0
2024-04-19,104,DPD30-59,0,0,0
2024-04-19,104,DPD60-89,0,0,0
2024-04-19,20,Current,27,27,0
2024-04-19,20,DPD15-29,211,211,0
2024-04-19,20,DPD3-14,388,388,0
2024-04-19,20,DPD30-59,113,113,0
2024-04-19,20,DPD60-89,46,46,0
2024-04-19,20,DPD90+,39,39,0
2024-04-19,22,Current,0,0,0
2024-04-19,22,DPD15-29,0,0,0
2024-04-19,22,DPD30-59,0,0,0
2024-04-19,22,DPD60-89,0,0,0
2024-04-19,24,Current,119,119,0
2024-04-19,24,DPD15-29,124,124,0
2024-04-19,24,DPD3-14,197,197,0
2024-04-19,24,DPD30-59,54,54,0
2024-04-19,24,DPD60-89,0,0,0
2024-04-19,24,DPD90+,0,0,0
2024-04-19,26,Current,0,0,0
2024-04-19,26,DPD15-29,18,18,0
2024-04-19,26,DPD3-14,29,29,0
2024-04-19,26,DPD30-59,10,10,0
2024-04-19,26,DPD60-89,0,0,0
2024-04-19,26,DPD90+,0,0,0
2024-04-19,32,Current,0,0,0
2024-04-19,32,DPD15-29,115,115,0
2024-04-19,32,DPD3-14,169,169,0
2024-04-19,32,DPD30-59,46,46,0
2024-04-19,32,DPD60-89,0,0,0
2024-04-19,32,DPD90+,0,0,0
2024-04-19,34,Current,0,0,0
2024-04-19,34,DPD15-29,56,56,0
2024-04-19,34,DPD3-14,76,76,0
2024-04-19,34,DPD30-59,28,28,0
2024-04-19,34,DPD60-89,0,0,0
2024-04-19,34,DPD90+,0,0,0
2024-04-19,36,Current,0,0,0
2024-04-19,36,DPD15-29,29,29,0
2024-04-19,36,DPD3-14,49,49,0
2024-04-19,36,DPD30-59,14,14,0
2024-04-19,36,DPD60-89,0,0,0
2024-04-19,36,DPD90+,0,0,0
2024-04-19,38,Current,0,0,0
2024-04-19,38,DPD15-29,36,36,0
2024-04-19,38,DPD3-14,63,63,0
2024-04-19,38,DPD30-59,13,13,0
2024-04-19,38,DPD60-89,0,0,0
2024-04-19,38,DPD90+,0,0,0
2024-04-19,40,Current,0,0,0
2024-04-19,40,DPD15-29,21,21,0
2024-04-19,40,DPD3-14,30,30,0
2024-04-19,40,DPD30-59,7,7,0
2024-04-19,40,DPD60-89,0,0,0
2024-04-19,40,DPD90+,0,0,0
2024-04-19,42,Current,0,0,0
2024-04-19,42,DPD15-29,6,6,0
2024-04-19,42,DPD3-14,21,21,0
2024-04-19,42,DPD30-59,6,6,0
2024-04-19,42,DPD60-89,0,0,0
2024-04-19,42,DPD90+,0,0,0
2024-04-19,44,Current,0,0,0
2024-04-19,44,DPD15-29,24,24,0
2024-04-19,44,DPD3-14,52,52,0
2024-04-19,44,DPD30-59,6,6,0
2024-04-19,44,DPD60-89,0,0,0
2024-04-19,44,DPD90+,0,0,0
2024-04-19,46,Current,0,0,0
2024-04-19,46,DPD3-14,1,1,0
2024-04-19,46,DPD90+,0,0,0
2024-04-19,48,Current,87,87,0
2024-04-19,48,DPD15-29,13,13,0
2024-04-19,48,DPD3-14,39,39,0
2024-04-19,48,DPD30-59,15,15,0
2024-04-19,48,DPD60-89,0,0,0
2024-04-19,48,DPD90+,0,0,0
2024-04-19,6,Current,0,0,0
2024-04-19,6,DPD30-59,0,0,0
2024-04-18,100,Current,0,0,0
2024-04-18,100,DPD15-29,0,0,0
2024-04-18,102,Current,0,0,0
2024-04-18,102,DPD3-14,0,0,0
2024-04-18,102,DPD30-59,0,0,0
2024-04-18,102,DPD90+,0,0,0
2024-04-18,104,Current,0,0,0
2024-04-18,104,DPD30-59,1,1,0
2024-04-18,104,DPD60-89,0,0,0
2024-04-18,20,Current,0,0,0
2024-04-18,20,DPD15-29,183,183,0
2024-04-18,20,DPD3-14,263,263,0
2024-04-18,20,DPD30-59,194,194,0
2024-04-18,20,DPD60-89,71,71,0
2024-04-18,20,DPD90+,44,44,0
2024-04-18,22,Current,0,0,0
2024-04-18,22,DPD15-29,0,0,0
2024-04-18,22,DPD3-14,0,0,0
2024-04-18,22,DPD30-59,0,0,0
2024-04-18,22,DPD60-89,0,0,0
2024-04-18,24,Current,44,44,0
2024-04-18,24,DPD15-29,81,81,0
2024-04-18,24,DPD3-14,158,158,0
2024-04-18,24,DPD30-59,86,86,0
2024-04-18,24,DPD60-89,0,0,0
2024-04-18,24,DPD90+,0,0,0
2024-04-18,26,Current,0,0,0
2024-04-18,26,DPD15-29,9,9,0
2024-04-18,26,DPD3-14,16,16,0
2024-04-18,26,DPD30-59,12,12,0
2024-04-18,26,DPD60-89,0,0,0
2024-04-18,26,DPD90+,0,0,0
2024-04-18,32,Current,0,0,0
2024-04-18,32,DPD15-29,91,91,0
2024-04-18,32,DPD3-14,108,108,0
2024-04-18,32,DPD30-59,85,85,0
2024-04-18,32,DPD60-89,0,0,0
2024-04-18,32,DPD90+,0,0,0
2024-04-18,34,Current,0,0,0
2024-04-18,34,DPD15-29,44,44,0
2024-04-18,34,DPD3-14,47,47,0
2024-04-18,34,DPD30-59,58,58,0
2024-04-18,34,DPD60-89,0,0,0
2024-04-18,34,DPD90+,0,0,0
2024-04-18,36,Current,0,0,0
2024-04-18,36,DPD15-29,24,24,0
2024-04-18,36,DPD3-14,30,30,0
2024-04-18,36,DPD30-59,21,21,0
2024-04-18,36,DPD60-89,0,0,0
2024-04-18,36,DPD90+,0,0,0
2024-04-18,38,Current,0,0,0
2024-04-18,38,DPD15-29,19,19,0
2024-04-18,38,DPD3-14,33,33,0
2024-04-18,38,DPD30-59,29,29,0
2024-04-18,38,DPD60-89,0,0,0
2024-04-18,38,DPD90+,0,0,0
2024-04-18,40,Current,0,0,0
2024-04-18,40,DPD15-29,19,19,0
2024-04-18,40,DPD3-14,35,35,0
2024-04-18,40,DPD30-59,9,9,0
2024-04-18,40,DPD60-89,0,0,0
2024-04-18,40,DPD90+,0,0,0
2024-04-18,42,Current,0,0,0
2024-04-18,42,DPD15-29,13,13,0
2024-04-18,42,DPD3-14,13,13,0
2024-04-18,42,DPD30-59,7,7,0
2024-04-18,42,DPD60-89,0,0,0
2024-04-18,42,DPD90+,0,0,0
2024-04-18,44,Current,0,0,0
2024-04-18,44,DPD15-29,12,12,0
2024-04-18,44,DPD3-14,40,40,0
2024-04-18,44,DPD30-59,23,23,0
2024-04-18,44,DPD60-89,0,0,0
2024-04-18,44,DPD90+,0,0,0
2024-04-18,46,Current,0,0,0
2024-04-18,46,DPD3-14,0,0,0
2024-04-18,46,DPD90+,0,0,0
2024-04-18,48,Current,27,27,0
2024-04-18,48,DPD15-29,7,7,0
2024-04-18,48,DPD3-14,33,33,0
2024-04-18,48,DPD30-59,5,5,0
2024-04-18,48,DPD60-89,0,0,0
2024-04-18,48,DPD90+,0,0,0
2024-04-18,6,Current,0,0,0
2024-04-18,6,DPD30-59,0,0,0
2024-04-17,100,Current,0,0,0
2024-04-17,100,DPD3-14,0,0,0
2024-04-17,102,Current,0,0,0
2024-04-17,102,DPD3-14,1,1,0
2024-04-17,102,DPD30-59,0,0,0
2024-04-17,102,DPD90+,0,0,0
2024-04-17,104,Current,0,0,0
2024-04-17,104,DPD30-59,0,0,0
2024-04-17,104,DPD60-89,0,0,0
2024-04-17,20,Current,0,0,0
2024-04-17,20,DPD15-29,211,211,0
2024-04-17,20,DPD3-14,222,222,0
2024-04-17,20,DPD30-59,93,93,0
2024-04-17,20,DPD60-89,20,20,0
2024-04-17,20,DPD90+,32,32,0
2024-04-17,22,Current,0,0,0
2024-04-17,22,DPD15-29,0,0,0
2024-04-17,22,DPD3-14,0,0,0
2024-04-17,22,DPD30-59,1,1,0
2024-04-17,22,DPD60-89,0,0,0
2024-04-17,24,Current,31,31,0
2024-04-17,24,DPD15-29,125,125,0
2024-04-17,24,DPD3-14,142,142,0
2024-04-17,24,DPD30-59,42,42,0
2024-04-17,24,DPD60-89,0,0,0
2024-04-17,24,DPD90+,0,0,0
2024-04-17,26,Current,0,0,0
2024-04-17,26,DPD15-29,14,14,0
2024-04-17,26,DPD3-14,22,22,0
2024-04-17,26,DPD30-59,2,2,0
2024-04-17,26,DPD60-89,0,0,0
2024-04-17,26,DPD90+,0,0,0
2024-04-17,32,Current,0,0,0
2024-04-17,32,DPD15-29,112,112,0
2024-04-17,32,DPD3-14,102,102,0
2024-04-17,32,DPD30-59,50,50,0
2024-04-17,32,DPD60-89,0,0,0
2024-04-17,32,DPD90+,0,0,0
2024-04-17,34,Current,0,0,0
2024-04-17,34,DPD15-29,56,56,0
2024-04-17,34,DPD3-14,52,52,0
2024-04-17,34,DPD30-59,19,19,0
2024-04-17,34,DPD60-89,0,0,0
2024-04-17,34,DPD90+,0,0,0
2024-04-17,36,Current,0,0,0
2024-04-17,36,DPD15-29,35,35,0
2024-04-17,36,DPD3-14,23,23,0
2024-04-17,36,DPD30-59,14,14,0
2024-04-17,36,DPD60-89,0,0,0
2024-04-17,36,DPD90+,0,0,0
2024-04-17,38,Current,0,0,0
2024-04-17,38,DPD15-29,40,40,0
2024-04-17,38,DPD3-14,34,34,0
2024-04-17,38,DPD30-59,8,8,0
2024-04-17,38,DPD60-89,0,0,0
2024-04-17,38,DPD90+,0,0,0
2024-04-17,40,Current,0,0,0
2024-04-17,40,DPD15-29,23,23,0
2024-04-17,40,DPD3-14,17,17,0
2024-04-17,40,DPD30-59,3,3,0
2024-04-17,40,DPD60-89,0,0,0
2024-04-17,40,DPD90+,0,0,0
2024-04-17,42,Current,0,0,0
2024-04-17,42,DPD15-29,8,8,0
2024-04-17,42,DPD3-14,11,11,0
2024-04-17,42,DPD30-59,6,6,0
2024-04-17,42,DPD60-89,0,0,0
2024-04-17,42,DPD90+,0,0,0
2024-04-17,44,Current,0,0,0
2024-04-17,44,DPD15-29,24,24,0
2024-04-17,44,DPD3-14,22,22,0
2024-04-17,44,DPD30-59,4,4,0
2024-04-17,44,DPD60-89,0,0,0
2024-04-17,44,DPD90+,0,0,0
2024-04-17,46,Current,0,0,0
2024-04-17,46,DPD3-14,1,1,0
2024-04-17,46,DPD90+,0,0,0
2024-04-17,48,Current,18,18,0
2024-04-17,48,DPD15-29,13,13,0
2024-04-17,48,DPD3-14,29,29,0
2024-04-17,48,DPD30-59,12,12,0
2024-04-17,48,DPD60-89,0,0,0
2024-04-17,48,DPD90+,0,0,0
2024-04-17,6,Current,0,0,0
2024-04-17,6,DPD30-59,1,1,0
2024-04-16,100,Current,0,0,0
2024-04-16,100,DPD3-14,0,0,0
2024-04-16,102,Current,0,0,0
2024-04-16,102,DPD3-14,1,1,0
2024-04-16,102,DPD30-59,0,0,0
2024-04-16,102,DPD90+,0,0,0
2024-04-16,104,Current,0,0,0
2024-04-16,104,DPD30-59,0,0,0
2024-04-16,104,DPD60-89,0,0,0
2024-04-16,20,Current,0,0,0
2024-04-16,20,DPD15-29,198,198,0
2024-04-16,20,DPD3-14,256,256,0
2024-04-16,20,DPD30-59,97,97,0
2024-04-16,20,DPD60-89,41,41,0
2024-04-16,20,DPD90+,15,15,0
2024-04-16,22,Current,0,0,0
2024-04-16,22,DPD15-29,0,0,0
2024-04-16,22,DPD3-14,0,0,0
2024-04-16,22,DPD30-59,0,0,0
2024-04-16,22,DPD60-89,0,0,0
2024-04-16,24,Current,30,30,0
2024-04-16,24,DPD15-29,80,80,0
2024-04-16,24,DPD3-14,155,155,0
2024-04-16,24,DPD30-59,44,44,0
2024-04-16,24,DPD60-89,0,0,0
2024-04-16,24,DPD90+,0,0,0
2024-04-16,26,Current,0,0,0
2024-04-16,26,DPD15-29,15,15,0
2024-04-16,26,DPD3-14,19,19,0
2024-04-16,26,DPD30-59,9,9,0
2024-04-16,26,DPD60-89,0,0,0
2024-04-16,26,DPD90+,0,0,0
2024-04-16,32,Current,0,0,0
2024-04-16,32,DPD15-29,81,81,0
2024-04-16,32,DPD3-14,125,125,0
2024-04-16,32,DPD30-59,48,48,0
2024-04-16,32,DPD60-89,0,0,0
2024-04-16,32,DPD90+,0,0,0
2024-04-16,34,Current,0,0,0
2024-04-16,34,DPD15-29,51,51,0
2024-04-16,34,DPD3-14,50,50,0
2024-04-16,34,DPD30-59,28,28,0
2024-04-16,34,DPD60-89,0,0,0
2024-04-16,34,DPD90+,0,0,0
2024-04-16,36,Current,0,0,0
2024-04-16,36,DPD15-29,23,23,0
2024-04-16,36,DPD3-14,33,33,0
2024-04-16,36,DPD30-59,16,16,0
2024-04-16,36,DPD60-89,0,0,0
2024-04-16,36,DPD90+,0,0,0
2024-04-16,38,Current,0,0,0
2024-04-16,38,DPD15-29,20,20,0
2024-04-16,38,DPD3-14,42,42,0
2024-04-16,38,DPD30-59,14,14,0
2024-04-16,38,DPD60-89,0,0,0
2024-04-16,38,DPD90+,0,0,0
2024-04-16,40,Current,0,0,0
2024-04-16,40,DPD15-29,15,15,0
2024-04-16,40,DPD3-14,31,31,0
2024-04-16,40,DPD30-59,8,8,0
2024-04-16,40,DPD60-89,0,0,0
2024-04-16,40,DPD90+,0,0,0
2024-04-16,42,Current,0,0,0
2024-04-16,42,DPD15-29,16,16,0
2024-04-16,42,DPD3-14,15,15,0
2024-04-16,42,DPD30-59,4,4,0
2024-04-16,42,DPD60-89,0,0,0
2024-04-16,42,DPD90+,0,0,0
2024-04-16,44,Current,0,0,0
2024-04-16,44,DPD15-29,12,12,0
2024-04-16,44,DPD3-14,37,37,0
2024-04-16,44,DPD30-59,5,5,0
2024-04-16,44,DPD60-89,0,0,0
2024-04-16,44,DPD90+,0,0,0
2024-04-16,46,Current,0,0,0
2024-04-16,46,DPD3-14,0,0,0
2024-04-16,46,DPD90+,0,0,0
2024-04-16,48,Current,19,19,0
2024-04-16,48,DPD15-29,5,5,0
2024-04-16,48,DPD3-14,23,23,0
2024-04-16,48,DPD30-59,15,15,0
2024-04-16,48,DPD60-89,0,0,0
2024-04-16,48,DPD90+,0,0,0
2024-04-16,6,Current,0,0,0
2024-04-16,6,DPD30-59,0,0,0
2024-04-15,100,Current,0,0,0
2024-04-15,100,DPD3-14,0,0,0
2024-04-15,102,Current,0,0,0
2024-04-15,102,DPD3-14,0,0,0
2024-04-15,102,DPD30-59,0,0,0
2024-04-15,102,DPD90+,0,0,0
2024-04-15,104,Current,0,0,0
2024-04-15,104,DPD3-14,0,0,0
2024-04-15,104,DPD30-59,0,0,0
2024-04-15,104,DPD60-89,0,0,0
2024-04-15,20,Current,5032,5032,0
2024-04-15,20,DPD15-29,264,264,0
2024-04-15,20,DPD3-14,387,387,0
2024-04-15,20,DPD30-59,94,94,0
2024-04-15,20,DPD60-89,32,32,0
2024-04-15,20,DPD90+,30,30,0
2024-04-15,22,Current,0,0,0
2024-04-15,22,DPD15-29,2,2,0
2024-04-15,22,DPD3-14,0,0,0
2024-04-15,22,DPD30-59,0,0,0
2024-04-15,22,DPD60-89,0,0,0
2024-04-15,24,Current,3736,3736,0
2024-04-15,24,DPD15-29,133,133,0
2024-04-15,24,DPD3-14,230,230,0
2024-04-15,24,DPD30-59,43,43,0
2024-04-15,24,DPD60-89,9,9,0
2024-04-15,24,DPD90+,9,9,0
2024-04-15,26,Current,0,0,0
2024-04-15,26,DPD15-29,20,20,0
2024-04-15,26,DPD3-14,25,25,0
2024-04-15,26,DPD30-59,3,3,0
2024-04-15,26,DPD60-89,0,0,0
2024-04-15,26,DPD90+,0,0,0
2024-04-15,32,Current,260,260,0
2024-04-15,32,DPD15-29,127,127,0
2024-04-15,32,DPD3-14,147,147,0
2024-04-15,32,DPD30-59,22,22,0
2024-04-15,32,DPD60-89,2,2,0
2024-04-15,32,DPD90+,2,2,0
2024-04-15,34,Current,0,0,0
2024-04-15,34,DPD15-29,53,53,0
2024-04-15,34,DPD3-14,55,55,0
2024-04-15,34,DPD30-59,4,4,0
2024-04-15,34,DPD60-89,0,0,0
2024-04-15,34,DPD90+,0,0,0
2024-04-15,36,Current,279,279,0
2024-04-15,36,DPD15-29,45,45,0
2024-04-15,36,DPD3-14,40,40,0
2024-04-15,36,DPD30-59,7,7,0
2024-04-15,36,DPD60-89,1,1,0
2024-04-15,36,DPD90+,3,3,0
2024-04-15,38,Current,0,0,0
2024-04-15,38,DPD15-29,40,40,0
2024-04-15,38,DPD3-14,49,49,0
2024-04-15,38,DPD30-59,5,5,0
2024-04-15,38,DPD60-89,0,0,0
2024-04-15,38,DPD90+,0,0,0
2024-04-15,40,Current,312,312,0
2024-04-15,40,DPD15-29,22,22,0
2024-04-15,40,DPD3-14,35,35,0
2024-04-15,40,DPD30-59,3,3,0
2024-04-15,40,DPD60-89,0,0,0
2024-04-15,40,DPD90+,2,2,0
2024-04-15,42,Current,0,0,0
2024-04-15,42,DPD15-29,13,13,0
2024-04-15,42,DPD3-14,11,11,0
2024-04-15,42,DPD30-59,2,2,0
2024-04-15,42,DPD60-89,0,0,0
2024-04-15,42,DPD90+,0,0,0
2024-04-15,44,Current,192,192,0
2024-04-15,44,DPD15-29,25,25,0
2024-04-15,44,DPD3-14,31,31,0
2024-04-15,44,DPD30-59,4,4,0
2024-04-15,44,DPD60-89,2,2,0
2024-04-15,44,DPD90+,1,1,0
2024-04-15,46,Current,5,5,0
2024-04-15,46,DPD3-14,1,1,0
2024-04-15,46,DPD90+,0,0,0
2024-04-15,48,Current,4250,4250,0
2024-04-15,48,DPD15-29,24,24,0
2024-04-15,48,DPD3-14,73,73,0
2024-04-15,48,DPD30-59,22,22,0
2024-04-15,48,DPD60-89,11,11,0
2024-04-15,48,DPD90+,13,13,0
2024-04-15,6,Current,2,2,0
2024-04-15,6,DPD30-59,1,1,0
2024-04-14,100,Current,0,0,0
2024-04-14,100,DPD3-14,0,0,0
2024-04-14,102,Current,0,0,0
2024-04-14,102,DPD3-14,1,1,0
2024-04-14,102,DPD30-59,0,0,0
2024-04-14,102,DPD90+,0,0,0
2024-04-14,104,Current,0,0,0
2024-04-14,104,DPD3-14,1,1,0
2024-04-14,104,DPD30-59,1,1,0
2024-04-14,104,DPD60-89,0,0,0
2024-04-14,20,Current,0,0,0
2024-04-14,20,DPD15-29,244,244,0
2024-04-14,20,DPD3-14,228,228,0
2024-04-14,20,DPD30-59,245,245,0
2024-04-14,20,DPD60-89,101,101,0
2024-04-14,20,DPD90+,68,68,0
2024-04-14,22,Current,0,0,0
2024-04-14,22,DPD15-29,0,0,0
2024-04-14,22,DPD3-14,0,0,0
2024-04-14,22,DPD30-59,0,0,0
2024-04-14,22,DPD60-89,0,0,0
2024-04-14,24,Current,62,62,0
2024-04-14,24,DPD15-29,103,103,0
2024-04-14,24,DPD3-14,121,121,0
2024-04-14,24,DPD30-59,113,113,0
2024-04-14,24,DPD60-89,0,0,0
2024-04-14,24,DPD90+,0,0,0
2024-04-14,26,Current,0,0,0
2024-04-14,26,DPD15-29,19,19,0
2024-04-14,26,DPD3-14,17,17,0
2024-04-14,26,DPD30-59,13,13,0
2024-04-14,26,DPD60-89,0,0,0
2024-04-14,26,DPD90+,0,0,0
2024-04-14,32,Current,0,0,0
2024-04-14,32,DPD15-29,109,109,0
2024-04-14,32,DPD3-14,107,107,0
2024-04-14,32,DPD30-59,114,114,0
2024-04-14,32,DPD60-89,0,0,0
2024-04-14,32,DPD90+,0,0,0
2024-04-14,34,Current,0,0,0
2024-04-14,34,DPD15-29,64,64,0
2024-04-14,34,DPD3-14,45,45,0
2024-04-14,34,DPD30-59,79,79,0
2024-04-14,34,DPD60-89,0,0,0
2024-04-14,34,DPD90+,0,0,0
2024-04-14,36,Current,0,0,0
2024-04-14,36,DPD15-29,28,28,0
2024-04-14,36,DPD3-14,26,26,0
2024-04-14,36,DPD30-59,35,35,0
2024-04-14,36,DPD60-89,0,0,0
2024-04-14,36,DPD90+,0,0,0
2024-04-14,38,Current,0,0,0
2024-04-14,38,DPD15-29,28,28,0
2024-04-14,38,DPD3-14,31,31,0
2024-04-14,38,DPD30-59,35,35,0
2024-04-14,38,DPD60-89,0,0,0
2024-04-14,38,DPD90+,0,0,0
2024-04-14,40,Current,0,0,0
2024-04-14,40,DPD15-29,18,18,0
2024-04-14,40,DPD3-14,26,26,0
2024-04-14,40,DPD30-59,14,14,0
2024-04-14,40,DPD60-89,0,0,0
2024-04-14,40,DPD90+,0,0,0
2024-04-14,42,Current,0,0,0
2024-04-14,42,DPD15-29,19,19,0
2024-04-14,42,DPD3-14,12,12,0
2024-04-14,42,DPD30-59,7,7,0
2024-04-14,42,DPD60-89,0,0,0
2024-04-14,42,DPD90+,0,0,0
2024-04-14,44,Current,0,0,0
2024-04-14,44,DPD15-29,19,19,0
2024-04-14,44,DPD3-14,34,34,0
2024-04-14,44,DPD30-59,28,28,0
2024-04-14,44,DPD60-89,0,0,0
2024-04-14,44,DPD90+,0,0,0
2024-04-14,46,Current,0,0,0
2024-04-14,46,DPD3-14,0,0,0
2024-04-14,46,DPD90+,0,0,0
2024-04-14,48,Current,44,44,0
2024-04-14,48,DPD15-29,10,10,0
2024-04-14,48,DPD3-14,19,19,0
2024-04-14,48,DPD30-59,10,10,0
2024-04-14,48,DPD60-89,0,0,0
2024-04-14,48,DPD90+,0,0,0
2024-04-14,6,Current,0,0,0
2024-04-14,6,DPD30-59,0,0,0
2024-04-13,100,Current,0,0,0
2024-04-13,100,DPD3-14,0,0,0
2024-04-13,102,Current,0,0,0
2024-04-13,102,DPD3-14,0,0,0
2024-04-13,102,DPD30-59,0,0,0
2024-04-13,102,DPD90+,0,0,0
2024-04-13,104,Current,0,0,0
2024-04-13,104,DPD3-14,0,0,0
2024-04-13,104,DPD30-59,0,0,0
2024-04-13,104,DPD60-89,0,0,0
2024-04-13,20,Current,0,0,0
2024-04-13,20,DPD15-29,250,250,0
2024-04-13,20,DPD3-14,250,250,0
2024-04-13,20,DPD30-59,82,82,0
2024-04-13,20,DPD60-89,19,19,0
2024-04-13,20,DPD90+,0,0,0
2024-04-13,22,Current,0,0,0
2024-04-13,22,DPD15-29,2,2,0
2024-04-13,22,DPD3-14,0,0,0
2024-04-13,22,DPD30-59,1,1,0
2024-04-13,24,Current,28,28,0
2024-04-13,24,DPD15-29,131,131,0
2024-04-13,24,DPD3-14,166,166,0
2024-04-13,24,DPD30-59,40,40,0
2024-04-13,24,DPD60-89,0,0,0
2024-04-13,24,DPD90+,0,0,0
2024-04-13,26,Current,0,0,0
2024-04-13,26,DPD15-29,22,22,0
2024-04-13,26,DPD3-14,22,22,0
2024-04-13,26,DPD30-59,1,1,0
2024-04-13,26,DPD60-89,0,0,0
2024-04-13,26,DPD90+,0,0,0
2024-04-13,32,Current,0,0,0
2024-04-13,32,DPD15-29,135,135,0
2024-04-13,32,DPD3-14,114,114,0
2024-04-13,32,DPD30-59,45,45,0
2024-04-13,32,DPD60-89,0,0,0
2024-04-13,32,DPD90+,0,0,0
2024-04-13,34,Current,0,0,0
2024-04-13,34,DPD15-29,57,57,0
2024-04-13,34,DPD3-14,46,46,0
2024-04-13,34,DPD30-59,15,15,0
2024-04-13,34,DPD60-89,0,0,0
2024-04-13,34,DPD90+,0,0,0
2024-04-13,36,Current,0,0,0
2024-04-13,36,DPD15-29,43,43,0
2024-04-13,36,DPD3-14,32,32,0
2024-04-13,36,DPD30-59,11,11,0
2024-04-13,36,DPD60-89,0,0,0
2024-04-13,36,DPD90+,0,0,0
2024-04-13,38,Current,0,0,0
2024-04-13,38,DPD15-29,44,44,0
2024-04-13,38,DPD3-14,41,41,0
2024-04-13,38,DPD30-59,7,7,0
2024-04-13,38,DPD60-89,0,0,0
2024-04-13,38,DPD90+,0,0,0
2024-04-13,40,Current,0,0,0
2024-04-13,40,DPD15-29,24,24,0
2024-04-13,40,DPD3-14,22,22,0
2024-04-13,40,DPD30-59,1,1,0
2024-04-13,40,DPD60-89,0,0,0
2024-04-13,40,DPD90+,0,0,0
2024-04-13,42,Current,0,0,0
2024-04-13,42,DPD15-29,15,15,0
2024-04-13,42,DPD3-14,8,8,0
2024-04-13,42,DPD30-59,4,4,0
2024-04-13,42,DPD60-89,0,0,0
2024-04-13,42,DPD90+,0,0,0
2024-04-13,44,Current,0,0,0
2024-04-13,44,DPD15-29,27,27,0
2024-04-13,44,DPD3-14,24,24,0
2024-04-13,44,DPD30-59,3,3,0
2024-04-13,44,DPD60-89,0,0,0
2024-04-13,44,DPD90+,0,0,0
2024-04-13,46,Current,0,0,0
2024-04-13,46,DPD3-14,1,1,0
2024-04-13,46,DPD90+,0,0,0
2024-04-13,48,Current,39,39,0
2024-04-13,48,DPD15-29,12,12,0
2024-04-13,48,DPD3-14,27,27,0
2024-04-13,48,DPD30-59,9,9,0
2024-04-13,48,DPD60-89,0,0,0
2024-04-13,48,DPD90+,0,0,0
2024-04-13,6,Current,0,0,0
2024-04-13,6,DPD30-59,1,1,0
2024-04-12,100,Current,0,0,0
2024-04-12,100,DPD3-14,0,0,0
2024-04-12,102,Current,0,0,0
2024-04-12,102,DPD3-14,1,1,0
2024-04-12,102,DPD30-59,0,0,0
2024-04-12,102,DPD90+,0,0,0
2024-04-12,104,Current,0,0,0
2024-04-12,104,DPD30-59,0,0,0
2024-04-12,104,DPD60-89,0,0,0
2024-04-12,20,Current,35,35,0
2024-04-12,20,DPD15-29,250,250,0
2024-04-12,20,DPD3-14,199,199,0
2024-04-12,20,DPD30-59,50,50,0
2024-04-12,20,DPD60-89,4,4,0
2024-04-12,20,DPD90+,2,2,0
2024-04-12,22,Current,0,0,0
2024-04-12,22,DPD15-29,0,0,0
2024-04-12,22,DPD3-14,0,0,0
2024-04-12,22,DPD30-59,0,0,0
2024-04-12,24,Current,99,99,0
2024-04-12,24,DPD15-29,105,105,0
2024-04-12,24,DPD3-14,103,103,0
2024-04-12,24,DPD30-59,18,18,0
2024-04-12,24,DPD60-89,0,0,0
2024-04-12,24,DPD90+,0,0,0
2024-04-12,26,Current,0,0,0
2024-04-12,26,DPD15-29,22,22,0
2024-04-12,26,DPD3-14,15,15,0
2024-04-12,26,DPD30-59,6,6,0
2024-04-12,26,DPD60-89,0,0,0
2024-04-12,26,DPD90+,0,0,0
2024-04-12,32,Current,0,0,0
2024-04-12,32,DPD15-29,115,115,0
2024-04-12,32,DPD3-14,92,92,0
2024-04-12,32,DPD30-59,17,17,0
2024-04-12,32,DPD60-89,0,0,0
2024-04-12,32,DPD90+,0,0,0
2024-04-12,34,Current,0,0,0
2024-04-12,34,DPD15-29,69,69,0
2024-04-12,34,DPD3-14,35,35,0
2024-04-12,34,DPD30-59,7,7,0
2024-04-12,34,DPD60-89,0,0,0
2024-04-12,34,DPD90+,0,0,0
2024-04-12,36,Current,0,0,0
2024-04-12,36,DPD15-29,29,29,0
2024-04-12,36,DPD3-14,22,22,0
2024-04-12,36,DPD30-59,5,5,0
2024-04-12,36,DPD60-89,0,0,0
2024-04-12,36,DPD90+,0,0,0
2024-04-12,38,Current,0,0,0
2024-04-12,38,DPD15-29,30,30,0
2024-04-12,38,DPD3-14,28,28,0
2024-04-12,38,DPD30-59,5,5,0
2024-04-12,38,DPD60-89,0,0,0
2024-04-12,38,DPD90+,0,0,0
2024-04-12,40,Current,0,0,0
2024-04-12,40,DPD15-29,16,16,0
2024-04-12,40,DPD3-14,22,22,0
2024-04-12,40,DPD30-59,4,4,0
2024-04-12,40,DPD60-89,0,0,0
2024-04-12,40,DPD90+,0,0,0
2024-04-12,42,Current,0,0,0
2024-04-12,42,DPD15-29,17,17,0
2024-04-12,42,DPD3-14,11,11,0
2024-04-12,42,DPD30-59,1,1,0
2024-04-12,42,DPD60-89,0,0,0
2024-04-12,42,DPD90+,0,0,0
2024-04-12,44,Current,0,0,0
2024-04-12,44,DPD15-29,23,23,0
2024-04-12,44,DPD3-14,33,33,0
2024-04-12,44,DPD30-59,3,3,0
2024-04-12,44,DPD60-89,0,0,0
2024-04-12,44,DPD90+,0,0,0
2024-04-12,46,Current,0,0,0
2024-04-12,46,DPD3-14,0,0,0
2024-04-12,46,DPD90+,0,0,0
2024-04-12,48,Current,87,87,0
2024-04-12,48,DPD15-29,8,8,0
2024-04-12,48,DPD3-14,19,19,0
2024-04-12,48,DPD30-59,7,7,0
2024-04-12,48,DPD60-89,0,0,0
2024-04-12,48,DPD90+,0,0,0
2024-04-12,6,Current,0,0,0
2024-04-12,6,DPD30-59,0,0,0
2024-04-11,100,Current,0,0,0
2024-04-11,100,DPD3-14,0,0,0
2024-04-11,102,Current,0,0,0
2024-04-11,102,DPD3-14,0,0,0
2024-04-11,102,DPD30-59,0,0,0
2024-04-11,102,DPD90+,0,0,0
2024-04-11,104,Current,0,0,0
2024-04-11,104,DPD30-59,0,0,0
2024-04-11,104,DPD60-89,0,0,0
2024-04-11,20,Current,0,0,0
2024-04-11,20,DPD15-29,230,230,0
2024-04-11,20,DPD3-14,301,301,0
2024-04-11,20,DPD30-59,120,120,0
2024-04-11,20,DPD60-89,49,49,0
2024-04-11,20,DPD90+,37,37,0
2024-04-11,22,Current,0,0,0
2024-04-11,22,DPD15-29,1,1,0
2024-04-11,22,DPD3-14,1,1,0
2024-04-11,22,DPD30-59,0,0,0
2024-04-11,22,DPD60-89,0,0,0
2024-04-11,24,Current,18,18,0
2024-04-11,24,DPD15-29,131,131,0
2024-04-11,24,DPD3-14,189,189,0
2024-04-11,24,DPD30-59,66,66,0
2024-04-11,24,DPD60-89,0,0,0
2024-04-11,24,DPD90+,0,0,0
2024-04-11,26,Current,0,0,0
2024-04-11,26,DPD15-29,17,17,0
2024-04-11,26,DPD3-14,31,31,0
2024-04-11,26,DPD30-59,7,7,0
2024-04-11,26,DPD60-89,0,0,0
2024-04-11,26,DPD90+,0,0,0
2024-04-11,32,Current,0,0,0
2024-04-11,32,DPD15-29,121,121,0
2024-04-11,32,DPD3-14,143,143,0
2024-04-11,32,DPD30-59,65,65,0
2024-04-11,32,DPD60-89,0,0,0
2024-04-11,32,DPD90+,0,0,0
2024-04-11,34,Current,0,0,0
2024-04-11,34,DPD15-29,47,47,0
2024-04-11,34,DPD3-14,65,65,0
2024-04-11,34,DPD30-59,34,34,0
2024-04-11,34,DPD60-89,0,0,0
2024-04-11,34,DPD90+,0,0,0
2024-04-11,36,Current,0,0,0
2024-04-11,36,DPD15-29,35,35,0
2024-04-11,36,DPD3-14,45,45,0
2024-04-11,36,DPD30-59,17,17,0
2024-04-11,36,DPD60-89,0,0,0
2024-04-11,36,DPD90+,0,0,0
2024-04-11,38,Current,0,0,0
2024-04-11,38,DPD15-29,41,41,0
2024-04-11,38,DPD3-14,53,53,0
2024-04-11,38,DPD30-59,18,18,0
2024-04-11,38,DPD60-89,0,0,0
2024-04-11,38,DPD90+,0,0,0
2024-04-11,40,Current,0,0,0
2024-04-11,40,DPD15-29,17,17,0
2024-04-11,40,DPD3-14,28,28,0
2024-04-11,40,DPD30-59,8,8,0
2024-04-11,40,DPD60-89,0,0,0
2024-04-11,40,DPD90+,0,0,0
2024-04-11,42,Current,0,0,0
2024-04-11,42,DPD15-29,13,13,0
2024-04-11,42,DPD3-14,15,15,0
2024-04-11,42,DPD30-59,5,5,0
2024-04-11,42,DPD60-89,0,0,0
2024-04-11,42,DPD90+,0,0,0
2024-04-11,44,Current,0,0,0
2024-04-11,44,DPD15-29,21,21,0
2024-04-11,44,DPD3-14,38,38,0
2024-04-11,44,DPD30-59,9,9,0
2024-04-11,44,DPD60-89,0,0,0
2024-04-11,44,DPD90+,0,0,0
2024-04-11,46,Current,0,0,0
2024-04-11,46,DPD3-14,1,1,0
2024-04-11,46,DPD90+,0,0,0
2024-04-11,48,Current,21,21,0
2024-04-11,48,DPD15-29,12,12,0
2024-04-11,48,DPD3-14,33,33,0
2024-04-11,48,DPD30-59,6,6,0
2024-04-11,48,DPD60-89,0,0,0
2024-04-11,48,DPD90+,0,0,0
2024-04-11,6,Current,0,0,0
2024-04-11,6,DPD30-59,0,0,0
2024-04-10,100,Current,0,0,0
2024-04-10,100,DPD3-14,0,0,0
2024-04-10,102,Current,0,0,0
2024-04-10,102,DPD15-29,0,0,0
2024-04-10,102,DPD3-14,0,0,0
2024-04-10,102,DPD30-59,0,0,0
2024-04-10,102,DPD90+,0,0,0
2024-04-10,104,Current,0,0,0
2024-04-10,104,DPD15-29,0,0,0
2024-04-10,104,DPD30-59,1,1,0
2024-04-10,104,DPD60-89,0,0,0
2024-04-10,20,Current,0,0,0
2024-04-10,20,DPD15-29,225,225,0
2024-04-10,20,DPD3-14,198,198,0
2024-04-10,20,DPD30-59,147,147,0
2024-04-10,20,DPD60-89,42,42,0
2024-04-10,20,DPD90+,68,68,0
2024-04-10,22,Current,0,0,0
2024-04-10,22,DPD15-29,0,0,0
2024-04-10,22,DPD3-14,0,0,0
2024-04-10,22,DPD30-59,0,0,0
2024-04-10,22,DPD60-89,0,0,0
2024-04-10,24,Current,24,24,0
2024-04-10,24,DPD15-29,104,104,0
2024-04-10,24,DPD3-14,101,101,0
2024-04-10,24,DPD30-59,69,69,0
2024-04-10,24,DPD60-89,0,0,0
2024-04-10,24,DPD90+,0,0,0
2024-04-10,26,Current,0,0,0
2024-04-10,26,DPD15-29,21,21,0
2024-04-10,26,DPD3-14,16,16,0
2024-04-10,26,DPD30-59,7,7,0
2024-04-10,26,DPD60-89,0,0,0
2024-04-10,26,DPD90+,0,0,0
2024-04-10,32,Current,0,0,0
2024-04-10,32,DPD15-29,97,97,0
2024-04-10,32,DPD3-14,87,87,0
2024-04-10,32,DPD30-59,56,56,0
2024-04-10,32,DPD60-89,0,0,0
2024-04-10,32,DPD90+,0,0,0
2024-04-10,34,Current,0,0,0
2024-04-10,34,DPD15-29,60,60,0
2024-04-10,34,DPD3-14,43,43,0
2024-04-10,34,DPD30-59,47,47,0
2024-04-10,34,DPD60-89,0,0,0
2024-04-10,34,DPD90+,0,0,0
2024-04-10,36,Current,0,0,0
2024-04-10,36,DPD15-29,28,28,0
2024-04-10,36,DPD3-14,20,20,0
2024-04-10,36,DPD30-59,19,19,0
2024-04-10,36,DPD60-89,0,0,0
2024-04-10,36,DPD90+,0,0,0
2024-04-10,38,Current,0,0,0
2024-04-10,38,DPD15-29,32,32,0
2024-04-10,38,DPD3-14,27,27,0
2024-04-10,38,DPD30-59,17,17,0
2024-04-10,38,DPD60-89,0,0,0
2024-04-10,38,DPD90+,0,0,0
2024-04-10,40,Current,0,0,0
2024-04-10,40,DPD15-29,13,13,0
2024-04-10,40,DPD3-14,23,23,0
2024-04-10,40,DPD30-59,7,7,0
2024-04-10,40,DPD60-89,0,0,0
2024-04-10,40,DPD90+,0,0,0
2024-04-10,42,Current,0,0,0
2024-04-10,42,DPD15-29,17,17,0
2024-04-10,42,DPD3-14,12,12,0
2024-04-10,42,DPD30-59,6,6,0
2024-04-10,42,DPD60-89,0,0,0
2024-04-10,42,DPD90+,0,0,0
2024-04-10,44,Current,0,0,0
2024-04-10,44,DPD15-29,21,21,0
2024-04-10,44,DPD3-14,27,27,0
2024-04-10,44,DPD30-59,23,23,0
2024-04-10,44,DPD60-89,0,0,0
2024-04-10,44,DPD90+,0,0,0
2024-04-10,46,Current,0,0,0
2024-04-10,46,DPD3-14,0,0,0
2024-04-10,46,DPD90+,0,0,0
2024-04-10,48,Current,45,45,0
2024-04-10,48,DPD15-29,14,14,0
2024-04-10,48,DPD3-14,18,18,0
2024-04-10,48,DPD30-59,8,8,0
2024-04-10,48,DPD60-89,0,0,0
2024-04-10,48,DPD90+,0,0,0
2024-04-10,6,Current,0,0,0
2024-04-10,6,DPD30-59,0,0,0
2024-04-09,100,Current,0,0,0
2024-04-09,100,DPD3-14,0,0,0
2024-04-09,102,Current,0,0,0
2024-04-09,102,DPD15-29,0,0,0
2024-04-09,102,DPD3-14,0,0,0
2024-04-09,102,DPD30-59,0,0,0
2024-04-09,102,DPD90+,0,0,0
2024-04-09,104,Current,0,0,0
2024-04-09,104,DPD15-29,1,1,0
2024-04-09,104,DPD30-59,0,0,0
2024-04-09,104,DPD60-89,0,0,0
2024-04-09,20,Current,0,0,0
2024-04-09,20,DPD15-29,222,222,0
2024-04-09,20,DPD3-14,352,352,0
2024-04-09,20,DPD30-59,85,85,0
2024-04-09,20,DPD60-89,21,21,0
2024-04-09,20,DPD90+,47,47,0
2024-04-09,22,Current,0,0,0
2024-04-09,22,DPD3-14,2,2,0
2024-04-09,22,DPD30-59,0,0,0
2024-04-09,22,DPD60-89,0,0,0
2024-04-09,24,Current,27,27,0
2024-04-09,24,DPD15-29,147,147,0
2024-04-09,24,DPD3-14,179,179,0
2024-04-09,24,DPD30-59,35,35,0
2024-04-09,24,DPD60-89,0,0,0
2024-04-09,24,DPD90+,0,0,0
2024-04-09,26,Current,0,0,0
2024-04-09,26,DPD15-29,15,15,0
2024-04-09,26,DPD3-14,34,34,0
2024-04-09,26,DPD30-59,2,2,0
2024-04-09,26,DPD60-89,0,0,0
2024-04-09,26,DPD90+,0,0,0
2024-04-09,32,Current,0,0,0
2024-04-09,32,DPD15-29,116,116,0
2024-04-09,32,DPD3-14,142,142,0
2024-04-09,32,DPD30-59,42,42,0
2024-04-09,32,DPD60-89,0,0,0
2024-04-09,32,DPD90+,0,0,0
2024-04-09,34,Current,0,0,0
2024-04-09,34,DPD15-29,44,44,0
2024-04-09,34,DPD3-14,62,62,0
2024-04-09,34,DPD30-59,15,15,0
2024-04-09,34,DPD60-89,0,0,0
2024-04-09,34,DPD90+,0,0,0
2024-04-09,36,Current,0,0,0
2024-04-09,36,DPD15-29,36,36,0
2024-04-09,36,DPD3-14,45,45,0
2024-04-09,36,DPD30-59,12,12,0
2024-04-09,36,DPD60-89,0,0,0
2024-04-09,36,DPD90+,0,0,0
2024-04-09,38,Current,0,0,0
2024-04-09,38,DPD15-29,35,35,0
2024-04-09,38,DPD3-14,56,56,0
2024-04-09,38,DPD30-59,7,7,0
2024-04-09,38,DPD60-89,0,0,0
2024-04-09,38,DPD90+,0,0,0
2024-04-09,40,Current,0,0,0
2024-04-09,40,DPD15-29,17,17,0
2024-04-09,40,DPD3-14,31,31,0
2024-04-09,40,DPD30-59,2,2,0
2024-04-09,40,DPD60-89,0,0,0
2024-04-09,40,DPD90+,0,0,0
2024-04-09,42,Current,0,0,0
2024-04-09,42,DPD15-29,12,12,0
2024-04-09,42,DPD3-14,15,15,0
2024-04-09,42,DPD30-59,3,3,0
2024-04-09,42,DPD60-89,0,0,0
2024-04-09,42,DPD90+,0,0,0
2024-04-09,44,Current,0,0,0
2024-04-09,44,DPD15-29,22,22,0
2024-04-09,44,DPD3-14,36,36,0
2024-04-09,44,DPD30-59,5,5,0
2024-04-09,44,DPD60-89,0,0,0
2024-04-09,44,DPD90+,0,0,0
2024-04-09,46,Current,0,0,0
2024-04-09,46,DPD90+,0,0,0
2024-04-09,48,Current,34,34,0
2024-04-09,48,DPD15-29,12,12,0
2024-04-09,48,DPD3-14,33,33,0
2024-04-09,48,DPD30-59,9,9,0
2024-04-09,48,DPD60-89,0,0,0
2024-04-09,48,DPD90+,0,0,0
2024-04-09,6,Current,0,0,0
2024-04-09,6,DPD30-59,1,1,0
2024-04-08,100,Current,0,0,0
2024-04-08,100,DPD3-14,0,0,0
2024-04-08,102,Current,0,0,0
2024-04-08,102,DPD15-29,0,0,0
2024-04-08,102,DPD3-14,0,0,0
2024-04-08,102,DPD30-59,0,0,0
2024-04-08,102,DPD90+,0,0,0
2024-04-08,104,Current,0,0,0
2024-04-08,104,DPD15-29,0,0,0
2024-04-08,104,DPD3-14,0,0,0
2024-04-08,104,DPD30-59,0,0,0
2024-04-08,104,DPD60-89,0,0,0
2024-04-08,20,Current,0,0,0
2024-04-08,20,DPD15-29,220,220,0
2024-04-08,20,DPD3-14,235,235,0
2024-04-08,20,DPD30-59,51,51,0
2024-04-08,20,DPD60-89,52,52,0
2024-04-08,20,DPD90+,16,16,0
2024-04-08,22,Current,0,0,0
2024-04-08,22,DPD3-14,0,0,0
2024-04-08,22,DPD30-59,0,0,0
2024-04-08,22,DPD60-89,0,0,0
2024-04-08,24,Current,24,24,0
2024-04-08,24,DPD15-29,103,103,0
2024-04-08,24,DPD3-14,105,105,0
2024-04-08,24,DPD30-59,17,17,0
2024-04-08,24,DPD60-89,0,0,0
2024-04-08,24,DPD90+,0,0,0
2024-04-08,26,Current,0,0,0
2024-04-08,26,DPD15-29,24,24,0
2024-04-08,26,DPD3-14,14,14,0
2024-04-08,26,DPD30-59,3,3,0
2024-04-08,26,DPD60-89,0,0,0
2024-04-08,26,DPD90+,0,0,0
2024-04-08,32,Current,0,0,0
2024-04-08,32,DPD15-29,100,100,0
2024-04-08,32,DPD3-14,111,111,0
2024-04-08,32,DPD30-59,19,19,0
2024-04-08,32,DPD60-89,0,0,0
2024-04-08,32,DPD90+,0,0,0
2024-04-08,34,Current,0,0,0
2024-04-08,34,DPD15-29,67,67,0
2024-04-08,34,DPD3-14,44,44,0
2024-04-08,34,DPD30-59,7,7,0
2024-04-08,34,DPD60-89,0,0,0
2024-04-08,34,DPD90+,0,0,0
2024-04-08,36,Current,0,0,0
2024-04-08,36,DPD15-29,28,28,0
2024-04-08,36,DPD3-14,20,20,0
2024-04-08,36,DPD30-59,4,4,0
2024-04-08,36,DPD60-89,0,0,0
2024-04-08,36,DPD90+,0,0,0
2024-04-08,38,Current,0,0,0
2024-04-08,38,DPD15-29,37,37,0
2024-04-08,38,DPD3-14,25,25,0
2024-04-08,38,DPD30-59,3,3,0
2024-04-08,38,DPD60-89,0,0,0
2024-04-08,38,DPD90+,0,0,0
2024-04-08,40,Current,0,0,0
2024-04-08,40,DPD15-29,14,14,0
2024-04-08,40,DPD3-14,30,30,0
2024-04-08,40,DPD30-59,6,6,0
2024-04-08,40,DPD60-89,0,0,0
2024-04-08,40,DPD90+,0,0,0
2024-04-08,42,Current,0,0,0
2024-04-08,42,DPD15-29,16,16,0
2024-04-08,42,DPD3-14,12,12,0
2024-04-08,42,DPD30-59,2,2,0
2024-04-08,42,DPD60-89,0,0,0
2024-04-08,42,DPD90+,0,0,0
2024-04-08,44,Current,0,0,0
2024-04-08,44,DPD15-29,22,22,0
2024-04-08,44,DPD3-14,26,26,0
2024-04-08,44,DPD30-59,3,3,0
2024-04-08,44,DPD60-89,0,0,0
2024-04-08,44,DPD90+,0,0,0
2024-04-08,46,Current,0,0,0
2024-04-08,46,DPD90+,0,0,0
2024-04-08,48,Current,36,36,0
2024-04-08,48,DPD15-29,15,15,0
2024-04-08,48,DPD3-14,17,17,0
2024-04-08,48,DPD30-59,4,4,0
2024-04-08,48,DPD60-89,0,0,0
2024-04-08,48,DPD90+,0,0,0
2024-04-08,6,Current,0,0,0
2024-04-08,6,DPD30-59,0,0,0
2024-04-07,100,Current,0,0,0
2024-04-07,100,DPD3-14,2,2,0
2024-04-07,102,Current,0,0,0
2024-04-07,102,DPD15-29,0,0,0
2024-04-07,102,DPD3-14,0,0,0
2024-04-07,102,DPD30-59,0,0,0
2024-04-07,102,DPD90+,0,0,0
2024-04-07,104,Current,0,0,0
2024-04-07,104,DPD15-29,1,1,0
2024-04-07,104,DPD3-14,1,1,0
2024-04-07,104,DPD30-59,0,0,0
2024-04-07,104,DPD60-89,0,0,0
2024-04-07,20,Current,0,0,0
2024-04-07,20,DPD15-29,215,215,0
2024-04-07,20,DPD3-14,349,349,0
2024-04-07,20,DPD30-59,135,135,0
2024-04-07,20,DPD60-89,7,7,0
2024-04-07,20,DPD90+,0,0,0
2024-04-07,22,Current,0,0,0
2024-04-07,22,DPD15-29,1,1,0
2024-04-07,22,DPD3-14,2,2,0
2024-04-07,22,DPD30-59,0,0,0
2024-04-07,22,DPD60-89,0,0,0
2024-04-07,24,Current,54,54,0
2024-04-07,24,DPD15-29,140,140,0
2024-04-07,24,DPD3-14,186,186,0
2024-04-07,24,DPD30-59,65,65,0
2024-04-07,24,DPD60-89,0,0,0
2024-04-07,24,DPD90+,0,0,0
2024-04-07,26,Current,0,0,0
2024-04-07,26,DPD15-29,20,20,0
2024-04-07,26,DPD3-14,30,30,0
2024-04-07,26,DPD30-59,8,8,0
2024-04-07,26,DPD60-89,0,0,0
2024-04-07,26,DPD90+,0,0,0
2024-04-07,32,Current,0,0,0
2024-04-07,32,DPD15-29,103,103,0
2024-04-07,32,DPD3-14,170,170,0
2024-04-07,32,DPD30-59,76,76,0
2024-04-07,32,DPD60-89,0,0,0
2024-04-07,32,DPD90+,0,0,0
2024-04-07,34,Current,0,0,0
2024-04-07,34,DPD15-29,42,42,0
2024-04-07,34,DPD3-14,67,67,0
2024-04-07,34,DPD30-59,36,36,0
2024-04-07,34,DPD60-89,0,0,0
2024-04-07,34,DPD90+,0,0,0
2024-04-07,36,Current,0,0,0
2024-04-07,36,DPD15-29,34,34,0
2024-04-07,36,DPD3-14,43,43,0
2024-04-07,36,DPD30-59,19,19,0
2024-04-07,36,DPD60-89,0,0,0
2024-04-07,36,DPD90+,0,0,0
2024-04-07,38,Current,0,0,0
2024-04-07,38,DPD15-29,28,28,0
2024-04-07,38,DPD3-14,63,63,0
2024-04-07,38,DPD30-59,21,21,0
2024-04-07,38,DPD60-89,0,0,0
2024-04-07,38,DPD90+,0,0,0
2024-04-07,40,Current,0,0,0
2024-04-07,40,DPD15-29,15,15,0
2024-04-07,40,DPD3-14,37,37,0
2024-04-07,40,DPD30-59,7,7,0
2024-04-07,40,DPD60-89,0,0,0
2024-04-07,40,DPD90+,0,0,0
2024-04-07,42,Current,0,0,0
2024-04-07,42,DPD15-29,10,10,0
2024-04-07,42,DPD3-14,17,17,0
2024-04-07,42,DPD30-59,6,6,0
2024-04-07,42,DPD60-89,0,0,0
2024-04-07,42,DPD90+,0,0,0
2024-04-07,44,Current,0,0,0
2024-04-07,44,DPD15-29,20,20,0
2024-04-07,44,DPD3-14,42,42,0
2024-04-07,44,DPD30-59,11,11,0
2024-04-07,44,DPD60-89,0,0,0
2024-04-07,44,DPD90+,0,0,0
2024-04-07,46,Current,0,0,0
2024-04-07,46,DPD90+,0,0,0
2024-04-07,48,Current,63,63,0
2024-04-07,48,DPD15-29,14,14,0
2024-04-07,48,DPD3-14,25,25,0
2024-04-07,48,DPD30-59,6,6,0
2024-04-07,48,DPD60-89,0,0,0
2024-04-07,48,DPD90+,0,0,0
2024-04-07,6,Current,0,0,0
2024-04-07,6,DPD30-59,0,0,0
2024-04-06,100,Current,0,0,0
2024-04-06,100,DPD3-14,0,0,0
2024-04-06,102,Current,0,0,0
2024-04-06,102,DPD15-29,0,0,0
2024-04-06,102,DPD3-14,0,0,0
2024-04-06,102,DPD30-59,0,0,0
2024-04-06,102,DPD90+,0,0,0
2024-04-06,104,Current,0,0,0
2024-04-06,104,DPD15-29,0,0,0
2024-04-06,104,DPD3-14,0,0,0
2024-04-06,104,DPD30-59,1,1,0
2024-04-06,104,DPD60-89,0,0,0
2024-04-06,20,Current,1,1,0
2024-04-06,20,DPD15-29,200,200,0
2024-04-06,20,DPD3-14,225,225,0
2024-04-06,20,DPD30-59,155,155,0
2024-04-06,20,DPD60-89,75,75,0
2024-04-06,20,DPD90+,64,64,0
2024-04-06,22,Current,0,0,0
2024-04-06,22,DPD15-29,0,0,0
2024-04-06,22,DPD3-14,0,0,0
2024-04-06,22,DPD30-59,0,0,0
2024-04-06,22,DPD60-89,0,0,0
2024-04-06,24,Current,36,36,0
2024-04-06,24,DPD15-29,89,89,0
2024-04-06,24,DPD3-14,103,103,0
2024-04-06,24,DPD30-59,69,69,0
2024-04-06,24,DPD60-89,0,0,0
2024-04-06,24,DPD90+,0,0,0
2024-04-06,26,Current,0,0,0
2024-04-06,26,DPD15-29,19,19,0
2024-04-06,26,DPD3-14,15,15,0
2024-04-06,26,DPD30-59,9,9,0
2024-04-06,26,DPD60-89,0,0,0
2024-04-06,26,DPD90+,0,0,0
2024-04-06,32,Current,0,0,0
2024-04-06,32,DPD15-29,91,91,0
2024-04-06,32,DPD3-14,116,116,0
2024-04-06,32,DPD30-59,56,56,0
2024-04-06,32,DPD60-89,0,0,0
2024-04-06,32,DPD90+,0,0,0
2024-04-06,34,Current,0,0,0
2024-04-06,34,DPD15-29,60,60,0
2024-04-06,34,DPD3-14,46,46,0
2024-04-06,34,DPD30-59,48,48,0
2024-04-06,34,DPD60-89,0,0,0
2024-04-06,34,DPD90+,0,0,0
2024-04-06,36,Current,0,0,0
2024-04-06,36,DPD15-29,27,27,0
2024-04-06,36,DPD3-14,22,22,0
2024-04-06,36,DPD30-59,19,19,0
2024-04-06,36,DPD60-89,0,0,0
2024-04-06,36,DPD90+,0,0,0
2024-04-06,38,Current,0,0,0
2024-04-06,38,DPD15-29,32,32,0
2024-04-06,38,DPD3-14,27,27,0
2024-04-06,38,DPD30-59,17,17,0
2024-04-06,38,DPD60-89,0,0,0
2024-04-06,38,DPD90+,0,0,0
2024-04-06,40,Current,0,0,0
2024-04-06,40,DPD15-29,12,12,0
2024-04-06,40,DPD3-14,27,27,0
2024-04-06,40,DPD30-59,8,8,0
2024-04-06,40,DPD60-89,0,0,0
2024-04-06,40,DPD90+,0,0,0
2024-04-06,42,Current,0,0,0
2024-04-06,42,DPD15-29,12,12,0
2024-04-06,42,DPD3-14,16,16,0
2024-04-06,42,DPD30-59,6,6,0
2024-04-06,42,DPD60-89,0,0,0
2024-04-06,42,DPD90+,0,0,0
2024-04-06,44,Current,0,0,0
2024-04-06,44,DPD15-29,17,17,0
2024-04-06,44,DPD3-14,22,22,0
2024-04-06,44,DPD30-59,25,25,0
2024-04-06,44,DPD60-89,0,0,0
2024-04-06,44,DPD90+,0,0,0
2024-04-06,46,Current,0,0,0
2024-04-06,46,DPD90+,0,0,0
2024-04-06,48,Current,55,55,0
2024-04-06,48,DPD15-29,17,17,0
2024-04-06,48,DPD3-14,12,12,0
2024-04-06,48,DPD30-59,10,10,0
2024-04-06,48,DPD60-89,0,0,0
2024-04-06,48,DPD90+,0,0,0
2024-04-06,6,Current,0,0,0
2024-04-06,6,DPD15-29,0,0,0
2024-04-06,6,DPD30-59,0,0,0
2024-04-05,100,Current,0,0,0
2024-04-05,100,DPD3-14,1,1,0
2024-04-05,102,Current,0,0,0
2024-04-05,102,DPD15-29,0,0,0
2024-04-05,102,DPD3-14,0,0,0
2024-04-05,102,DPD30-59,0,0,0
2024-04-05,102,DPD90+,0,0,0
2024-04-05,104,Current,0,0,0
2024-04-05,104,DPD15-29,1,1,0
2024-04-05,104,DPD30-59,0,0,0
2024-04-05,104,DPD60-89,0,0,0
2024-04-05,20,Current,143,143,0
2024-04-05,20,DPD15-29,221,221,0
2024-04-05,20,DPD3-14,358,358,0
2024-04-05,20,DPD30-59,73,73,0
2024-04-05,20,DPD60-89,17,17,0
2024-04-05,20,DPD90+,1,1,0
2024-04-05,22,Current,0,0,0
2024-04-05,22,DPD15-29,1,1,0
2024-04-05,22,DPD3-14,2,2,0
2024-04-05,22,DPD30-59,0,0,0
2024-04-05,22,DPD60-89,0,0,0
2024-04-05,24,Current,250,250,0
2024-04-05,24,DPD15-29,128,128,0
2024-04-05,24,DPD3-14,201,201,0
2024-04-05,24,DPD30-59,32,32,0
2024-04-05,24,DPD60-89,0,0,0
2024-04-05,24,DPD90+,0,0,0
2024-04-05,26,Current,5,5,0
2024-04-05,26,DPD15-29,20,20,0
2024-04-05,26,DPD3-14,35,35,0
2024-04-05,26,DPD30-59,0,0,0
2024-04-05,26,DPD60-89,0,0,0
2024-04-05,26,DPD90+,0,0,0
2024-04-05,32,Current,37,37,0
2024-04-05,32,DPD15-29,103,103,0
2024-04-05,32,DPD3-14,180,180,0
2024-04-05,32,DPD30-59,35,35,0
2024-04-05,32,DPD60-89,0,0,0
2024-04-05,32,DPD90+,0,0,0
2024-04-05,34,Current,7,7,0
2024-04-05,34,DPD15-29,37,37,0
2024-04-05,34,DPD3-14,72,72,0
2024-04-05,34,DPD30-59,11,11,0
2024-04-05,34,DPD60-89,0,0,0
2024-04-05,34,DPD90+,0,0,0
2024-04-05,36,Current,11,11,0
2024-04-05,36,DPD15-29,38,38,0
2024-04-05,36,DPD3-14,46,46,0
2024-04-05,36,DPD30-59,10,10,0
2024-04-05,36,DPD60-89,0,0,0
2024-04-05,36,DPD90+,0,0,0
2024-04-05,38,Current,11,11,0
2024-04-05,38,DPD15-29,23,23,0
2024-04-05,38,DPD3-14,71,71,0
2024-04-05,38,DPD30-59,6,6,0
2024-04-05,38,DPD60-89,0,0,0
2024-04-05,38,DPD90+,0,0,0
2024-04-05,40,Current,9,9,0
2024-04-05,40,DPD15-29,16,16,0
2024-04-05,40,DPD3-14,40,40,0
2024-04-05,40,DPD30-59,2,2,0
2024-04-05,40,DPD60-89,0,0,0
2024-04-05,40,DPD90+,0,0,0
2024-04-05,42,Current,5,5,0
2024-04-05,42,DPD15-29,8,8,0
2024-04-05,42,DPD3-14,17,17,0
2024-04-05,42,DPD30-59,3,3,0
2024-04-05,42,DPD60-89,0,0,0
2024-04-05,42,DPD90+,0,0,0
2024-04-05,44,Current,22,22,0
2024-04-05,44,DPD15-29,20,20,0
2024-04-05,44,DPD3-14,44,44,0
2024-04-05,44,DPD30-59,5,5,0
2024-04-05,44,DPD60-89,0,0,0
2024-04-05,44,DPD90+,0,0,0
2024-04-05,46,Current,0,0,0
2024-04-05,46,DPD90+,0,0,0
2024-04-05,48,Current,226,226,0
2024-04-05,48,DPD15-29,15,15,0
2024-04-05,48,DPD3-14,22,22,0
2024-04-05,48,DPD30-59,6,6,0
2024-04-05,48,DPD60-89,0,0,0
2024-04-05,48,DPD90+,0,0,0
2024-04-05,6,Current,0,0,0
2024-04-05,6,DPD15-29,1,1,0
2024-04-05,6,DPD30-59,0,0,0
2024-04-04,100,Current,0,0,0
2024-04-04,100,DPD3-14,0,0,0
2024-04-04,102,Current,0,0,0
2024-04-04,102,DPD15-29,0,0,0
2024-04-04,102,DPD3-14,0,0,0
2024-04-04,102,DPD30-59,0,0,0
2024-04-04,102,DPD90+,0,0,0
2024-04-04,104,Current,0,0,0
2024-04-04,104,DPD15-29,0,0,0
2024-04-04,104,DPD30-59,0,0,0
2024-04-04,104,DPD60-89,0,0,0
2024-04-04,20,Current,0,0,0
2024-04-04,20,DPD15-29,200,200,0
2024-04-04,20,DPD3-14,248,248,0
2024-04-04,20,DPD30-59,22,22,0
2024-04-04,20,DPD60-89,3,3,0
2024-04-04,20,DPD90+,0,0,0
2024-04-04,22,Current,0,0,0
2024-04-04,22,DPD15-29,0,0,0
2024-04-04,22,DPD3-14,1,1,0
2024-04-04,22,DPD30-59,0,0,0
2024-04-04,22,DPD60-89,0,0,0
2024-04-04,24,Current,15,15,0
2024-04-04,24,DPD15-29,99,99,0
2024-04-04,24,DPD3-14,96,96,0
2024-04-04,24,DPD30-59,6,6,0
2024-04-04,24,DPD60-89,0,0,0
2024-04-04,24,DPD90+,0,0,0
2024-04-04,26,Current,0,0,0
2024-04-04,26,DPD15-29,15,15,0
2024-04-04,26,DPD3-14,18,18,0
2024-04-04,26,DPD30-59,2,2,0
2024-04-04,26,DPD60-89,0,0,0
2024-04-04,26,DPD90+,0,0,0
2024-04-04,32,Current,0,0,0
2024-04-04,32,DPD15-29,99,99,0
2024-04-04,32,DPD3-14,117,117,0
2024-04-04,32,DPD30-59,12,12,0
2024-04-04,32,DPD60-89,0,0,0
2024-04-04,32,DPD90+,0,0,0
2024-04-04,34,Current,0,0,0
2024-04-04,34,DPD15-29,61,61,0
2024-04-04,34,DPD3-14,52,52,0
2024-04-04,34,DPD30-59,2,2,0
2024-04-04,34,DPD60-89,0,0,0
2024-04-04,34,DPD90+,0,0,0
2024-04-04,36,Current,0,0,0
2024-04-04,36,DPD15-29,28,28,0
2024-04-04,36,DPD3-14,30,30,0
2024-04-04,36,DPD30-59,1,1,0
2024-04-04,36,DPD60-89,0,0,0
2024-04-04,36,DPD90+,0,0,0
2024-04-04,38,Current,0,0,0
2024-04-04,38,DPD15-29,31,31,0
2024-04-04,38,DPD3-14,32,32,0
2024-04-04,38,DPD30-59,2,2,0
2024-04-04,38,DPD60-89,0,0,0
2024-04-04,38,DPD90+,0,0,0
2024-04-04,40,Current,0,0,0
2024-04-04,40,DPD15-29,11,11,0
2024-04-04,40,DPD3-14,27,27,0
2024-04-04,40,DPD30-59,3,3,0
2024-04-04,40,DPD60-89,0,0,0
2024-04-04,40,DPD90+,0,0,0
2024-04-04,42,Current,0,0,0
2024-04-04,42,DPD15-29,9,9,0
2024-04-04,42,DPD3-14,15,15,0
2024-04-04,42,DPD30-59,1,1,0
2024-04-04,42,DPD60-89,0,0,0
2024-04-04,42,DPD90+,0,0,0
2024-04-04,44,Current,0,0,0
2024-04-04,44,DPD15-29,20,20,0
2024-04-04,44,DPD3-14,20,20,0
2024-04-04,44,DPD30-59,2,2,0
2024-04-04,44,DPD60-89,0,0,0
2024-04-04,44,DPD90+,0,0,0
2024-04-04,46,Current,0,0,0
2024-04-04,46,DPD90+,0,0,0
2024-04-04,48,Current,27,27,0
2024-04-04,48,DPD15-29,21,21,0
2024-04-04,48,DPD3-14,13,13,0
2024-04-04,48,DPD30-59,3,3,0
2024-04-04,48,DPD60-89,0,0,0
2024-04-04,48,DPD90+,0,0,0
2024-04-04,6,Current,0,0,0
2024-04-04,6,DPD15-29,0,0,0
2024-04-04,6,DPD30-59,0,0,0
2024-04-03,100,Current,0,0,0
2024-04-03,102,Current,0,0,0
2024-04-03,102,DPD15-29,0,0,0
2024-04-03,102,DPD30-59,0,0,0
2024-04-03,102,DPD90+,0,0,0
2024-04-03,104,Current,0,0,0
2024-04-03,104,DPD15-29,1,1,0
2024-04-03,104,DPD30-59,0,0,0
2024-04-03,104,DPD60-89,0,0,0
2024-04-03,20,Current,0,0,0
2024-04-03,20,DPD15-29,188,188,0
2024-04-03,20,DPD3-14,327,327,0
2024-04-03,20,DPD30-59,142,142,0
2024-04-03,20,DPD60-89,47,47,0
2024-04-03,20,DPD90+,47,47,0
2024-04-03,22,Current,0,0,0
2024-04-03,22,DPD15-29,1,1,0
2024-04-03,22,DPD3-14,3,3,0
2024-04-03,22,DPD30-59,0,0,0
2024-04-03,22,DPD60-89,0,0,0
2024-04-03,24,Current,22,22,0
2024-04-03,24,DPD15-29,103,103,0
2024-04-03,24,DPD3-14,168,168,0
2024-04-03,24,DPD30-59,63,63,0
2024-04-03,24,DPD60-89,0,0,0
2024-04-03,24,DPD90+,0,0,0
2024-04-03,26,Current,0,0,0
2024-04-03,26,DPD15-29,17,17,0
2024-04-03,26,DPD3-14,28,28,0
2024-04-03,26,DPD30-59,6,6,0
2024-04-03,26,DPD60-89,0,0,0
2024-04-03,26,DPD90+,0,0,0
2024-04-03,32,Current,0,0,0
2024-04-03,32,DPD15-29,85,85,0
2024-04-03,32,DPD3-14,151,151,0
2024-04-03,32,DPD30-59,78,78,0
2024-04-03,32,DPD60-89,0,0,0
2024-04-03,32,DPD90+,0,0,0
2024-04-03,34,Current,0,0,0
2024-04-03,34,DPD15-29,31,31,0
2024-04-03,34,DPD3-14,72,72,0
2024-04-03,34,DPD30-59,35,35,0
2024-04-03,34,DPD60-89,0,0,0
2024-04-03,34,DPD90+,0,0,0
2024-04-03,36,Current,0,0,0
2024-04-03,36,DPD15-29,31,31,0
2024-04-03,36,DPD3-14,48,48,0
2024-04-03,36,DPD30-59,17,17,0
2024-04-03,36,DPD60-89,0,0,0
2024-04-03,36,DPD90+,0,0,0
2024-04-03,38,Current,0,0,0
2024-04-03,38,DPD15-29,17,17,0
2024-04-03,38,DPD3-14,59,59,0
2024-04-03,38,DPD30-59,20,20,0
2024-04-03,38,DPD60-89,0,0,0
2024-04-03,38,DPD90+,0,0,0
2024-04-03,40,Current,0,0,0
2024-04-03,40,DPD15-29,12,12,0
2024-04-03,40,DPD3-14,28,28,0
2024-04-03,40,DPD30-59,8,8,0
2024-04-03,40,DPD60-89,0,0,0
2024-04-03,40,DPD90+,0,0,0
2024-04-03,42,Current,0,0,0
2024-04-03,42,DPD15-29,12,12,0
2024-04-03,42,DPD3-14,17,17,0
2024-04-03,42,DPD30-59,5,5,0
2024-04-03,42,DPD60-89,0,0,0
2024-04-03,42,DPD90+,0,0,0
2024-04-03,44,Current,0,0,0
2024-04-03,44,DPD15-29,16,16,0
2024-04-03,44,DPD3-14,33,33,0
2024-04-03,44,DPD30-59,14,14,0
2024-04-03,44,DPD60-89,0,0,0
2024-04-03,44,DPD90+,0,0,0
2024-04-03,46,Current,0,0,0
2024-04-03,46,DPD90+,0,0,0
2024-04-03,48,Current,23,23,0
2024-04-03,48,DPD15-29,15,15,0
2024-04-03,48,DPD3-14,16,16,0
2024-04-03,48,DPD30-59,7,7,0
2024-04-03,48,DPD60-89,0,0,0
2024-04-03,48,DPD90+,0,0,0
2024-04-03,6,Current,0,0,0
2024-04-03,6,DPD15-29,1,1,0
2024-04-03,6,DPD30-59,0,0,0
2024-04-02,100,Current,0,0,0
2024-04-02,102,Current,0,0,0
2024-04-02,102,DPD15-29,0,0,0
2024-04-02,102,DPD30-59,0,0,0
2024-04-02,102,DPD90+,0,0,0
2024-04-02,104,Current,0,0,0
2024-04-02,104,DPD15-29,0,0,0
2024-04-02,104,DPD30-59,1,1,0
2024-04-02,104,DPD60-89,0,0,0
2024-04-02,20,Current,0,0,0
2024-04-02,20,DPD15-29,195,195,0
2024-04-02,20,DPD3-14,348,348,0
2024-04-02,20,DPD30-59,172,172,0
2024-04-02,20,DPD60-89,36,36,0
2024-04-02,20,DPD90+,72,72,0
2024-04-02,22,Current,0,0,0
2024-04-02,22,DPD15-29,0,0,0
2024-04-02,22,DPD3-14,1,1,0
2024-04-02,22,DPD30-59,0,0,0
2024-04-02,22,DPD60-89,0,0,0
2024-04-02,24,Current,37,37,0
2024-04-02,24,DPD15-29,93,93,0
2024-04-02,24,DPD3-14,160,160,0
2024-04-02,24,DPD30-59,88,88,0
2024-04-02,24,DPD60-89,0,0,0
2024-04-02,24,DPD90+,0,0,0
2024-04-02,26,Current,0,0,0
2024-04-02,26,DPD15-29,11,11,0
2024-04-02,26,DPD3-14,26,26,0
2024-04-02,26,DPD30-59,12,12,0
2024-04-02,26,DPD60-89,0,0,0
2024-04-02,26,DPD90+,0,0,0
2024-04-02,32,Current,0,0,0
2024-04-02,32,DPD15-29,101,101,0
2024-04-02,32,DPD3-14,152,152,0
2024-04-02,32,DPD30-59,68,68,0
2024-04-02,32,DPD60-89,0,0,0
2024-04-02,32,DPD90+,0,0,0
2024-04-02,34,Current,0,0,0
2024-04-02,34,DPD15-29,55,55,0
2024-04-02,34,DPD3-14,68,68,0
2024-04-02,34,DPD30-59,49,49,0
2024-04-02,34,DPD60-89,0,0,0
2024-04-02,34,DPD90+,0,0,0
2024-04-02,36,Current,0,0,0
2024-04-02,36,DPD15-29,26,26,0
2024-04-02,36,DPD3-14,43,43,0
2024-04-02,36,DPD30-59,19,19,0
2024-04-02,36,DPD60-89,0,0,0
2024-04-02,36,DPD90+,0,0,0
2024-04-02,38,Current,0,0,0
2024-04-02,38,DPD15-29,28,28,0
2024-04-02,38,DPD3-14,49,49,0
2024-04-02,38,DPD30-59,21,21,0
2024-04-02,38,DPD60-89,0,0,0
2024-04-02,38,DPD90+,0,0,0
2024-04-02,40,Current,0,0,0
2024-04-02,40,DPD15-29,19,19,0
2024-04-02,40,DPD3-14,37,37,0
2024-04-02,40,DPD30-59,10,10,0
2024-04-02,40,DPD60-89,0,0,0
2024-04-02,40,DPD90+,0,0,0
2024-04-02,42,Current,0,0,0
2024-04-02,42,DPD15-29,9,9,0
2024-04-02,42,DPD3-14,20,20,0
2024-04-02,42,DPD30-59,8,8,0
2024-04-02,42,DPD60-89,0,0,0
2024-04-02,42,DPD90+,0,0,0
2024-04-02,44,Current,0,0,0
2024-04-02,44,DPD15-29,18,18,0
2024-04-02,44,DPD3-14,38,38,0
2024-04-02,44,DPD30-59,27,27,0
2024-04-02,44,DPD60-89,0,0,0
2024-04-02,44,DPD90+,0,0,0
2024-04-02,46,Current,0,0,0
2024-04-02,46,DPD60-89,0,0,0
2024-04-02,48,Current,41,41,0
2024-04-02,48,DPD15-29,21,21,0
2024-04-02,48,DPD3-14,19,19,0
2024-04-02,48,DPD30-59,10,10,0
2024-04-02,48,DPD60-89,0,0,0
2024-04-02,48,DPD90+,0,0,0
2024-04-02,6,Current,0,0,0
2024-04-02,6,DPD15-29,0,0,0
2024-04-02,6,DPD30-59,0,0,0
2024-04-01,100,Current,0,0,0
2024-04-01,102,Current,0,0,0
2024-04-01,102,DPD15-29,0,0,0
2024-04-01,102,DPD60-89,0,0,0
2024-04-01,102,DPD90+,0,0,0
2024-04-01,104,Current,0,0,0
2024-04-01,104,DPD3-14,1,1,0
2024-04-01,104,DPD30-59,0,0,0
2024-04-01,104,DPD60-89,0,0,0
2024-04-01,20,Current,5091,5091,0
2024-04-01,20,DPD15-29,243,243,0
2024-04-01,20,DPD3-14,614,614,0
2024-04-01,20,DPD30-59,137,137,0
2024-04-01,20,DPD60-89,51,51,0
2024-04-01,20,DPD90+,92,92,0
2024-04-01,22,Current,0,0,0
2024-04-01,22,DPD15-29,1,1,0
2024-04-01,22,DPD3-14,3,3,0
2024-04-01,22,DPD30-59,0,0,0
2024-04-01,22,DPD60-89,0,0,0
2024-04-01,24,Current,3636,3636,0
2024-04-01,24,DPD15-29,128,128,0
2024-04-01,24,DPD3-14,315,315,0
2024-04-01,24,DPD30-59,64,64,0
2024-04-01,24,DPD60-89,9,9,0
2024-04-01,24,DPD90+,7,7,0
2024-04-01,26,Current,0,0,0
2024-04-01,26,DPD15-29,17,17,0
2024-04-01,26,DPD3-14,42,42,0
2024-04-01,26,DPD30-59,2,2,0
2024-04-01,26,DPD60-89,0,0,0
2024-04-01,26,DPD90+,0,0,0
2024-04-01,32,Current,260,260,0
2024-04-01,32,DPD15-29,95,95,0
2024-04-01,32,DPD3-14,236,236,0
2024-04-01,32,DPD30-59,42,42,0
2024-04-01,32,DPD60-89,1,1,0
2024-04-01,32,DPD90+,6,6,0
2024-04-01,34,Current,0,0,0
2024-04-01,34,DPD15-29,33,33,0
2024-04-01,34,DPD3-14,111,111,0
2024-04-01,34,DPD30-59,15,15,0
2024-04-01,34,DPD60-89,0,0,0
2024-04-01,34,DPD90+,0,0,0
2024-04-01,36,Current,290,290,0
2024-04-01,36,DPD15-29,29,29,0
2024-04-01,36,DPD3-14,80,80,0
2024-04-01,36,DPD30-59,14,14,0
2024-04-01,36,DPD60-89,2,2,0
2024-04-01,36,DPD90+,5,5,0
2024-04-01,38,Current,0,0,0
2024-04-01,38,DPD15-29,22,22,0
2024-04-01,38,DPD3-14,83,83,0
2024-04-01,38,DPD30-59,8,8,0
2024-04-01,38,DPD60-89,0,0,0
2024-04-01,38,DPD90+,0,0,0
2024-04-01,40,Current,319,319,0
2024-04-01,40,DPD15-29,18,18,0
2024-04-01,40,DPD3-14,41,41,0
2024-04-01,40,DPD30-59,3,3,0
2024-04-01,40,DPD60-89,0,0,0
2024-04-01,40,DPD90+,2,2,0
2024-04-01,42,Current,0,0,0
2024-04-01,42,DPD15-29,10,10,0
2024-04-01,42,DPD3-14,27,27,0
2024-04-01,42,DPD30-59,3,3,0
2024-04-01,42,DPD60-89,0,0,0
2024-04-01,42,DPD90+,0,0,0
2024-04-01,44,Current,196,196,0
2024-04-01,44,DPD15-29,19,19,0
2024-04-01,44,DPD3-14,52,52,0
2024-04-01,44,DPD30-59,13,13,0
2024-04-01,44,DPD60-89,1,1,0
2024-04-01,44,DPD90+,0,0,0
2024-04-01,46,Current,5,5,0
2024-04-01,46,DPD60-89,0,0,0
2024-04-01,48,Current,4128,4128,0
2024-04-01,48,DPD15-29,37,37,0
2024-04-01,48,DPD3-14,67,67,0
2024-04-01,48,DPD30-59,24,24,0
2024-04-01,48,DPD60-89,12,12,0
2024-04-01,48,DPD90+,9,9,0
2024-04-01,6,Current,2,2,0
2024-04-01,6,DPD15-29,2,2,0
2024-04-01,6,DPD30-59,0,0,0
2024-03-31,100,Current,0,0,0
2024-03-31,102,Current,0,0,0
2024-03-31,102,DPD15-29,0,0,0
2024-03-31,102,DPD60-89,0,0,0
2024-03-31,102,DPD90+,0,0,0
2024-03-31,104,Current,0,0,0
2024-03-31,104,DPD3-14,0,0,0
2024-03-31,104,DPD30-59,0,0,0
2024-03-31,104,DPD60-89,0,0,0
2024-03-31,20,Current,0,0,0
2024-03-31,20,DPD15-29,200,200,0
2024-03-31,20,DPD3-14,396,396,0
2024-03-31,20,DPD30-59,127,127,0
2024-03-31,20,DPD60-89,54,54,0
2024-03-31,20,DPD90+,24,24,0
2024-03-31,22,Current,0,0,0
2024-03-31,22,DPD15-29,0,0,0
2024-03-31,22,DPD3-14,1,1,0
2024-03-31,22,DPD30-59,0,0,0
2024-03-31,22,DPD60-89,0,0,0
2024-03-31,24,Current,70,70,0
2024-03-31,24,DPD15-29,83,83,0
2024-03-31,24,DPD3-14,186,186,0
2024-03-31,24,DPD30-59,62,62,0
2024-03-31,24,DPD60-89,0,0,0
2024-03-31,24,DPD90+,0,0,0
2024-03-31,26,Current,0,0,0
2024-03-31,26,DPD15-29,11,11,0
2024-03-31,26,DPD3-14,31,31,0
2024-03-31,26,DPD30-59,7,7,0
2024-03-31,26,DPD60-89,0,0,0
2024-03-31,26,DPD90+,0,0,0
2024-03-31,32,Current,0,0,0
2024-03-31,32,DPD15-29,104,104,0
2024-03-31,32,DPD3-14,163,163,0
2024-03-31,32,DPD30-59,82,82,0
2024-03-31,32,DPD60-89,0,0,0
2024-03-31,32,DPD90+,0,0,0
2024-03-31,34,Current,0,0,0
2024-03-31,34,DPD15-29,46,46,0
2024-03-31,34,DPD3-14,78,78,0
2024-03-31,34,DPD30-59,30,30,0
2024-03-31,34,DPD60-89,0,0,0
2024-03-31,34,DPD90+,0,0,0
2024-03-31,36,Current,0,0,0
2024-03-31,36,DPD15-29,26,26,0
2024-03-31,36,DPD3-14,55,55,0
2024-03-31,36,DPD30-59,14,14,0
2024-03-31,36,DPD60-89,0,0,0
2024-03-31,36,DPD90+,0,0,0
2024-03-31,38,Current,0,0,0
2024-03-31,38,DPD15-29,32,32,0
2024-03-31,38,DPD3-14,60,60,0
2024-03-31,38,DPD30-59,16,16,0
2024-03-31,38,DPD60-89,0,0,0
2024-03-31,38,DPD90+,0,0,0
2024-03-31,40,Current,0,0,0
2024-03-31,40,DPD15-29,19,19,0
2024-03-31,40,DPD3-14,39,39,0
2024-03-31,40,DPD30-59,7,7,0
2024-03-31,40,DPD60-89,0,0,0
2024-03-31,40,DPD90+,0,0,0
2024-03-31,42,Current,0,0,0
2024-03-31,42,DPD15-29,7,7,0
2024-03-31,42,DPD3-14,22,22,0
2024-03-31,42,DPD30-59,5,5,0
2024-03-31,42,DPD60-89,0,0,0
2024-03-31,42,DPD90+,0,0,0
2024-03-31,44,Current,0,0,0
2024-03-31,44,DPD15-29,21,21,0
2024-03-31,44,DPD3-14,44,44,0
2024-03-31,44,DPD30-59,13,13,0
2024-03-31,44,DPD60-89,0,0,0
2024-03-31,44,DPD90+,0,0,0
2024-03-31,46,Current,0,0,0
2024-03-31,46,DPD90+,0,0,0
2024-03-31,48,Current,63,63,0
2024-03-31,48,DPD15-29,21,21,0
2024-03-31,48,DPD3-14,22,22,0
2024-03-31,48,DPD30-59,6,6,0
2024-03-31,48,DPD60-89,0,0,0
2024-03-31,48,DPD90+,0,0,0
2024-03-31,6,Current,0,0,0
2024-03-31,6,DPD15-29,0,0,0
2024-03-31,6,DPD30-59,0,0,0
2024-03-30,100,Current,0,0,0
2024-03-30,102,Current,0,0,0
2024-03-30,102,DPD15-29,0,0,0
2024-03-30,102,DPD60-89,0,0,0
2024-03-30,102,DPD90+,0,0,0
2024-03-30,104,Current,0,0,0
2024-03-30,104,DPD3-14,1,1,0
2024-03-30,104,DPD30-59,0,0,0
2024-03-30,104,DPD60-89,0,0,0
2024-03-30,20,Current,0,0,0
2024-03-30,20,DPD15-29,147,147,0
2024-03-30,20,DPD3-14,344,344,0
2024-03-30,20,DPD30-59,18,18,0
2024-03-30,20,DPD60-89,1,1,0
2024-03-30,20,DPD90+,0,0,0
2024-03-30,22,Current,0,0,0
2024-03-30,22,DPD15-29,1,1,0
2024-03-30,22,DPD3-14,2,2,0
2024-03-30,22,DPD30-59,0,0,0
2024-03-30,22,DPD60-89,0,0,0
2024-03-30,24,Current,65,65,0
2024-03-30,24,DPD15-29,82,82,0
2024-03-30,24,DPD3-14,199,199,0
2024-03-30,24,DPD30-59,8,8,0
2024-03-30,24,DPD60-89,0,0,0
2024-03-30,24,DPD90+,0,0,0
2024-03-30,26,Current,0,0,0
2024-03-30,26,DPD15-29,11,11,0
2024-03-30,26,DPD3-14,31,31,0
2024-03-30,26,DPD30-59,1,1,0
2024-03-30,26,DPD60-89,0,0,0
2024-03-30,26,DPD90+,0,0,0
2024-03-30,32,Current,0,0,0
2024-03-30,32,DPD15-29,66,66,0
2024-03-30,32,DPD3-14,169,169,0
2024-03-30,32,DPD30-59,11,11,0
2024-03-30,32,DPD60-89,0,0,0
2024-03-30,32,DPD90+,0,0,0
2024-03-30,34,Current,0,0,0
2024-03-30,34,DPD15-29,29,29,0
2024-03-30,34,DPD3-14,61,61,0
2024-03-30,34,DPD30-59,4,4,0
2024-03-30,34,DPD60-89,0,0,0
2024-03-30,34,DPD90+,0,0,0
2024-03-30,36,Current,0,0,0
2024-03-30,36,DPD15-29,16,16,0
2024-03-30,36,DPD3-14,60,60,0
2024-03-30,36,DPD30-59,3,3,0
2024-03-30,36,DPD60-89,0,0,0
2024-03-30,36,DPD90+,0,0,0
2024-03-30,38,Current,0,0,0
2024-03-30,38,DPD15-29,20,20,0
2024-03-30,38,DPD3-14,56,56,0
2024-03-30,38,DPD30-59,3,3,0
2024-03-30,38,DPD60-89,0,0,0
2024-03-30,38,DPD90+,0,0,0
2024-03-30,40,Current,0,0,0
2024-03-30,40,DPD15-29,17,17,0
2024-03-30,40,DPD3-14,24,24,0
2024-03-30,40,DPD30-59,1,1,0
2024-03-30,40,DPD60-89,0,0,0
2024-03-30,40,DPD90+,0,0,0
2024-03-30,42,Current,0,0,0
2024-03-30,42,DPD15-29,6,6,0
2024-03-30,42,DPD3-14,23,23,0
2024-03-30,42,DPD30-59,1,1,0
2024-03-30,42,DPD60-89,0,0,0
2024-03-30,42,DPD90+,0,0,0
2024-03-30,44,Current,0,0,0
2024-03-30,44,DPD15-29,9,9,0
2024-03-30,44,DPD3-14,40,40,0
2024-03-30,44,DPD30-59,0,0,0
2024-03-30,44,DPD60-89,0,0,0
2024-03-30,44,DPD90+,0,0,0
2024-03-30,46,Current,0,0,0
2024-03-30,46,DPD60-89,0,0,0
2024-03-30,48,Current,84,84,0
2024-03-30,48,DPD15-29,9,9,0
2024-03-30,48,DPD3-14,25,25,0
2024-03-30,48,DPD30-59,2,2,0
2024-03-30,48,DPD60-89,0,0,0
2024-03-30,48,DPD90+,0,0,0
2024-03-30,6,Current,0,0,0
2024-03-30,6,DPD15-29,1,1,0
2024-03-29,100,Current,0,0,0
2024-03-29,102,Current,0,0,0
2024-03-29,102,DPD15-29,0,0,0
2024-03-29,102,DPD60-89,0,0,0
2024-03-29,102,DPD90+,0,0,0
2024-03-29,104,Current,0,0,0
2024-03-29,104,DPD3-14,0,0,0
2024-03-29,104,DPD30-59,1,1,0
2024-03-29,104,DPD60-89,0,0,0
2024-03-29,20,Current,238,238,0
2024-03-29,20,DPD15-29,166,166,0
2024-03-29,20,DPD3-14,374,374,0
2024-03-29,20,DPD30-59,169,169,0
2024-03-29,20,DPD60-89,79,79,0
2024-03-29,20,DPD90+,70,70,0
2024-03-29,22,Current,0,0,0
2024-03-29,22,DPD15-29,0,0,0
2024-03-29,22,DPD3-14,1,1,0
2024-03-29,22,DPD30-59,0,0,0
2024-03-29,22,DPD60-89,0,0,0
2024-03-29,24,Current,218,218,0
2024-03-29,24,DPD15-29,60,60,0
2024-03-29,24,DPD3-14,189,189,0
2024-03-29,24,DPD30-59,86,86,0
2024-03-29,24,DPD60-89,0,0,0
2024-03-29,24,DPD90+,0,0,0
2024-03-29,26,Current,17,17,0
2024-03-29,26,DPD15-29,5,5,0
2024-03-29,26,DPD3-14,32,32,0
2024-03-29,26,DPD30-59,11,11,0
2024-03-29,26,DPD60-89,0,0,0
2024-03-29,26,DPD90+,0,0,0
2024-03-29,32,Current,82,82,0
2024-03-29,32,DPD15-29,79,79,0
2024-03-29,32,DPD3-14,157,157,0
2024-03-29,32,DPD30-59,64,64,0
2024-03-29,32,DPD60-89,0,0,0
2024-03-29,32,DPD90+,0,0,0
2024-03-29,34,Current,34,34,0
2024-03-29,34,DPD15-29,33,33,0
2024-03-29,34,DPD3-14,83,83,0
2024-03-29,34,DPD30-59,46,46,0
2024-03-29,34,DPD60-89,0,0,0
2024-03-29,34,DPD90+,0,0,0
2024-03-29,36,Current,39,39,0
2024-03-29,36,DPD15-29,19,19,0
2024-03-29,36,DPD3-14,62,62,0
2024-03-29,36,DPD30-59,18,18,0
2024-03-29,36,DPD60-89,0,0,0
2024-03-29,36,DPD90+,0,0,0
2024-03-29,38,Current,40,40,0
2024-03-29,38,DPD15-29,24,24,0
2024-03-29,38,DPD3-14,66,66,0
2024-03-29,38,DPD30-59,19,19,0
2024-03-29,38,DPD60-89,0,0,0
2024-03-29,38,DPD90+,0,0,0
2024-03-29,40,Current,18,18,0
2024-03-29,40,DPD15-29,13,13,0
2024-03-29,40,DPD3-14,34,34,0
2024-03-29,40,DPD30-59,10,10,0
2024-03-29,40,DPD60-89,0,0,0
2024-03-29,40,DPD90+,0,0,0
2024-03-29,42,Current,10,10,0
2024-03-29,42,DPD15-29,5,5,0
2024-03-29,42,DPD3-14,23,23,0
2024-03-29,42,DPD30-59,9,9,0
2024-03-29,42,DPD60-89,0,0,0
2024-03-29,42,DPD90+,0,0,0
2024-03-29,44,Current,32,32,0
2024-03-29,44,DPD15-29,18,18,0
2024-03-29,44,DPD3-14,44,44,0
2024-03-29,44,DPD30-59,26,26,0
2024-03-29,44,DPD60-89,0,0,0
2024-03-29,44,DPD90+,0,0,0
2024-03-29,46,Current,0,0,0
2024-03-29,46,DPD60-89,0,0,0
2024-03-29,48,Current,102,102,0
2024-03-29,48,DPD15-29,17,17,0
2024-03-29,48,DPD3-14,23,23,0
2024-03-29,48,DPD30-59,9,9,0
2024-03-29,48,DPD60-89,0,0,0
2024-03-29,48,DPD90+,0,0,0
2024-03-29,6,Current,0,0,0
2024-03-29,6,DPD15-29,0,0,0
2024-03-28,100,Current,0,0,0
2024-03-28,102,Current,0,0,0
2024-03-28,102,DPD15-29,0,0,0
2024-03-28,102,DPD60-89,0,0,0
2024-03-28,102,DPD90+,0,0,0
2024-03-28,104,Current,0,0,0
2024-03-28,104,DPD3-14,1,1,0
2024-03-28,104,DPD30-59,0,0,0
2024-03-28,104,DPD60-89,0,0,0
2024-03-28,20,Current,0,0,0
2024-03-28,20,DPD15-29,153,153,0
2024-03-28,20,DPD3-14,380,380,0
2024-03-28,20,DPD30-59,74,74,0
2024-03-28,20,DPD60-89,4,4,0
2024-03-28,20,DPD90+,1,1,0
2024-03-28,22,Current,0,0,0
2024-03-28,22,DPD15-29,1,1,0
2024-03-28,22,DPD3-14,1,1,0
2024-03-28,22,DPD30-59,0,0,0
2024-03-28,22,DPD60-89,0,0,0
2024-03-28,24,Current,20,20,0
2024-03-28,24,DPD15-29,76,76,0
2024-03-28,24,DPD3-14,242,242,0
2024-03-28,24,DPD30-59,39,39,0
2024-03-28,24,DPD60-89,0,0,0
2024-03-28,24,DPD90+,0,0,0
2024-03-28,26,Current,0,0,0
2024-03-28,26,DPD15-29,12,12,0
2024-03-28,26,DPD3-14,27,27,0
2024-03-28,26,DPD30-59,3,3,0
2024-03-28,26,DPD60-89,0,0,0
2024-03-28,26,DPD90+,0,0,0
2024-03-28,32,Current,0,0,0
2024-03-28,32,DPD15-29,72,72,0
2024-03-28,32,DPD3-14,177,177,0
2024-03-28,32,DPD30-59,38,38,0
2024-03-28,32,DPD60-89,0,0,0
2024-03-28,32,DPD90+,0,0,0
2024-03-28,34,Current,0,0,0
2024-03-28,34,DPD15-29,32,32,0
2024-03-28,34,DPD3-14,67,67,0
2024-03-28,34,DPD30-59,15,15,0
2024-03-28,34,DPD60-89,0,0,0
2024-03-28,34,DPD90+,0,0,0
2024-03-28,36,Current,0,0,0
2024-03-28,36,DPD15-29,20,20,0
2024-03-28,36,DPD3-14,61,61,0
2024-03-28,36,DPD30-59,10,10,0
2024-03-28,36,DPD60-89,0,0,0
2024-03-28,36,DPD90+,0,0,0
2024-03-28,38,Current,0,0,0
2024-03-28,38,DPD15-29,20,20,0
2024-03-28,38,DPD3-14,60,60,0
2024-03-28,38,DPD30-59,7,7,0
2024-03-28,38,DPD60-89,0,0,0
2024-03-28,38,DPD90+,0,0,0
2024-03-28,40,Current,0,0,0
2024-03-28,40,DPD15-29,18,18,0
2024-03-28,40,DPD3-14,31,31,0
2024-03-28,40,DPD30-59,0,0,0
2024-03-28,40,DPD60-89,0,0,0
2024-03-28,40,DPD90+,0,0,0
2024-03-28,42,Current,0,0,0
2024-03-28,42,DPD15-29,6,6,0
2024-03-28,42,DPD3-14,14,14,0
2024-03-28,42,DPD30-59,3,3,0
2024-03-28,42,DPD60-89,0,0,0
2024-03-28,42,DPD90+,0,0,0
2024-03-28,44,Current,0,0,0
2024-03-28,44,DPD15-29,12,12,0
2024-03-28,44,DPD3-14,43,43,0
2024-03-28,44,DPD30-59,9,9,0
2024-03-28,44,DPD60-89,0,0,0
2024-03-28,44,DPD90+,0,0,0
2024-03-28,46,Current,0,0,0
2024-03-28,46,DPD60-89,0,0,0
2024-03-28,48,Current,38,38,0
2024-03-28,48,DPD15-29,12,12,0
2024-03-28,48,DPD3-14,34,34,0
2024-03-28,48,DPD30-59,7,7,0
2024-03-28,48,DPD60-89,0,0,0
2024-03-28,48,DPD90+,0,0,0
2024-03-28,6,Current,0,0,0
2024-03-28,6,DPD15-29,1,1,0
2024-03-27,100,Current,0,0,0
2024-03-27,102,Current,0,0,0
2024-03-27,102,DPD15-29,0,0,0
2024-03-27,102,DPD60-89,0,0,0
2024-03-27,102,DPD90+,0,0,0
2024-03-27,104,Current,0,0,0
2024-03-27,104,DPD3-14,0,0,0
2024-03-27,104,DPD30-59,0,0,0
2024-03-27,104,DPD60-89,0,0,0
2024-03-27,20,Current,0,0,0
2024-03-27,20,DPD15-29,186,186,0
2024-03-27,20,DPD3-14,364,364,0
2024-03-27,20,DPD30-59,146,146,0
2024-03-27,20,DPD60-89,45,45,0
2024-03-27,20,DPD90+,45,45,0
2024-03-27,22,Current,0,0,0
2024-03-27,22,DPD15-29,0,0,0
2024-03-27,22,DPD3-14,1,1,0
2024-03-27,22,DPD30-59,0,0,0
2024-03-27,22,DPD60-89,0,0,0
2024-03-27,24,Current,29,29,0
2024-03-27,24,DPD15-29,73,73,0
2024-03-27,24,DPD3-14,183,183,0
2024-03-27,24,DPD30-59,69,69,0
2024-03-27,24,DPD60-89,0,0,0
2024-03-27,24,DPD90+,0,0,0
2024-03-27,26,Current,0,0,0
2024-03-27,26,DPD15-29,7,7,0
2024-03-27,26,DPD3-14,35,35,0
2024-03-27,26,DPD30-59,10,10,0
2024-03-27,26,DPD60-89,0,0,0
2024-03-27,26,DPD90+,0,0,0
2024-03-27,32,Current,0,0,0
2024-03-27,32,DPD15-29,86,86,0
2024-03-27,32,DPD3-14,149,149,0
2024-03-27,32,DPD30-59,78,78,0
2024-03-27,32,DPD60-89,0,0,0
2024-03-27,32,DPD90+,0,0,0
2024-03-27,34,Current,0,0,0
2024-03-27,34,DPD15-29,41,41,0
2024-03-27,34,DPD3-14,79,79,0
2024-03-27,34,DPD30-59,33,33,0
2024-03-27,34,DPD60-89,0,0,0
2024-03-27,34,DPD90+,0,0,0
2024-03-27,36,Current,0,0,0
2024-03-27,36,DPD15-29,26,26,0
2024-03-27,36,DPD3-14,53,53,0
2024-03-27,36,DPD30-59,20,20,0
2024-03-27,36,DPD60-89,0,0,0
2024-03-27,36,DPD90+,0,0,0
2024-03-27,38,Current,0,0,0
2024-03-27,38,DPD15-29,28,28,0
2024-03-27,38,DPD3-14,71,71,0
2024-03-27,38,DPD30-59,21,21,0
2024-03-27,38,DPD60-89,0,0,0
2024-03-27,38,DPD90+,0,0,0
2024-03-27,40,Current,0,0,0
2024-03-27,40,DPD15-29,14,14,0
2024-03-27,40,DPD3-14,34,34,0
2024-03-27,40,DPD30-59,8,8,0
2024-03-27,40,DPD60-89,0,0,0
2024-03-27,40,DPD90+,0,0,0
2024-03-27,42,Current,0,0,0
2024-03-27,42,DPD15-29,9,9,0
2024-03-27,42,DPD3-14,20,20,0
2024-03-27,42,DPD30-59,5,5,0
2024-03-27,42,DPD60-89,0,0,0
2024-03-27,42,DPD90+,0,0,0
2024-03-27,44,Current,0,0,0
2024-03-27,44,DPD15-29,23,23,0
2024-03-27,44,DPD3-14,47,47,0
2024-03-27,44,DPD30-59,16,16,0
2024-03-27,44,DPD60-89,0,0,0
2024-03-27,44,DPD90+,0,0,0
2024-03-27,46,Current,0,0,0
2024-03-27,46,DPD60-89,0,0,0
2024-03-27,48,Current,39,39,0
2024-03-27,48,DPD15-29,17,17,0
2024-03-27,48,DPD3-14,20,20,0
2024-03-27,48,DPD30-59,8,8,0
2024-03-27,48,DPD60-89,0,0,0
2024-03-27,48,DPD90+,0,0,0
2024-03-27,6,Current,0,0,0
2024-03-27,6,DPD15-29,1,1,0
2024-03-26,100,Current,0,0,0
2024-03-26,102,Current,0,0,0
2024-03-26,102,DPD15-29,0,0,0
2024-03-26,102,DPD3-14,0,0,0
2024-03-26,102,DPD60-89,0,0,0
2024-03-26,102,DPD90+,0,0,0
2024-03-26,104,Current,0,0,0
2024-03-26,104,DPD3-14,1,1,0
2024-03-26,104,DPD30-59,0,0,0
2024-03-26,104,DPD60-89,0,0,0
2024-03-26,20,Current,0,0,0
2024-03-26,20,DPD15-29,155,155,0
2024-03-26,20,DPD3-14,410,410,0
2024-03-26,20,DPD30-59,17,17,0
2024-03-26,20,DPD60-89,1,1,0
2024-03-26,20,DPD90+,0,0,0
2024-03-26,22,Current,0,0,0
2024-03-26,22,DPD15-29,1,1,0
2024-03-26,22,DPD3-14,1,1,0
2024-03-26,22,DPD30-59,0,0,0
2024-03-26,22,DPD60-89,0,0,0
2024-03-26,24,Current,70,70,0
2024-03-26,24,DPD15-29,82,82,0
2024-03-26,24,DPD3-14,243,243,0
2024-03-26,24,DPD30-59,7,7,0
2024-03-26,24,DPD60-89,0,0,0
2024-03-26,24,DPD90+,0,0,0
2024-03-26,26,Current,0,0,0
2024-03-26,26,DPD15-29,10,10,0
2024-03-26,26,DPD3-14,35,35,0
2024-03-26,26,DPD30-59,1,1,0
2024-03-26,26,DPD60-89,0,0,0
2024-03-26,26,DPD90+,0,0,0
2024-03-26,32,Current,0,0,0
2024-03-26,32,DPD15-29,74,74,0
2024-03-26,32,DPD3-14,184,184,0
2024-03-26,32,DPD30-59,8,8,0
2024-03-26,32,DPD60-89,0,0,0
2024-03-26,32,DPD90+,0,0,0
2024-03-26,34,Current,0,0,0
2024-03-26,34,DPD15-29,40,40,0
2024-03-26,34,DPD3-14,64,64,0
2024-03-26,34,DPD30-59,6,6,0
2024-03-26,34,DPD60-89,0,0,0
2024-03-26,34,DPD90+,0,0,0
2024-03-26,36,Current,0,0,0
2024-03-26,36,DPD15-29,22,22,0
2024-03-26,36,DPD3-14,68,68,0
2024-03-26,36,DPD30-59,2,2,0
2024-03-26,36,DPD60-89,0,0,0
2024-03-26,36,DPD90+,0,0,0
2024-03-26,38,Current,0,0,0
2024-03-26,38,DPD15-29,19,19,0
2024-03-26,38,DPD3-14,60,60,0
2024-03-26,38,DPD30-59,4,4,0
2024-03-26,38,DPD60-89,0,0,0
2024-03-26,38,DPD90+,0,0,0
2024-03-26,40,Current,0,0,0
2024-03-26,40,DPD15-29,18,18,0
2024-03-26,40,DPD3-14,30,30,0
2024-03-26,40,DPD30-59,0,0,0
2024-03-26,40,DPD60-89,0,0,0
2024-03-26,40,DPD90+,0,0,0
2024-03-26,42,Current,0,0,0
2024-03-26,42,DPD15-29,4,4,0
2024-03-26,42,DPD3-14,18,18,0
2024-03-26,42,DPD30-59,1,1,0
2024-03-26,42,DPD60-89,0,0,0
2024-03-26,42,DPD90+,0,0,0
2024-03-26,44,Current,0,0,0
2024-03-26,44,DPD15-29,10,10,0
2024-03-26,44,DPD3-14,51,51,0
2024-03-26,44,DPD30-59,4,4,0
2024-03-26,44,DPD60-89,0,0,0
2024-03-26,44,DPD90+,0,0,0
2024-03-26,46,Current,0,0,0
2024-03-26,46,DPD60-89,0,0,0
2024-03-26,48,Current,48,48,0
2024-03-26,48,DPD15-29,8,8,0
2024-03-26,48,DPD3-14,37,37,0
2024-03-26,48,DPD30-59,1,1,0
2024-03-26,48,DPD60-89,0,0,0
2024-03-26,48,DPD90+,0,0,0
2024-03-26,6,Current,0,0,0
2024-03-26,6,DPD15-29,1,1,0
2024-03-25,100,Current,0,0,0
2024-03-25,102,Current,0,0,0
2024-03-25,102,DPD15-29,0,0,0
2024-03-25,102,DPD3-14,0,0,0
2024-03-25,102,DPD60-89,0,0,0
2024-03-25,102,DPD90+,0,0,0
2024-03-25,104,Current,0,0,0
2024-03-25,104,DPD3-14,1,1,0
2024-03-25,104,DPD30-59,1,1,0
2024-03-25,104,DPD60-89,0,0,0
2024-03-25,20,Current,0,0,0
2024-03-25,20,DPD15-29,217,217,0
2024-03-25,20,DPD3-14,405,405,0
2024-03-25,20,DPD30-59,172,172,0
2024-03-25,20,DPD60-89,44,44,0
2024-03-25,20,DPD90+,76,76,0
2024-03-25,22,Current,0,0,0
2024-03-25,22,DPD15-29,0,0,0
2024-03-25,22,DPD3-14,1,1,0
2024-03-25,22,DPD30-59,0,0,0
2024-03-25,22,DPD60-89,0,0,0
2024-03-25,24,Current,32,32,0
2024-03-25,24,DPD15-29,86,86,0
2024-03-25,24,DPD3-14,205,205,0
2024-03-25,24,DPD30-59,93,93,0
2024-03-25,24,DPD60-89,0,0,0
2024-03-25,24,DPD90+,0,0,0
2024-03-25,26,Current,0,0,0
2024-03-25,26,DPD15-29,11,11,0
2024-03-25,26,DPD3-14,39,39,0
2024-03-25,26,DPD30-59,10,10,0
2024-03-25,26,DPD60-89,0,0,0
2024-03-25,26,DPD90+,0,0,0
2024-03-25,32,Current,0,0,0
2024-03-25,32,DPD15-29,109,109,0
2024-03-25,32,DPD3-14,179,179,0
2024-03-25,32,DPD30-59,71,71,0
2024-03-25,32,DPD60-89,0,0,0
2024-03-25,32,DPD90+,0,0,0
2024-03-25,34,Current,0,0,0
2024-03-25,34,DPD15-29,44,44,0
2024-03-25,34,DPD3-14,82,82,0
2024-03-25,34,DPD30-59,43,43,0
2024-03-25,34,DPD60-89,0,0,0
2024-03-25,34,DPD90+,0,0,0
2024-03-25,36,Current,0,0,0
2024-03-25,36,DPD15-29,30,30,0
2024-03-25,36,DPD3-14,52,52,0
2024-03-25,36,DPD30-59,22,22,0
2024-03-25,36,DPD60-89,0,0,0
2024-03-25,36,DPD90+,0,0,0
2024-03-25,38,Current,0,0,0
2024-03-25,38,DPD15-29,33,33,0
2024-03-25,38,DPD3-14,81,81,0
2024-03-25,38,DPD30-59,19,19,0
2024-03-25,38,DPD60-89,0,0,0
2024-03-25,38,DPD90+,0,0,0
2024-03-25,40,Current,0,0,0
2024-03-25,40,DPD15-29,18,18,0
2024-03-25,40,DPD3-14,37,37,0
2024-03-25,40,DPD30-59,12,12,0
2024-03-25,40,DPD60-89,0,0,0
2024-03-25,40,DPD90+,0,0,0
2024-03-25,42,Current,0,0,0
2024-03-25,42,DPD15-29,10,10,0
2024-03-25,42,DPD3-14,20,20,0
2024-03-25,42,DPD30-59,10,10,0
2024-03-25,42,DPD60-89,0,0,0
2024-03-25,42,DPD90+,0,0,0
2024-03-25,44,Current,0,0,0
2024-03-25,44,DPD15-29,22,22,0
2024-03-25,44,DPD3-14,52,52,0
2024-03-25,44,DPD30-59,25,25,0
2024-03-25,44,DPD60-89,0,0,0
2024-03-25,44,DPD90+,0,0,0
2024-03-25,46,Current,0,0,0
2024-03-25,46,DPD60-89,0,0,0
2024-03-25,48,Current,37,37,0
2024-03-25,48,DPD15-29,20,20,0
2024-03-25,48,DPD3-14,32,32,0
2024-03-25,48,DPD30-59,8,8,0
2024-03-25,48,DPD60-89,0,0,0
2024-03-25,48,DPD90+,0,0,0
2024-03-25,6,Current,0,0,0
2024-03-25,6,DPD15-29,1,1,0
2024-03-24,100,Current,0,0,0
2024-03-24,102,Current,0,0,0
2024-03-24,102,DPD3-14,0,0,0
2024-03-24,102,DPD60-89,0,0,0
2024-03-24,102,DPD90+,0,0,0
2024-03-24,104,Current,0,0,0
2024-03-24,104,DPD3-14,1,1,0
2024-03-24,104,DPD30-59,0,0,0
2024-03-24,104,DPD60-89,0,0,0
2024-03-24,20,Current,0,0,0
2024-03-24,20,DPD15-29,156,156,0
2024-03-24,20,DPD3-14,408,408,0
2024-03-24,20,DPD30-59,60,60,0
2024-03-24,20,DPD60-89,32,32,0
2024-03-24,20,DPD90+,62,62,0
2024-03-24,22,Current,0,0,0
2024-03-24,22,DPD15-29,1,1,0
2024-03-24,22,DPD3-14,0,0,0
2024-03-24,22,DPD30-59,0,0,0
2024-03-24,22,DPD60-89,0,0,0
2024-03-24,24,Current,29,29,0
2024-03-24,24,DPD15-29,88,88,0
2024-03-24,24,DPD3-14,235,235,0
2024-03-24,24,DPD30-59,29,29,0
2024-03-24,24,DPD60-89,0,0,0
2024-03-24,24,DPD90+,0,0,0
2024-03-24,26,Current,0,0,0
2024-03-24,26,DPD15-29,11,11,0
2024-03-24,26,DPD3-14,36,36,0
2024-03-24,26,DPD30-59,3,3,0
2024-03-24,26,DPD60-89,0,0,0
2024-03-24,26,DPD90+,0,0,0
2024-03-24,32,Current,0,0,0
2024-03-24,32,DPD15-29,70,70,0
2024-03-24,32,DPD3-14,186,186,0
2024-03-24,32,DPD30-59,32,32,0
2024-03-24,32,DPD60-89,0,0,0
2024-03-24,32,DPD90+,0,0,0
2024-03-24,34,Current,0,0,0
2024-03-24,34,DPD15-29,41,41,0
2024-03-24,34,DPD3-14,61,61,0
2024-03-24,34,DPD30-59,17,17,0
2024-03-24,34,DPD60-89,0,0,0
2024-03-24,34,DPD90+,0,0,0
2024-03-24,36,Current,0,0,0
2024-03-24,36,DPD15-29,22,22,0
2024-03-24,36,DPD3-14,62,62,0
2024-03-24,36,DPD30-59,8,8,0
2024-03-24,36,DPD60-89,0,0,0
2024-03-24,36,DPD90+,0,0,0
2024-03-24,38,Current,0,0,0
2024-03-24,38,DPD15-29,24,24,0
2024-03-24,38,DPD3-14,56,56,0
2024-03-24,38,DPD30-59,6,6,0
2024-03-24,38,DPD60-89,0,0,0
2024-03-24,38,DPD90+,0,0,0
2024-03-24,40,Current,0,0,0
2024-03-24,40,DPD15-29,16,16,0
2024-03-24,40,DPD3-14,36,36,0
2024-03-24,40,DPD30-59,0,0,0
2024-03-24,40,DPD60-89,0,0,0
2024-03-24,40,DPD90+,0,0,0
2024-03-24,42,Current,0,0,0
2024-03-24,42,DPD15-29,7,7,0
2024-03-24,42,DPD3-14,19,19,0
2024-03-24,42,DPD30-59,2,2,0
2024-03-24,42,DPD60-89,0,0,0
2024-03-24,42,DPD90+,0,0,0
2024-03-24,44,Current,0,0,0
2024-03-24,44,DPD15-29,18,18,0
2024-03-24,44,DPD3-14,52,52,0
2024-03-24,44,DPD30-59,9,9,0
2024-03-24,44,DPD60-89,0,0,0
2024-03-24,44,DPD90+,0,0,0
2024-03-24,46,Current,0,0,0
2024-03-24,46,DPD60-89,0,0,0
2024-03-24,48,Current,45,45,0
2024-03-24,48,DPD15-29,8,8,0
2024-03-24,48,DPD3-14,39,39,0
2024-03-24,48,DPD30-59,5,5,0
2024-03-24,48,DPD60-89,0,0,0
2024-03-24,48,DPD90+,0,0,0
2024-03-24,6,Current,0,0,0
2024-03-24,6,DPD15-29,1,1,0
2024-03-23,100,Current,0,0,0
2024-03-23,102,Current,0,0,0
2024-03-23,102,DPD3-14,0,0,0
2024-03-23,102,DPD60-89,0,0,0
2024-03-23,102,DPD90+,0,0,0
2024-03-23,104,Current,0,0,0
2024-03-23,104,DPD3-14,1,1,0
2024-03-23,104,DPD30-59,0,0,0
2024-03-23,104,DPD60-89,0,0,0
2024-03-23,20,Current,0,0,0
2024-03-23,20,DPD15-29,199,199,0
2024-03-23,20,DPD3-14,336,336,0
2024-03-23,20,DPD30-59,153,153,0
2024-03-23,20,DPD60-89,38,38,0
2024-03-23,20,DPD90+,28,28,0
2024-03-23,22,Current,0,0,0
2024-03-23,22,DPD15-29,0,0,0
2024-03-23,22,DPD30-59,0,0,0
2024-03-23,22,DPD60-89,0,0,0
2024-03-23,24,Current,27,27,0
2024-03-23,24,DPD15-29,80,80,0
2024-03-23,24,DPD3-14,175,175,0
2024-03-23,24,DPD30-59,73,73,0
2024-03-23,24,DPD60-89,0,0,0
2024-03-23,24,DPD90+,0,0,0
2024-03-23,26,Current,0,0,0
2024-03-23,26,DPD15-29,10,10,0
2024-03-23,26,DPD3-14,34,34,0
2024-03-23,26,DPD30-59,10,10,0
2024-03-23,26,DPD60-89,0,0,0
2024-03-23,26,DPD90+,0,0,0
2024-03-23,32,Current,0,0,0
2024-03-23,32,DPD15-29,92,92,0
2024-03-23,32,DPD3-14,163,163,0
2024-03-23,32,DPD30-59,73,73,0
2024-03-23,32,DPD60-89,0,0,0
2024-03-23,32,DPD90+,0,0,0
2024-03-23,34,Current,0,0,0
2024-03-23,34,DPD15-29,39,39,0
2024-03-23,34,DPD3-14,76,76,0
2024-03-23,34,DPD30-59,30,30,0
2024-03-23,34,DPD60-89,0,0,0
2024-03-23,34,DPD90+,0,0,0
2024-03-23,36,Current,0,0,0
2024-03-23,36,DPD15-29,26,26,0
2024-03-23,36,DPD3-14,49,49,0
2024-03-23,36,DPD30-59,21,21,0
2024-03-23,36,DPD60-89,0,0,0
2024-03-23,36,DPD90+,0,0,0
2024-03-23,38,Current,0,0,0
2024-03-23,38,DPD15-29,33,33,0
2024-03-23,38,DPD3-14,66,66,0
2024-03-23,38,DPD30-59,19,19,0
2024-03-23,38,DPD60-89,0,0,0
2024-03-23,38,DPD90+,0,0,0
2024-03-23,40,Current,0,0,0
2024-03-23,40,DPD15-29,14,14,0
2024-03-23,40,DPD3-14,33,33,0
2024-03-23,40,DPD30-59,8,8,0
2024-03-23,40,DPD60-89,0,0,0
2024-03-23,40,DPD90+,0,0,0
2024-03-23,42,Current,0,0,0
2024-03-23,42,DPD15-29,13,13,0
2024-03-23,42,DPD3-14,19,19,0
2024-03-23,42,DPD30-59,8,8,0
2024-03-23,42,DPD60-89,0,0,0
2024-03-23,42,DPD90+,0,0,0
2024-03-23,44,Current,0,0,0
2024-03-23,44,DPD15-29,23,23,0
2024-03-23,44,DPD3-14,43,43,0
2024-03-23,44,DPD30-59,17,17,0
2024-03-23,44,DPD60-89,0,0,0
2024-03-23,44,DPD90+,0,0,0
2024-03-23,46,Current,0,0,0
2024-03-23,46,DPD60-89,0,0,0
2024-03-23,48,Current,38,38,0
2024-03-23,48,DPD15-29,18,18,0
2024-03-23,48,DPD3-14,30,30,0
2024-03-23,48,DPD30-59,11,11,0
2024-03-23,48,DPD60-89,0,0,0
2024-03-23,48,DPD90+,0,0,0
2024-03-23,6,Current,0,0,0
2024-03-23,6,DPD15-29,1,1,0
2024-03-22,100,Current,0,0,0
2024-03-22,102,Current,1,1,0
2024-03-22,102,DPD3-14,0,0,0
2024-03-22,102,DPD60-89,0,0,0
2024-03-22,102,DPD90+,0,0,0
2024-03-22,104,Current,0,0,0
2024-03-22,104,DPD3-14,1,1,0
2024-03-22,104,DPD30-59,0,0,0
2024-03-22,104,DPD60-89,0,0,0
2024-03-22,20,Current,262,262,0
2024-03-22,20,DPD15-29,154,154,0
2024-03-22,20,DPD3-14,318,318,0
2024-03-22,20,DPD30-59,115,115,0
2024-03-22,20,DPD60-89,72,72,0
2024-03-22,20,DPD90+,44,44,0
2024-03-22,22,Current,0,0,0
2024-03-22,22,DPD15-29,0,0,0
2024-03-22,22,DPD3-14,1,1,0
2024-03-22,22,DPD30-59,0,0,0
2024-03-22,22,DPD60-89,0,0,0
2024-03-22,24,Current,224,224,0
2024-03-22,24,DPD15-29,79,79,0
2024-03-22,24,DPD3-14,190,190,0
2024-03-22,24,DPD30-59,62,62,0
2024-03-22,24,DPD60-89,0,0,0
2024-03-22,24,DPD90+,0,0,0
2024-03-22,26,Current,17,17,0
2024-03-22,26,DPD15-29,11,11,0
2024-03-22,26,DPD3-14,27,27,0
2024-03-22,26,DPD30-59,10,10,0
2024-03-22,26,DPD60-89,0,0,0
2024-03-22,26,DPD90+,0,0,0
2024-03-22,32,Current,104,104,0
2024-03-22,32,DPD15-29,66,66,0
2024-03-22,32,DPD3-14,153,153,0
2024-03-22,32,DPD30-59,58,58,0
2024-03-22,32,DPD60-89,0,0,0
2024-03-22,32,DPD90+,0,0,0
2024-03-22,34,Current,37,37,0
2024-03-22,34,DPD15-29,40,40,0
2024-03-22,34,DPD3-14,57,57,0
2024-03-22,34,DPD30-59,32,32,0
2024-03-22,34,DPD60-89,0,0,0
2024-03-22,34,DPD90+,0,0,0
2024-03-22,36,Current,29,29,0
2024-03-22,36,DPD15-29,27,27,0
2024-03-22,36,DPD3-14,46,46,0
2024-03-22,36,DPD30-59,16,16,0
2024-03-22,36,DPD60-89,0,0,0
2024-03-22,36,DPD90+,0,0,0
2024-03-22,38,Current,40,40,0
2024-03-22,38,DPD15-29,27,27,0
2024-03-22,38,DPD3-14,42,42,0
2024-03-22,38,DPD30-59,11,11,0
2024-03-22,38,DPD60-89,0,0,0
2024-03-22,38,DPD90+,0,0,0
2024-03-22,40,Current,21,21,0
2024-03-22,40,DPD15-29,12,12,0
2024-03-22,40,DPD3-14,37,37,0
2024-03-22,40,DPD30-59,10,10,0
2024-03-22,40,DPD60-89,0,0,0
2024-03-22,40,DPD90+,0,0,0
2024-03-22,42,Current,18,18,0
2024-03-22,42,DPD15-29,8,8,0
2024-03-22,42,DPD3-14,18,18,0
2024-03-22,42,DPD30-59,5,5,0
2024-03-22,42,DPD60-89,0,0,0
2024-03-22,42,DPD90+,0,0,0
2024-03-22,44,Current,43,43,0
2024-03-22,44,DPD15-29,15,15,0
2024-03-22,44,DPD3-14,42,42,0
2024-03-22,44,DPD30-59,15,15,0
2024-03-22,44,DPD60-89,0,0,0
2024-03-22,44,DPD90+,0,0,0
2024-03-22,46,Current,0,0,0
2024-03-22,46,DPD60-89,0,0,0
2024-03-22,48,Current,99,99,0
2024-03-22,48,DPD15-29,5,5,0
2024-03-22,48,DPD3-14,36,36,0
2024-03-22,48,DPD30-59,4,4,0
2024-03-22,48,DPD60-89,0,0,0
2024-03-22,48,DPD90+,0,0,0
2024-03-22,6,Current,0,0,0
2024-03-22,6,DPD15-29,0,0,0
2024-03-22,6,DPD3-14,1,1,0
2024-03-21,100,Current,0,0,0
2024-03-21,100,DPD15-29,0,0,0
2024-03-21,102,Current,0,0,0
2024-03-21,102,DPD3-14,1,1,0
2024-03-21,102,DPD60-89,0,0,0
2024-03-21,102,DPD90+,0,0,0
2024-03-21,104,Current,0,0,0
2024-03-21,104,DPD3-14,0,0,0
2024-03-21,104,DPD30-59,1,1,0
2024-03-21,104,DPD90+,0,0,0
2024-03-21,20,Current,0,0,0
2024-03-21,20,DPD15-29,221,221,0
2024-03-21,20,DPD3-14,346,346,0
2024-03-21,20,DPD30-59,62,62,0
2024-03-21,20,DPD60-89,21,21,0
2024-03-21,20,DPD90+,36,36,0
2024-03-21,22,Current,0,0,0
2024-03-21,22,DPD15-29,0,0,0
2024-03-21,22,DPD3-14,0,0,0
2024-03-21,22,DPD30-59,0,0,0
2024-03-21,22,DPD60-89,0,0,0
2024-03-21,24,Current,35,35,0
2024-03-21,24,DPD15-29,95,95,0
2024-03-21,24,DPD3-14,206,206,0
2024-03-21,24,DPD30-59,32,32,0
2024-03-21,24,DPD60-89,0,0,0
2024-03-21,24,DPD90+,0,0,0
2024-03-21,26,Current,0,0,0
2024-03-21,26,DPD15-29,13,13,0
2024-03-21,26,DPD3-14,31,31,0
2024-03-21,26,DPD30-59,2,2,0
2024-03-21,26,DPD60-89,0,0,0
2024-03-21,26,DPD90+,0,0,0
2024-03-21,32,Current,0,0,0
2024-03-21,32,DPD15-29,98,98,0
2024-03-21,32,DPD3-14,176,176,0
2024-03-21,32,DPD30-59,19,19,0
2024-03-21,32,DPD60-89,0,0,0
2024-03-21,32,DPD90+,0,0,0
2024-03-21,34,Current,0,0,0
2024-03-21,34,DPD15-29,40,40,0
2024-03-21,34,DPD3-14,85,85,0
2024-03-21,34,DPD30-59,14,14,0
2024-03-21,34,DPD60-89,0,0,0
2024-03-21,34,DPD90+,0,0,0
2024-03-21,36,Current,0,0,0
2024-03-21,36,DPD15-29,30,30,0
2024-03-21,36,DPD3-14,47,47,0
2024-03-21,36,DPD30-59,9,9,0
2024-03-21,36,DPD60-89,0,0,0
2024-03-21,36,DPD90+,0,0,0
2024-03-21,38,Current,0,0,0
2024-03-21,38,DPD15-29,34,34,0
2024-03-21,38,DPD3-14,63,63,0
2024-03-21,38,DPD30-59,5,5,0
2024-03-21,38,DPD60-89,0,0,0
2024-03-21,38,DPD90+,0,0,0
2024-03-21,40,Current,0,0,0
2024-03-21,40,DPD15-29,14,14,0
2024-03-21,40,DPD3-14,35,35,0
2024-03-21,40,DPD30-59,3,3,0
2024-03-21,40,DPD60-89,0,0,0
2024-03-21,40,DPD90+,0,0,0
2024-03-21,42,Current,0,0,0
2024-03-21,42,DPD15-29,14,14,0
2024-03-21,42,DPD3-14,21,21,0
2024-03-21,42,DPD30-59,3,3,0
2024-03-21,42,DPD60-89,0,0,0
2024-03-21,42,DPD90+,0,0,0
2024-03-21,44,Current,0,0,0
2024-03-21,44,DPD15-29,22,22,0
2024-03-21,44,DPD3-14,43,43,0
2024-03-21,44,DPD30-59,10,10,0
2024-03-21,44,DPD60-89,0,0,0
2024-03-21,44,DPD90+,0,0,0
2024-03-21,46,Current,0,0,0
2024-03-21,46,DPD60-89,0,0,0
2024-03-21,48,Current,47,47,0
2024-03-21,48,DPD15-29,20,20,0
2024-03-21,48,DPD3-14,38,38,0
2024-03-21,48,DPD30-59,2,2,0
2024-03-21,48,DPD60-89,0,0,0
2024-03-21,48,DPD90+,0,0,0
2024-03-21,6,Current,0,0,0
2024-03-21,6,DPD15-29,1,1,0
2024-03-21,6,DPD3-14,0,0,0
2024-03-20,100,Current,0,0,0
2024-03-20,100,DPD15-29,0,0,0
2024-03-20,102,Current,0,0,0
2024-03-20,102,DPD3-14,1,1,0
2024-03-20,102,DPD60-89,0,0,0
2024-03-20,102,DPD90+,0,0,0
2024-03-20,104,Current,0,0,0
2024-03-20,104,DPD30-59,0,0,0
2024-03-20,104,DPD90+,0,0,0
2024-03-20,20,Current,0,0,0
2024-03-20,20,DPD15-29,176,176,0
2024-03-20,20,DPD3-14,274,274,0
2024-03-20,20,DPD30-59,52,52,0
2024-03-20,20,DPD60-89,3,3,0
2024-03-20,20,DPD90+,0,0,0
2024-03-20,22,Current,0,0,0
2024-03-20,22,DPD15-29,0,0,0
2024-03-20,22,DPD3-14,1,1,0
2024-03-20,22,DPD30-59,0,0,0
2024-03-20,22,DPD60-89,0,0,0
2024-03-20,24,Current,67,67,0
2024-03-20,24,DPD15-29,84,84,0
2024-03-20,24,DPD3-14,178,178,0
2024-03-20,24,DPD30-59,22,22,0
2024-03-20,24,DPD60-89,0,0,0
2024-03-20,24,DPD90+,0,0,0
2024-03-20,26,Current,0,0,0
2024-03-20,26,DPD15-29,14,14,0
2024-03-20,26,DPD3-14,27,27,0
2024-03-20,26,DPD30-59,3,3,0
2024-03-20,26,DPD60-89,0,0,0
2024-03-20,26,DPD90+,0,0,0
2024-03-20,32,Current,0,0,0
2024-03-20,32,DPD15-29,79,79,0
2024-03-20,32,DPD3-14,156,156,0
2024-03-20,32,DPD30-59,32,32,0
2024-03-20,32,DPD60-89,0,0,0
2024-03-20,32,DPD90+,0,0,0
2024-03-20,34,Current,0,0,0
2024-03-20,34,DPD15-29,42,42,0
2024-03-20,34,DPD3-14,61,61,0
2024-03-20,34,DPD30-59,15,15,0
2024-03-20,34,DPD60-89,0,0,0
2024-03-20,34,DPD90+,0,0,0
2024-03-20,36,Current,0,0,0
2024-03-20,36,DPD15-29,28,28,0
2024-03-20,36,DPD3-14,51,51,0
2024-03-20,36,DPD30-59,5,5,0
2024-03-20,36,DPD60-89,0,0,0
2024-03-20,36,DPD90+,0,0,0
2024-03-20,38,Current,0,0,0
2024-03-20,38,DPD15-29,25,25,0
2024-03-20,38,DPD3-14,44,44,0
2024-03-20,38,DPD30-59,4,4,0
2024-03-20,38,DPD60-89,0,0,0
2024-03-20,38,DPD90+,0,0,0
2024-03-20,40,Current,0,0,0
2024-03-20,40,DPD15-29,15,15,0
2024-03-20,40,DPD3-14,36,36,0
2024-03-20,40,DPD30-59,0,0,0
2024-03-20,40,DPD60-89,0,0,0
2024-03-20,40,DPD90+,0,0,0
2024-03-20,42,Current,0,0,0
2024-03-20,42,DPD15-29,9,9,0
2024-03-20,42,DPD3-14,18,18,0
2024-03-20,42,DPD30-59,1,1,0
2024-03-20,42,DPD60-89,0,0,0
2024-03-20,42,DPD90+,0,0,0
2024-03-20,44,Current,0,0,0
2024-03-20,44,DPD15-29,19,19,0
2024-03-20,44,DPD3-14,36,36,0
2024-03-20,44,DPD30-59,9,9,0
2024-03-20,44,DPD60-89,0,0,0
2024-03-20,44,DPD90+,0,0,0
2024-03-20,46,Current,0,0,0
2024-03-20,46,DPD60-89,0,0,0
2024-03-20,48,Current,58,58,0
2024-03-20,48,DPD15-29,7,7,0
2024-03-20,48,DPD3-14,25,25,0
2024-03-20,48,DPD30-59,5,5,0
2024-03-20,48,DPD60-89,0,0,0
2024-03-20,48,DPD90+,0,0,0
2024-03-20,6,Current,0,0,0
2024-03-20,6,DPD15-29,0,0,0
2024-03-20,6,DPD3-14,1,1,0
2024-03-19,100,Current,0,0,0
2024-03-19,100,DPD15-29,0,0,0
2024-03-19,102,Current,0,0,0
2024-03-19,102,DPD3-14,0,0,0
2024-03-19,102,DPD60-89,0,0,0
2024-03-19,104,Current,0,0,0
2024-03-19,104,DPD30-59,0,0,0
2024-03-19,104,DPD90+,0,0,0
2024-03-19,20,Current,0,0,0
2024-03-19,20,DPD15-29,235,235,0
2024-03-19,20,DPD3-14,391,391,0
2024-03-19,20,DPD30-59,170,170,0
2024-03-19,20,DPD60-89,49,49,0
2024-03-19,20,DPD90+,38,38,0
2024-03-19,22,Current,0,0,0
2024-03-19,22,DPD15-29,0,0,0
2024-03-19,22,DPD3-14,0,0,0
2024-03-19,22,DPD30-59,0,0,0
2024-03-19,22,DPD60-89,0,0,0
2024-03-19,24,Current,75,75,0
2024-03-19,24,DPD15-29,115,115,0
2024-03-19,24,DPD3-14,211,211,0
2024-03-19,24,DPD30-59,81,81,0
2024-03-19,24,DPD60-89,0,0,0
2024-03-19,24,DPD90+,0,0,0
2024-03-19,26,Current,0,0,0
2024-03-19,26,DPD15-29,13,13,0
2024-03-19,26,DPD3-14,36,36,0
2024-03-19,26,DPD30-59,12,12,0
2024-03-19,26,DPD60-89,0,0,0
2024-03-19,26,DPD90+,0,0,0
2024-03-19,32,Current,0,0,0
2024-03-19,32,DPD15-29,113,113,0
2024-03-19,32,DPD3-14,191,191,0
2024-03-19,32,DPD30-59,82,82,0
2024-03-19,32,DPD60-89,0,0,0
2024-03-19,32,DPD90+,0,0,0
2024-03-19,34,Current,0,0,0
2024-03-19,34,DPD15-29,52,52,0
2024-03-19,34,DPD3-14,84,84,0
2024-03-19,34,DPD30-59,30,30,0
2024-03-19,34,DPD60-89,0,0,0
2024-03-19,34,DPD90+,0,0,0
2024-03-19,36,Current,0,0,0
2024-03-19,36,DPD15-29,38,38,0
2024-03-19,36,DPD3-14,52,52,0
2024-03-19,36,DPD30-59,27,27,0
2024-03-19,36,DPD60-89,0,0,0
2024-03-19,36,DPD90+,0,0,0
2024-03-19,38,Current,0,0,0
2024-03-19,38,DPD15-29,45,45,0
2024-03-19,38,DPD3-14,70,70,0
2024-03-19,38,DPD30-59,17,17,0
2024-03-19,38,DPD60-89,0,0,0
2024-03-19,38,DPD90+,0,0,0
2024-03-19,40,Current,0,0,0
2024-03-19,40,DPD15-29,19,19,0
2024-03-19,40,DPD3-14,43,43,0
2024-03-19,40,DPD30-59,9,9,0
2024-03-19,40,DPD60-89,0,0,0
2024-03-19,40,DPD90+,0,0,0
2024-03-19,42,Current,0,0,0
2024-03-19,42,DPD15-29,15,15,0
2024-03-19,42,DPD3-14,27,27,0
2024-03-19,42,DPD30-59,12,12,0
2024-03-19,42,DPD60-89,0,0,0
2024-03-19,42,DPD90+,0,0,0
2024-03-19,44,Current,0,0,0
2024-03-19,44,DPD15-29,23,23,0
2024-03-19,44,DPD3-14,61,61,0
2024-03-19,44,DPD30-59,18,18,0
2024-03-19,44,DPD60-89,0,0,0
2024-03-19,44,DPD90+,0,0,0
2024-03-19,46,Current,0,0,0
2024-03-19,46,DPD60-89,0,0,0
2024-03-19,48,Current,77,77,0
2024-03-19,48,DPD15-29,16,16,0
2024-03-19,48,DPD3-14,52,52,0
2024-03-19,48,DPD30-59,12,12,0
2024-03-19,48,DPD60-89,0,0,0
2024-03-19,48,DPD90+,0,0,0
2024-03-19,6,Current,0,0,0
2024-03-19,6,DPD15-29,1,1,0
2024-03-19,6,DPD3-14,0,0,0
2024-03-18,100,Current,0,0,0
2024-03-18,100,DPD15-29,0,0,0
2024-03-18,102,Current,0,0,0
2024-03-18,102,DPD3-14,1,1,0
2024-03-18,102,DPD60-89,0,0,0
2024-03-18,104,Current,0,0,0
2024-03-18,104,DPD60-89,0,0,0
2024-03-18,104,DPD90+,0,0,0
2024-03-18,20,Current,0,0,0
2024-03-18,20,DPD15-29,220,220,0
2024-03-18,20,DPD3-14,303,303,0
2024-03-18,20,DPD30-59,159,159,0
2024-03-18,20,DPD60-89,74,74,0
2024-03-18,20,DPD90+,52,52,0
2024-03-18,22,Current,0,0,0
2024-03-18,22,DPD15-29,0,0,0
2024-03-18,22,DPD3-14,1,1,0
2024-03-18,22,DPD30-59,1,1,0
2024-03-18,22,DPD60-89,0,0,0
2024-03-18,24,Current,64,64,0
2024-03-18,24,DPD15-29,119,119,0
2024-03-18,24,DPD3-14,172,172,0
2024-03-18,24,DPD30-59,82,82,0
2024-03-18,24,DPD60-89,0,0,0
2024-03-18,24,DPD90+,0,0,0
2024-03-18,26,Current,0,0,0
2024-03-18,26,DPD15-29,15,15,0
2024-03-18,26,DPD3-14,20,20,0
2024-03-18,26,DPD30-59,11,11,0
2024-03-18,26,DPD60-89,0,0,0
2024-03-18,26,DPD90+,0,0,0
2024-03-18,32,Current,0,0,0
2024-03-18,32,DPD15-29,95,95,0
2024-03-18,32,DPD3-14,122,122,0
2024-03-18,32,DPD30-59,71,71,0
2024-03-18,32,DPD60-89,0,0,0
2024-03-18,32,DPD90+,0,0,0
2024-03-18,34,Current,0,0,0
2024-03-18,34,DPD15-29,53,53,0
2024-03-18,34,DPD3-14,60,60,0
2024-03-18,34,DPD30-59,42,42,0
2024-03-18,34,DPD60-89,0,0,0
2024-03-18,34,DPD90+,0,0,0
2024-03-18,36,Current,0,0,0
2024-03-18,36,DPD15-29,32,32,0
2024-03-18,36,DPD3-14,40,40,0
2024-03-18,36,DPD30-59,25,25,0
2024-03-18,36,DPD60-89,0,0,0
2024-03-18,36,DPD90+,0,0,0
2024-03-18,38,Current,0,0,0
2024-03-18,38,DPD15-29,32,32,0
2024-03-18,38,DPD3-14,47,47,0
2024-03-18,38,DPD30-59,12,12,0
2024-03-18,38,DPD60-89,0,0,0
2024-03-18,38,DPD90+,0,0,0
2024-03-18,40,Current,0,0,0
2024-03-18,40,DPD15-29,15,15,0
2024-03-18,40,DPD3-14,29,29,0
2024-03-18,40,DPD30-59,12,12,0
2024-03-18,40,DPD60-89,0,0,0
2024-03-18,40,DPD90+,0,0,0
2024-03-18,42,Current,0,0,0
2024-03-18,42,DPD15-29,10,10,0
2024-03-18,42,DPD3-14,18,18,0
2024-03-18,42,DPD30-59,6,6,0
2024-03-18,42,DPD60-89,0,0,0
2024-03-18,42,DPD90+,0,0,0
2024-03-18,44,Current,0,0,0
2024-03-18,44,DPD15-29,28,28,0
2024-03-18,44,DPD3-14,31,31,0
2024-03-18,44,DPD30-59,17,17,0
2024-03-18,44,DPD60-89,0,0,0
2024-03-18,44,DPD90+,0,0,0
2024-03-18,46,Current,0,0,0
2024-03-18,46,DPD60-89,0,0,0
2024-03-18,48,Current,81,81,0
2024-03-18,48,DPD15-29,11,11,0
2024-03-18,48,DPD3-14,32,32,0
2024-03-18,48,DPD30-59,7,7,0
2024-03-18,48,DPD60-89,0,0,0
2024-03-18,48,DPD90+,0,0,0
2024-03-18,6,Current,0,0,0
2024-03-18,6,DPD15-29,0,0,0
2024-03-18,6,DPD3-14,1,1,0
2024-03-17,100,Current,0,0,0
2024-03-17,100,DPD3-14,0,0,0
2024-03-17,102,Current,0,0,0
2024-03-17,102,DPD3-14,0,0,0
2024-03-17,102,DPD30-59,0,0,0
2024-03-17,102,DPD60-89,0,0,0
2024-03-17,102,DPD90+,0,0,0
2024-03-17,104,Current,0,0,0
2024-03-17,104,DPD15-29,0,0,0
2024-03-17,104,DPD60-89,0,0,0
2024-03-17,104,DPD90+,0,0,0
2024-03-17,20,Current,0,0,0
2024-03-17,20,DPD15-29,257,257,0
2024-03-17,20,DPD3-14,233,233,0
2024-03-17,20,DPD30-59,52,52,0
2024-03-17,20,DPD60-89,5,5,0
2024-03-17,20,DPD90+,1,1,0
2024-03-17,22,Current,0,0,0
2024-03-17,22,DPD15-29,1,1,0
2024-03-17,22,DPD3-14,0,0,0
2024-03-17,22,DPD30-59,0,0,0
2024-03-17,22,DPD60-89,0,0,0
2024-03-17,24,Current,68,68,0
2024-03-17,24,DPD15-29,126,126,0
2024-03-17,24,DPD3-14,121,121,0
2024-03-17,24,DPD30-59,16,16,0
2024-03-17,24,DPD60-89,0,0,0
2024-03-17,24,DPD90+,0,0,0
2024-03-17,26,Current,0,0,0
2024-03-17,26,DPD15-29,19,19,0
2024-03-17,26,DPD3-14,13,13,0
2024-03-17,26,DPD30-59,1,1,0
2024-03-17,26,DPD60-89,0,0,0
2024-03-17,26,DPD90+,0,0,0
2024-03-17,32,Current,0,0,0
2024-03-17,32,DPD15-29,123,123,0
2024-03-17,32,DPD3-14,102,102,0
2024-03-17,32,DPD30-59,18,18,0
2024-03-17,32,DPD60-89,0,0,0
2024-03-17,32,DPD90+,0,0,0
2024-03-17,34,Current,0,0,0
2024-03-17,34,DPD15-29,60,60,0
2024-03-17,34,DPD3-14,47,47,0
2024-03-17,34,DPD30-59,11,11,0
2024-03-17,34,DPD60-89,0,0,0
2024-03-17,34,DPD90+,0,0,0
2024-03-17,36,Current,0,0,0
2024-03-17,36,DPD15-29,41,41,0
2024-03-17,36,DPD3-14,28,28,0
2024-03-17,36,DPD30-59,6,6,0
2024-03-17,36,DPD60-89,0,0,0
2024-03-17,36,DPD90+,0,0,0
2024-03-17,38,Current,0,0,0
2024-03-17,38,DPD15-29,53,53,0
2024-03-17,38,DPD3-14,36,36,0
2024-03-17,38,DPD30-59,6,6,0
2024-03-17,38,DPD60-89,0,0,0
2024-03-17,38,DPD90+,0,0,0
2024-03-17,40,Current,0,0,0
2024-03-17,40,DPD15-29,18,18,0
2024-03-17,40,DPD3-14,25,25,0
2024-03-17,40,DPD30-59,1,1,0
2024-03-17,40,DPD60-89,0,0,0
2024-03-17,40,DPD90+,0,0,0
2024-03-17,42,Current,0,0,0
2024-03-17,42,DPD15-29,12,12,0
2024-03-17,42,DPD3-14,13,13,0
2024-03-17,42,DPD30-59,1,1,0
2024-03-17,42,DPD60-89,0,0,0
2024-03-17,42,DPD90+,0,0,0
2024-03-17,44,Current,0,0,0
2024-03-17,44,DPD15-29,25,25,0
2024-03-17,44,DPD3-14,25,25,0
2024-03-17,44,DPD30-59,8,8,0
2024-03-17,44,DPD60-89,0,0,0
2024-03-17,44,DPD90+,0,0,0
2024-03-17,46,Current,0,0,0
2024-03-17,46,DPD60-89,0,0,0
2024-03-17,48,Current,57,57,0
2024-03-17,48,DPD15-29,14,14,0
2024-03-17,48,DPD3-14,42,42,0
2024-03-17,48,DPD30-59,0,0,0
2024-03-17,48,DPD60-89,0,0,0
2024-03-17,48,DPD90+,0,0,0
2024-03-17,6,Current,0,0,0
2024-03-17,6,DPD15-29,1,1,0
2024-03-17,6,DPD3-14,0,0,0
2024-03-16,100,Current,0,0,0
2024-03-16,100,DPD3-14,0,0,0
2024-03-16,102,Current,0,0,0
2024-03-16,102,DPD3-14,1,1,0
2024-03-16,102,DPD30-59,0,0,0
2024-03-16,102,DPD60-89,0,0,0
2024-03-16,102,DPD90+,0,0,0
2024-03-16,104,Current,0,0,0
2024-03-16,104,DPD15-29,1,1,0
2024-03-16,104,DPD60-89,0,0,0
2024-03-16,104,DPD90+,0,0,0
2024-03-16,20,Current,0,0,0
2024-03-16,20,DPD15-29,197,197,0
2024-03-16,20,DPD3-14,261,261,0
2024-03-16,20,DPD30-59,29,29,0
2024-03-16,20,DPD60-89,48,48,0
2024-03-16,20,DPD90+,53,53,0
2024-03-16,22,Current,0,0,0
2024-03-16,22,DPD15-29,0,0,0
2024-03-16,22,DPD3-14,1,1,0
2024-03-16,22,DPD30-59,0,0,0
2024-03-16,22,DPD60-89,0,0,0
2024-03-16,24,Current,51,51,0
2024-03-16,24,DPD15-29,112,112,0
2024-03-16,24,DPD3-14,159,159,0
2024-03-16,24,DPD30-59,8,8,0
2024-03-16,24,DPD60-89,0,0,0
2024-03-16,24,DPD90+,0,0,0
2024-03-16,26,Current,0,0,0
2024-03-16,26,DPD15-29,16,16,0
2024-03-16,26,DPD3-14,17,17,0
2024-03-16,26,DPD30-59,2,2,0
2024-03-16,26,DPD60-89,0,0,0
2024-03-16,26,DPD90+,0,0,0
2024-03-16,32,Current,0,0,0
2024-03-16,32,DPD15-29,84,84,0
2024-03-16,32,DPD3-14,108,108,0
2024-03-16,32,DPD30-59,17,17,0
2024-03-16,32,DPD60-89,0,0,0
2024-03-16,32,DPD90+,0,0,0
2024-03-16,34,Current,0,0,0
2024-03-16,34,DPD15-29,50,50,0
2024-03-16,34,DPD3-14,51,51,0
2024-03-16,34,DPD30-59,8,8,0
2024-03-16,34,DPD60-89,0,0,0
2024-03-16,34,DPD90+,0,0,0
2024-03-16,36,Current,0,0,0
2024-03-16,36,DPD15-29,31,31,0
2024-03-16,36,DPD3-14,39,39,0
2024-03-16,36,DPD30-59,3,3,0
2024-03-16,36,DPD60-89,0,0,0
2024-03-16,36,DPD90+,0,0,0
2024-03-16,38,Current,0,0,0
2024-03-16,38,DPD15-29,30,30,0
2024-03-16,38,DPD3-14,37,37,0
2024-03-16,38,DPD30-59,2,2,0
2024-03-16,38,DPD60-89,0,0,0
2024-03-16,38,DPD90+,0,0,0
2024-03-16,40,Current,0,0,0
2024-03-16,40,DPD15-29,15,15,0
2024-03-16,40,DPD3-14,26,26,0
2024-03-16,40,DPD30-59,1,1,0
2024-03-16,40,DPD60-89,0,0,0
2024-03-16,40,DPD90+,0,0,0
2024-03-16,42,Current,0,0,0
2024-03-16,42,DPD15-29,10,10,0
2024-03-16,42,DPD3-14,16,16,0
2024-03-16,42,DPD30-59,0,0,0
2024-03-16,42,DPD60-89,0,0,0
2024-03-16,42,DPD90+,0,0,0
2024-03-16,44,Current,0,0,0
2024-03-16,44,DPD15-29,29,29,0
2024-03-16,44,DPD3-14,21,21,0
2024-03-16,44,DPD30-59,2,2,0
2024-03-16,44,DPD60-89,0,0,0
2024-03-16,44,DPD90+,0,0,0
2024-03-16,46,Current,0,0,0
2024-03-16,46,DPD60-89,0,0,0
2024-03-16,48,Current,68,68,0
2024-03-16,48,DPD15-29,10,10,0
2024-03-16,48,DPD3-14,28,28,0
2024-03-16,48,DPD30-59,2,2,0
2024-03-16,48,DPD60-89,0,0,0
2024-03-16,48,DPD90+,0,0,0
2024-03-16,6,Current,0,0,0
2024-03-16,6,DPD15-29,0,0,0
2024-03-16,6,DPD3-14,1,1,0
2024-03-15,100,Current,0,0,0
2024-03-15,100,DPD3-14,0,0,0
2024-03-15,102,Current,0,0,0
2024-03-15,102,DPD3-14,0,0,0
2024-03-15,102,DPD30-59,0,0,0
2024-03-15,102,DPD60-89,0,0,0
2024-03-15,102,DPD90+,0,0,0
2024-03-15,104,Current,0,0,0
2024-03-15,104,DPD15-29,0,0,0
2024-03-15,104,DPD60-89,0,0,0
2024-03-15,104,DPD90+,0,0,0
2024-03-15,20,Current,5417,5417,0
2024-03-15,20,DPD15-29,313,313,0
2024-03-15,20,DPD3-14,324,324,0
2024-03-15,20,DPD30-59,183,183,0
2024-03-15,20,DPD60-89,58,58,0
2024-03-15,20,DPD90+,79,79,0
2024-03-15,22,Current,0,0,0
2024-03-15,22,DPD15-29,2,2,0
2024-03-15,22,DPD3-14,0,0,0
2024-03-15,22,DPD30-59,0,0,0
2024-03-15,22,DPD60-89,0,0,0
2024-03-15,24,Current,3879,3879,0
2024-03-15,24,DPD15-29,143,143,0
2024-03-15,24,DPD3-14,194,194,0
2024-03-15,24,DPD30-59,86,86,0
2024-03-15,24,DPD60-89,8,8,0
2024-03-15,24,DPD90+,10,10,0
2024-03-15,26,Current,21,21,0
2024-03-15,26,DPD15-29,15,15,0
2024-03-15,26,DPD3-14,16,16,0
2024-03-15,26,DPD30-59,10,10,0
2024-03-15,26,DPD60-89,0,0,0
2024-03-15,26,DPD90+,0,0,0
2024-03-15,32,Current,353,353,0
2024-03-15,32,DPD15-29,122,122,0
2024-03-15,32,DPD3-14,119,119,0
2024-03-15,32,DPD30-59,64,64,0
2024-03-15,32,DPD60-89,4,4,0
2024-03-15,32,DPD90+,3,3,0
2024-03-15,34,Current,34,34,0
2024-03-15,34,DPD15-29,63,63,0
2024-03-15,34,DPD3-14,43,43,0
2024-03-15,34,DPD30-59,23,23,0
2024-03-15,34,DPD60-89,0,0,0
2024-03-15,34,DPD90+,0,0,0
2024-03-15,36,Current,328,328,0
2024-03-15,36,DPD15-29,42,42,0
2024-03-15,36,DPD3-14,40,40,0
2024-03-15,36,DPD30-59,24,24,0
2024-03-15,36,DPD60-89,4,4,0
2024-03-15,36,DPD90+,3,3,0
2024-03-15,38,Current,32,32,0
2024-03-15,38,DPD15-29,47,47,0
2024-03-15,38,DPD3-14,39,39,0
2024-03-15,38,DPD30-59,13,13,0
2024-03-15,38,DPD60-89,0,0,0
2024-03-15,38,DPD90+,0,0,0
2024-03-15,40,Current,347,347,0
2024-03-15,40,DPD15-29,23,23,0
2024-03-15,40,DPD3-14,25,25,0
2024-03-15,40,DPD30-59,10,10,0
2024-03-15,40,DPD60-89,2,2,0
2024-03-15,40,DPD90+,0,0,0
2024-03-15,42,Current,13,13,0
2024-03-15,42,DPD15-29,14,14,0
2024-03-15,42,DPD3-14,11,11,0
2024-03-15,42,DPD30-59,11,11,0
2024-03-15,42,DPD60-89,0,0,0
2024-03-15,42,DPD90+,0,0,0
2024-03-15,44,Current,228,228,0
2024-03-15,44,DPD15-29,22,22,0
2024-03-15,44,DPD3-14,30,30,0
2024-03-15,44,DPD30-59,15,15,0
2024-03-15,44,DPD60-89,1,1,0
2024-03-15,44,DPD90+,0,0,0
2024-03-15,46,Current,5,5,0
2024-03-15,46,DPD60-89,0,0,0
2024-03-15,48,Current,4169,4169,0
2024-03-15,48,DPD15-29,24,24,0
2024-03-15,48,DPD3-14,93,93,0
2024-03-15,48,DPD30-59,26,26,0
2024-03-15,48,DPD60-89,11,11,0
2024-03-15,48,DPD90+,12,12,0
2024-03-15,6,Current,2,2,0
2024-03-15,6,DPD3-14,3,3,0
2024-03-14,100,Current,0,0,0
2024-03-14,100,DPD3-14,0,0,0
2024-03-14,102,Current,0,0,0
2024-03-14,102,DPD3-14,0,0,0
2024-03-14,102,DPD30-59,0,0,0
2024-03-14,102,DPD60-89,0,0,0
2024-03-14,104,Current,0,0,0
2024-03-14,104,DPD15-29,1,1,0
2024-03-14,104,DPD60-89,0,0,0
2024-03-14,104,DPD90+,0,0,0
2024-03-14,20,Current,3,3,0
2024-03-14,20,DPD15-29,251,251,0
2024-03-14,20,DPD3-14,278,278,0
2024-03-14,20,DPD30-59,165,165,0
2024-03-14,20,DPD60-89,65,65,0
2024-03-14,20,DPD90+,51,51,0
2024-03-14,22,Current,0,0,0
2024-03-14,22,DPD15-29,0,0,0
2024-03-14,22,DPD3-14,1,1,0
2024-03-14,22,DPD30-59,1,1,0
2024-03-14,22,DPD60-89,0,0,0
2024-03-14,22,DPD90+,0,0,0
2024-03-14,24,Current,49,49,0
2024-03-14,24,DPD15-29,133,133,0
2024-03-14,24,DPD3-14,158,158,0
2024-03-14,24,DPD30-59,88,88,0
2024-03-14,24,DPD60-89,0,0,0
2024-03-14,24,DPD90+,0,0,0
2024-03-14,26,Current,0,0,0
2024-03-14,26,DPD15-29,25,25,0
2024-03-14,26,DPD3-14,15,15,0
2024-03-14,26,DPD30-59,11,11,0
2024-03-14,26,DPD60-89,0,0,0
2024-03-14,26,DPD90+,0,0,0
2024-03-14,32,Current,0,0,0
2024-03-14,32,DPD15-29,110,110,0
2024-03-14,32,DPD3-14,106,106,0
2024-03-14,32,DPD30-59,91,91,0
2024-03-14,32,DPD60-89,0,0,0
2024-03-14,32,DPD90+,0,0,0
2024-03-14,34,Current,0,0,0
2024-03-14,34,DPD15-29,63,63,0
2024-03-14,34,DPD3-14,51,51,0
2024-03-14,34,DPD30-59,46,46,0
2024-03-14,34,DPD60-89,0,0,0
2024-03-14,34,DPD90+,0,0,0
2024-03-14,36,Current,0,0,0
2024-03-14,36,DPD15-29,38,38,0
2024-03-14,36,DPD3-14,43,43,0
2024-03-14,36,DPD30-59,29,29,0
2024-03-14,36,DPD60-89,0,0,0
2024-03-14,36,DPD90+,0,0,0
2024-03-14,38,Current,0,0,0
2024-03-14,38,DPD15-29,33,33,0
2024-03-14,38,DPD3-14,37,37,0
2024-03-14,38,DPD30-59,15,15,0
2024-03-14,38,DPD60-89,0,0,0
2024-03-14,38,DPD90+,0,0,0
2024-03-14,40,Current,3,3,0
2024-03-14,40,DPD15-29,19,19,0
2024-03-14,40,DPD3-14,31,31,0
2024-03-14,40,DPD30-59,10,10,0
2024-03-14,40,DPD60-89,0,0,0
2024-03-14,40,DPD90+,0,0,0
2024-03-14,42,Current,0,0,0
2024-03-14,42,DPD15-29,15,15,0
2024-03-14,42,DPD3-14,12,12,0
2024-03-14,42,DPD30-59,6,6,0
2024-03-14,42,DPD60-89,0,0,0
2024-03-14,42,DPD90+,0,0,0
2024-03-14,44,Current,0,0,0
2024-03-14,44,DPD15-29,35,35,0
2024-03-14,44,DPD3-14,28,28,0
2024-03-14,44,DPD30-59,17,17,0
2024-03-14,44,DPD60-89,0,0,0
2024-03-14,44,DPD90+,0,0,0
2024-03-14,46,Current,0,0,0
2024-03-14,46,DPD60-89,0,0,0
2024-03-14,48,Current,59,59,0
2024-03-14,48,DPD15-29,13,13,0
2024-03-14,48,DPD3-14,28,28,0
2024-03-14,48,DPD30-59,9,9,0
2024-03-14,48,DPD60-89,0,0,0
2024-03-14,48,DPD90+,0,0,0
2024-03-14,6,Current,0,0,0
2024-03-14,6,DPD3-14,1,1,0
2024-03-13,100,Current,0,0,0
2024-03-13,100,DPD3-14,0,0,0
2024-03-13,102,Current,0,0,0
2024-03-13,102,DPD3-14,0,0,0
2024-03-13,102,DPD30-59,0,0,0
2024-03-13,102,DPD60-89,0,0,0
2024-03-13,104,Current,0,0,0
2024-03-13,104,DPD15-29,0,0,0
2024-03-13,104,DPD60-89,0,0,0
2024-03-13,104,DPD90+,0,0,0
2024-03-13,20,Current,0,0,0
2024-03-13,20,DPD15-29,181,181,0
2024-03-13,20,DPD3-14,323,323,0
2024-03-13,20,DPD30-59,46,46,0
2024-03-13,20,DPD60-89,30,30,0
2024-03-13,20,DPD90+,21,21,0
2024-03-13,22,Current,0,0,0
2024-03-13,22,DPD15-29,1,1,0
2024-03-13,22,DPD3-14,1,1,0
2024-03-13,22,DPD30-59,0,0,0
2024-03-13,22,DPD60-89,0,0,0
2024-03-13,22,DPD90+,0,0,0
2024-03-13,24,Current,23,23,0
2024-03-13,24,DPD15-29,121,121,0
2024-03-13,24,DPD3-14,158,158,0
2024-03-13,24,DPD30-59,17,17,0
2024-03-13,24,DPD60-89,0,0,0
2024-03-13,24,DPD90+,0,0,0
2024-03-13,26,Current,0,0,0
2024-03-13,26,DPD15-29,9,9,0
2024-03-13,26,DPD3-14,24,24,0
2024-03-13,26,DPD30-59,1,1,0
2024-03-13,26,DPD60-89,0,0,0
2024-03-13,26,DPD90+,0,0,0
2024-03-13,32,Current,0,0,0
2024-03-13,32,DPD15-29,102,102,0
2024-03-13,32,DPD3-14,149,149,0
2024-03-13,32,DPD30-59,17,17,0
2024-03-13,32,DPD60-89,0,0,0
2024-03-13,32,DPD90+,0,0,0
2024-03-13,34,Current,0,0,0
2024-03-13,34,DPD15-29,40,40,0
2024-03-13,34,DPD3-14,62,62,0
2024-03-13,34,DPD30-59,10,10,0
2024-03-13,34,DPD60-89,0,0,0
2024-03-13,34,DPD90+,0,0,0
2024-03-13,36,Current,0,0,0
2024-03-13,36,DPD15-29,29,29,0
2024-03-13,36,DPD3-14,44,44,0
2024-03-13,36,DPD30-59,6,6,0
2024-03-13,36,DPD60-89,0,0,0
2024-03-13,36,DPD90+,0,0,0
2024-03-13,38,Current,0,0,0
2024-03-13,38,DPD15-29,36,36,0
2024-03-13,38,DPD3-14,46,46,0
2024-03-13,38,DPD30-59,7,7,0
2024-03-13,38,DPD60-89,0,0,0
2024-03-13,38,DPD90+,0,0,0
2024-03-13,40,Current,0,0,0
2024-03-13,40,DPD15-29,12,12,0
2024-03-13,40,DPD3-14,30,30,0
2024-03-13,40,DPD30-59,1,1,0
2024-03-13,40,DPD60-89,0,0,0
2024-03-13,40,DPD90+,0,0,0
2024-03-13,42,Current,0,0,0
2024-03-13,42,DPD15-29,10,10,0
2024-03-13,42,DPD3-14,16,16,0
2024-03-13,42,DPD30-59,1,1,0
2024-03-13,42,DPD60-89,0,0,0
2024-03-13,42,DPD90+,0,0,0
2024-03-13,44,Current,0,0,0
2024-03-13,44,DPD15-29,20,20,0
2024-03-13,44,DPD3-14,39,39,0
2024-03-13,44,DPD30-59,9,9,0
2024-03-13,44,DPD60-89,0,0,0
2024-03-13,44,DPD90+,0,0,0
2024-03-13,46,Current,0,0,0
2024-03-13,46,DPD60-89,0,0,0
2024-03-13,48,Current,35,35,0
2024-03-13,48,DPD15-29,8,8,0
2024-03-13,48,DPD3-14,34,34,0
2024-03-13,48,DPD30-59,0,0,0
2024-03-13,48,DPD60-89,0,0,0
2024-03-13,48,DPD90+,0,0,0
2024-03-13,6,Current,0,0,0
2024-03-13,6,DPD3-14,1,1,0
2024-03-12,100,Current,0,0,0
2024-03-12,100,DPD3-14,0,0,0
2024-03-12,102,Current,0,0,0
2024-03-12,102,DPD3-14,0,0,0
2024-03-12,102,DPD30-59,0,0,0
2024-03-12,102,DPD60-89,0,0,0
2024-03-12,104,Current,0,0,0
2024-03-12,104,DPD15-29,1,1,0
2024-03-12,104,DPD60-89,0,0,0
2024-03-12,104,DPD90+,0,0,0
2024-03-12,20,Current,0,0,0
2024-03-12,20,DPD15-29,246,246,0
2024-03-12,20,DPD3-14,269,269,0
2024-03-12,20,DPD30-59,139,139,0
2024-03-12,20,DPD60-89,45,45,0
2024-03-12,20,DPD90+,25,25,0
2024-03-12,22,Current,0,0,0
2024-03-12,22,DPD15-29,0,0,0
2024-03-12,22,DPD3-14,1,1,0
2024-03-12,22,DPD30-59,0,0,0
2024-03-12,22,DPD60-89,0,0,0
2024-03-12,22,DPD90+,0,0,0
2024-03-12,24,Current,38,38,0
2024-03-12,24,DPD15-29,131,131,0
2024-03-12,24,DPD3-14,143,143,0
2024-03-12,24,DPD30-59,78,78,0
2024-03-12,24,DPD60-89,0,0,0
2024-03-12,24,DPD90+,0,0,0
2024-03-12,26,Current,0,0,0
2024-03-12,26,DPD15-29,27,27,0
2024-03-12,26,DPD3-14,21,21,0
2024-03-12,26,DPD30-59,9,9,0
2024-03-12,26,DPD60-89,0,0,0
2024-03-12,26,DPD90+,0,0,0
2024-03-12,32,Current,0,0,0
2024-03-12,32,DPD15-29,117,117,0
2024-03-12,32,DPD3-14,108,108,0
2024-03-12,32,DPD30-59,65,65,0
2024-03-12,32,DPD60-89,0,0,0
2024-03-12,32,DPD90+,0,0,0
2024-03-12,34,Current,0,0,0
2024-03-12,34,DPD15-29,54,54,0
2024-03-12,34,DPD3-14,54,54,0
2024-03-12,34,DPD30-59,26,26,0
2024-03-12,34,DPD60-89,0,0,0
2024-03-12,34,DPD90+,0,0,0
2024-03-12,36,Current,0,0,0
2024-03-12,36,DPD15-29,34,34,0
2024-03-12,36,DPD3-14,40,40,0
2024-03-12,36,DPD30-59,24,24,0
2024-03-12,36,DPD60-89,0,0,0
2024-03-12,36,DPD90+,0,0,0
2024-03-12,38,Current,0,0,0
2024-03-12,38,DPD15-29,34,34,0
2024-03-12,38,DPD3-14,40,40,0
2024-03-12,38,DPD30-59,14,14,0
2024-03-12,38,DPD60-89,0,0,0
2024-03-12,38,DPD90+,0,0,0
2024-03-12,40,Current,0,0,0
2024-03-12,40,DPD15-29,16,16,0
2024-03-12,40,DPD3-14,30,30,0
2024-03-12,40,DPD30-59,12,12,0
2024-03-12,40,DPD60-89,0,0,0
2024-03-12,40,DPD90+,0,0,0
2024-03-12,42,Current,0,0,0
2024-03-12,42,DPD15-29,13,13,0
2024-03-12,42,DPD3-14,13,13,0
2024-03-12,42,DPD30-59,11,11,0
2024-03-12,42,DPD60-89,0,0,0
2024-03-12,42,DPD90+,0,0,0
2024-03-12,44,Current,0,0,0
2024-03-12,44,DPD15-29,36,36,0
2024-03-12,44,DPD3-14,33,33,0
2024-03-12,44,DPD30-59,18,18,0
2024-03-12,44,DPD60-89,0,0,0
2024-03-12,44,DPD90+,0,0,0
2024-03-12,46,Current,0,0,0
2024-03-12,46,DPD60-89,0,0,0
2024-03-12,48,Current,38,38,0
2024-03-12,48,DPD15-29,11,11,0
2024-03-12,48,DPD3-14,26,26,0
2024-03-12,48,DPD30-59,9,9,0
2024-03-12,48,DPD60-89,0,0,0
2024-03-12,48,DPD90+,0,0,0
2024-03-12,6,Current,0,0,0
2024-03-12,6,DPD3-14,1,1,0
2024-03-11,100,Current,0,0,0
2024-03-11,100,DPD3-14,0,0,0
2024-03-11,102,Current,0,0,0
2024-03-11,102,DPD3-14,0,0,0
2024-03-11,102,DPD30-59,0,0,0
2024-03-11,102,DPD60-89,0,0,0
2024-03-11,104,Current,0,0,0
2024-03-11,104,DPD15-29,0,0,0
2024-03-11,104,DPD60-89,0,0,0
2024-03-11,104,DPD90+,0,0,0
2024-03-11,20,Current,0,0,0
2024-03-11,20,DPD15-29,194,194,0
2024-03-11,20,DPD3-14,407,407,0
2024-03-11,20,DPD30-59,69,69,0
2024-03-11,20,DPD60-89,5,5,0
2024-03-11,20,DPD90+,8,8,0
2024-03-11,22,Current,0,0,0
2024-03-11,22,DPD15-29,0,0,0
2024-03-11,22,DPD3-14,2,2,0
2024-03-11,22,DPD30-59,1,1,0
2024-03-11,22,DPD60-89,0,0,0
2024-03-11,22,DPD90+,0,0,0
2024-03-11,24,Current,16,16,0
2024-03-11,24,DPD15-29,137,137,0
2024-03-11,24,DPD3-14,200,200,0
2024-03-11,24,DPD30-59,50,50,0
2024-03-11,24,DPD60-89,0,0,0
2024-03-11,24,DPD90+,0,0,0
2024-03-11,26,Current,0,0,0
2024-03-11,26,DPD15-29,12,12,0
2024-03-11,26,DPD3-14,28,28,0
2024-03-11,26,DPD30-59,6,6,0
2024-03-11,26,DPD60-89,0,0,0
2024-03-11,26,DPD90+,0,0,0
2024-03-11,32,Current,0,0,0
2024-03-11,32,DPD15-29,109,109,0
2024-03-11,32,DPD3-14,163,163,0
2024-03-11,32,DPD30-59,34,34,0
2024-03-11,32,DPD60-89,0,0,0
2024-03-11,32,DPD90+,0,0,0
2024-03-11,34,Current,0,0,0
2024-03-11,34,DPD15-29,42,42,0
2024-03-11,34,DPD3-14,66,66,0
2024-03-11,34,DPD30-59,14,14,0
2024-03-11,34,DPD60-89,0,0,0
2024-03-11,34,DPD90+,0,0,0
2024-03-11,36,Current,0,0,0
2024-03-11,36,DPD15-29,31,31,0
2024-03-11,36,DPD3-14,47,47,0
2024-03-11,36,DPD30-59,12,12,0
2024-03-11,36,DPD60-89,0,0,0
2024-03-11,36,DPD90+,0,0,0
2024-03-11,38,Current,0,0,0
2024-03-11,38,DPD15-29,32,32,0
2024-03-11,38,DPD3-14,54,54,0
2024-03-11,38,DPD30-59,8,8,0
2024-03-11,38,DPD60-89,0,0,0
2024-03-11,38,DPD90+,0,0,0
2024-03-11,40,Current,0,0,0
2024-03-11,40,DPD15-29,12,12,0
2024-03-11,40,DPD3-14,33,33,0
2024-03-11,40,DPD30-59,5,5,0
2024-03-11,40,DPD60-89,0,0,0
2024-03-11,40,DPD90+,0,0,0
2024-03-11,42,Current,0,0,0
2024-03-11,42,DPD15-29,13,13,0
2024-03-11,42,DPD3-14,22,22,0
2024-03-11,42,DPD30-59,2,2,0
2024-03-11,42,DPD60-89,0,0,0
2024-03-11,42,DPD90+,0,0,0
2024-03-11,44,Current,0,0,0
2024-03-11,44,DPD15-29,20,20,0
2024-03-11,44,DPD3-14,55,55,0
2024-03-11,44,DPD30-59,10,10,0
2024-03-11,44,DPD60-89,0,0,0
2024-03-11,44,DPD90+,0,0,0
2024-03-11,46,Current,0,0,0
2024-03-11,46,DPD60-89,0,0,0
2024-03-11,48,Current,36,36,0
2024-03-11,48,DPD15-29,9,9,0
2024-03-11,48,DPD3-14,40,40,0
2024-03-11,48,DPD30-59,8,8,0
2024-03-11,48,DPD60-89,0,0,0
2024-03-11,48,DPD90+,0,0,0
2024-03-11,6,Current,0,0,0
2024-03-11,6,DPD3-14,1,1,0
2024-03-10,100,Current,0,0,0
2024-03-10,100,DPD3-14,0,0,0
2024-03-10,102,Current,0,0,0
2024-03-10,102,DPD3-14,0,0,0
2024-03-10,102,DPD30-59,0,0,0
2024-03-10,102,DPD60-89,0,0,0
2024-03-10,104,Current,0,0,0
2024-03-10,104,DPD15-29,1,1,0
2024-03-10,104,DPD60-89,0,0,0
2024-03-10,104,DPD90+,0,0,0
2024-03-10,20,Current,0,0,0
2024-03-10,20,DPD15-29,238,238,0
2024-03-10,20,DPD3-14,252,252,0
2024-03-10,20,DPD30-59,117,117,0
2024-03-10,20,DPD60-89,91,91,0
2024-03-10,20,DPD90+,75,75,0
2024-03-10,22,Current,0,0,0
2024-03-10,22,DPD15-29,0,0,0
2024-03-10,22,DPD3-14,0,0,0
2024-03-10,22,DPD30-59,1,1,0
2024-03-10,22,DPD60-89,0,0,0
2024-03-10,22,DPD90+,0,0,0
2024-03-10,24,Current,75,75,0
2024-03-10,24,DPD15-29,122,122,0
2024-03-10,24,DPD3-14,142,142,0
2024-03-10,24,DPD30-59,46,46,0
2024-03-10,24,DPD60-89,0,0,0
2024-03-10,24,DPD90+,0,0,0
2024-03-10,26,Current,0,0,0
2024-03-10,26,DPD15-29,25,25,0
2024-03-10,26,DPD3-14,16,16,0
2024-03-10,26,DPD30-59,7,7,0
2024-03-10,26,DPD60-89,0,0,0
2024-03-10,26,DPD90+,0,0,0
2024-03-10,32,Current,0,0,0
2024-03-10,32,DPD15-29,119,119,0
2024-03-10,32,DPD3-14,104,104,0
2024-03-10,32,DPD30-59,71,71,0
2024-03-10,32,DPD60-89,0,0,0
2024-03-10,32,DPD90+,0,0,0
2024-03-10,34,Current,0,0,0
2024-03-10,34,DPD15-29,48,48,0
2024-03-10,34,DPD3-14,60,60,0
2024-03-10,34,DPD30-59,36,36,0
2024-03-10,34,DPD60-89,0,0,0
2024-03-10,34,DPD90+,0,0,0
2024-03-10,36,Current,0,0,0
2024-03-10,36,DPD15-29,27,27,0
2024-03-10,36,DPD3-14,41,41,0
2024-03-10,36,DPD30-59,26,26,0
2024-03-10,36,DPD60-89,0,0,0
2024-03-10,36,DPD90+,0,0,0
2024-03-10,38,Current,0,0,0
2024-03-10,38,DPD15-29,32,32,0
2024-03-10,38,DPD3-14,36,36,0
2024-03-10,38,DPD30-59,11,11,0
2024-03-10,38,DPD60-89,0,0,0
2024-03-10,38,DPD90+,0,0,0
2024-03-10,40,Current,0,0,0
2024-03-10,40,DPD15-29,17,17,0
2024-03-10,40,DPD3-14,25,25,0
2024-03-10,40,DPD30-59,4,4,0
2024-03-10,40,DPD60-89,0,0,0
2024-03-10,40,DPD90+,0,0,0
2024-03-10,42,Current,0,0,0
2024-03-10,42,DPD15-29,11,11,0
2024-03-10,42,DPD3-14,16,16,0
2024-03-10,42,DPD30-59,5,5,0
2024-03-10,42,DPD60-89,0,0,0
2024-03-10,42,DPD90+,0,0,0
2024-03-10,44,Current,0,0,0
2024-03-10,44,DPD15-29,35,35,0
2024-03-10,44,DPD3-14,29,29,0
2024-03-10,44,DPD30-59,11,11,0
2024-03-10,44,DPD60-89,0,0,0
2024-03-10,44,DPD90+,0,0,0
2024-03-10,46,Current,0,0,0
2024-03-10,46,DPD60-89,0,0,0
2024-03-10,48,Current,71,71,0
2024-03-10,48,DPD15-29,11,11,0
2024-03-10,48,DPD3-14,20,20,0
2024-03-10,48,DPD30-59,3,3,0
2024-03-10,48,DPD60-89,0,0,0
2024-03-10,48,DPD90+,0,0,0
2024-03-10,6,Current,0,0,0
2024-03-10,6,DPD3-14,0,0,0
2024-03-09,100,Current,0,0,0
2024-03-09,100,DPD3-14,0,0,0
2024-03-09,102,Current,0,0,0
2024-03-09,102,DPD3-14,0,0,0
2024-03-09,102,DPD30-59,0,0,0
2024-03-09,102,DPD60-89,0,0,0
2024-03-09,104,Current,0,0,0
2024-03-09,104,DPD15-29,0,0,0
2024-03-09,104,DPD60-89,0,0,0
2024-03-09,104,DPD90+,0,0,0
2024-03-09,20,Current,0,0,0
2024-03-09,20,DPD15-29,172,172,0
2024-03-09,20,DPD3-14,362,362,0
2024-03-09,20,DPD30-59,31,31,0
2024-03-09,20,DPD60-89,3,3,0
2024-03-09,20,DPD90+,2,2,0
2024-03-09,22,Current,0,0,0
2024-03-09,22,DPD15-29,0,0,0
2024-03-09,22,DPD3-14,2,2,0
2024-03-09,22,DPD30-59,0,0,0
2024-03-09,22,DPD60-89,0,0,0
2024-03-09,22,DPD90+,0,0,0
2024-03-09,24,Current,33,33,0
2024-03-09,24,DPD15-29,122,122,0
2024-03-09,24,DPD3-14,192,192,0
2024-03-09,24,DPD30-59,13,13,0
2024-03-09,24,DPD60-89,0,0,0
2024-03-09,24,DPD90+,0,0,0
2024-03-09,26,Current,0,0,0
2024-03-09,26,DPD15-29,12,12,0
2024-03-09,26,DPD3-14,25,25,0
2024-03-09,26,DPD30-59,2,2,0
2024-03-09,26,DPD60-89,0,0,0
2024-03-09,26,DPD90+,0,0,0
2024-03-09,32,Current,0,0,0
2024-03-09,32,DPD15-29,95,95,0
2024-03-09,32,DPD3-14,154,154,0
2024-03-09,32,DPD30-59,10,10,0
2024-03-09,32,DPD60-89,0,0,0
2024-03-09,32,DPD90+,0,0,0
2024-03-09,34,Current,0,0,0
2024-03-09,34,DPD15-29,42,42,0
2024-03-09,34,DPD3-14,57,57,0
2024-03-09,34,DPD30-59,7,7,0
2024-03-09,34,DPD60-89,0,0,0
2024-03-09,34,DPD90+,0,0,0
2024-03-09,36,Current,0,0,0
2024-03-09,36,DPD15-29,27,27,0
2024-03-09,36,DPD3-14,49,49,0
2024-03-09,36,DPD30-59,6,6,0
2024-03-09,36,DPD60-89,0,0,0
2024-03-09,36,DPD90+,0,0,0
2024-03-09,38,Current,0,0,0
2024-03-09,38,DPD15-29,27,27,0
2024-03-09,38,DPD3-14,56,56,0
2024-03-09,38,DPD30-59,5,5,0
2024-03-09,38,DPD60-89,0,0,0
2024-03-09,38,DPD90+,0,0,0
2024-03-09,40,Current,0,0,0
2024-03-09,40,DPD15-29,11,11,0
2024-03-09,40,DPD3-14,28,28,0
2024-03-09,40,DPD30-59,1,1,0
2024-03-09,40,DPD60-89,0,0,0
2024-03-09,40,DPD90+,0,0,0
2024-03-09,42,Current,0,0,0
2024-03-09,42,DPD15-29,8,8,0
2024-03-09,42,DPD3-14,21,21,0
2024-03-09,42,DPD30-59,2,2,0
2024-03-09,42,DPD60-89,0,0,0
2024-03-09,42,DPD90+,0,0,0
2024-03-09,44,Current,0,0,0
2024-03-09,44,DPD15-29,22,22,0
2024-03-09,44,DPD3-14,39,39,0
2024-03-09,44,DPD30-59,6,6,0
2024-03-09,44,DPD60-89,0,0,0
2024-03-09,44,DPD90+,0,0,0
2024-03-09,46,Current,0,0,0
2024-03-09,46,DPD60-89,0,0,0
2024-03-09,48,Current,43,43,0
2024-03-09,48,DPD15-29,9,9,0
2024-03-09,48,DPD3-14,29,29,0
2024-03-09,48,DPD30-59,0,0,0
2024-03-09,48,DPD60-89,0,0,0
2024-03-09,48,DPD90+,0,0,0
2024-03-09,6,Current,0,0,0
2024-03-09,6,DPD3-14,1,1,0
2024-03-08,100,Current,0,0,0
2024-03-08,100,DPD3-14,0,0,0
2024-03-08,102,Current,0,0,0
2024-03-08,102,DPD30-59,0,0,0
2024-03-08,102,DPD60-89,0,0,0
2024-03-08,104,Current,0,0,0
2024-03-08,104,DPD15-29,1,1,0
2024-03-08,104,DPD60-89,0,0,0
2024-03-08,104,DPD90+,0,0,0
2024-03-08,20,Current,254,254,0
2024-03-08,20,DPD15-29,231,231,0
2024-03-08,20,DPD3-14,264,264,0
2024-03-08,20,DPD30-59,150,150,0
2024-03-08,20,DPD60-89,72,72,0
2024-03-08,20,DPD90+,32,32,0
2024-03-08,22,Current,0,0,0
2024-03-08,22,DPD15-29,0,0,0
2024-03-08,22,DPD3-14,0,0,0
2024-03-08,22,DPD30-59,0,0,0
2024-03-08,22,DPD60-89,0,0,0
2024-03-08,22,DPD90+,0,0,0
2024-03-08,24,Current,254,254,0
2024-03-08,24,DPD15-29,110,110,0
2024-03-08,24,DPD3-14,151,151,0
2024-03-08,24,DPD30-59,79,79,0
2024-03-08,24,DPD60-89,0,0,0
2024-03-08,24,DPD90+,0,0,0
2024-03-08,26,Current,26,26,0
2024-03-08,26,DPD15-29,23,23,0
2024-03-08,26,DPD3-14,18,18,0
2024-03-08,26,DPD30-59,8,8,0
2024-03-08,26,DPD60-89,0,0,0
2024-03-08,26,DPD90+,0,0,0
2024-03-08,32,Current,103,103,0
2024-03-08,32,DPD15-29,123,123,0
2024-03-08,32,DPD3-14,111,111,0
2024-03-08,32,DPD30-59,63,63,0
2024-03-08,32,DPD60-89,0,0,0
2024-03-08,32,DPD90+,0,0,0
2024-03-08,34,Current,38,38,0
2024-03-08,34,DPD15-29,46,46,0
2024-03-08,34,DPD3-14,60,60,0
2024-03-08,34,DPD30-59,29,29,0
2024-03-08,34,DPD60-89,0,0,0
2024-03-08,34,DPD90+,0,0,0
2024-03-08,36,Current,41,41,0
2024-03-08,36,DPD15-29,26,26,0
2024-03-08,36,DPD3-14,41,41,0
2024-03-08,36,DPD30-59,30,30,0
2024-03-08,36,DPD60-89,0,0,0
2024-03-08,36,DPD90+,0,0,0
2024-03-08,38,Current,38,38,0
2024-03-08,38,DPD15-29,28,28,0
2024-03-08,38,DPD3-14,32,32,0
2024-03-08,38,DPD30-59,15,15,0
2024-03-08,38,DPD60-89,0,0,0
2024-03-08,38,DPD90+,0,0,0
2024-03-08,40,Current,21,21,0
2024-03-08,40,DPD15-29,19,19,0
2024-03-08,40,DPD3-14,19,19,0
2024-03-08,40,DPD30-59,11,11,0
2024-03-08,40,DPD60-89,0,0,0
2024-03-08,40,DPD90+,0,0,0
2024-03-08,42,Current,14,14,0
2024-03-08,42,DPD15-29,8,8,0
2024-03-08,42,DPD3-14,17,17,0
2024-03-08,42,DPD30-59,10,10,0
2024-03-08,42,DPD60-89,0,0,0
2024-03-08,42,DPD90+,0,0,0
2024-03-08,44,Current,40,40,0
2024-03-08,44,DPD15-29,34,34,0
2024-03-08,44,DPD3-14,31,31,0
2024-03-08,44,DPD30-59,18,18,0
2024-03-08,44,DPD60-89,0,0,0
2024-03-08,44,DPD90+,0,0,0
2024-03-08,46,Current,0,0,0
2024-03-08,46,DPD60-89,0,0,0
2024-03-08,48,Current,124,124,0
2024-03-08,48,DPD15-29,12,12,0
2024-03-08,48,DPD3-14,15,15,0
2024-03-08,48,DPD30-59,9,9,0
2024-03-08,48,DPD60-89,0,0,0
2024-03-08,48,DPD90+,0,0,0
2024-03-08,6,Current,0,0,0
2024-03-08,6,DPD3-14,0,0,0
2024-03-07,100,Current,0,0,0
2024-03-07,100,DPD3-14,1,1,0
2024-03-07,102,Current,0,0,0
2024-03-07,102,DPD30-59,0,0,0
2024-03-07,102,DPD60-89,0,0,0
2024-03-07,104,Current,0,0,0
2024-03-07,104,DPD15-29,1,1,0
2024-03-07,104,DPD60-89,0,0,0
2024-03-07,104,DPD90+,0,0,0
2024-03-07,20,Current,3,3,0
2024-03-07,20,DPD15-29,214,214,0
2024-03-07,20,DPD3-14,406,406,0
2024-03-07,20,DPD30-59,63,63,0
2024-03-07,20,DPD60-89,32,32,0
2024-03-07,20,DPD90+,49,49,0
2024-03-07,22,Current,0,0,0
2024-03-07,22,DPD15-29,0,0,0
2024-03-07,22,DPD3-14,2,2,0
2024-03-07,22,DPD30-59,1,1,0
2024-03-07,22,DPD60-89,0,0,0
2024-03-07,22,DPD90+,0,0,0
2024-03-07,24,Current,46,46,0
2024-03-07,24,DPD15-29,132,132,0
2024-03-07,24,DPD3-14,226,226,0
2024-03-07,24,DPD30-59,45,45,0
2024-03-07,24,DPD60-89,0,0,0
2024-03-07,24,DPD90+,0,0,0
2024-03-07,26,Current,0,0,0
2024-03-07,26,DPD15-29,14,14,0
2024-03-07,26,DPD3-14,33,33,0
2024-03-07,26,DPD30-59,5,5,0
2024-03-07,26,DPD60-89,0,0,0
2024-03-07,26,DPD90+,0,0,0
2024-03-07,32,Current,0,0,0
2024-03-07,32,DPD15-29,106,106,0
2024-03-07,32,DPD3-14,173,173,0
2024-03-07,32,DPD30-59,36,36,0
2024-03-07,32,DPD60-89,0,0,0
2024-03-07,32,DPD90+,0,0,0
2024-03-07,34,Current,0,0,0
2024-03-07,34,DPD15-29,45,45,0
2024-03-07,34,DPD3-14,67,67,0
2024-03-07,34,DPD30-59,14,14,0
2024-03-07,34,DPD60-89,0,0,0
2024-03-07,34,DPD90+,0,0,0
2024-03-07,36,Current,0,0,0
2024-03-07,36,DPD15-29,32,32,0
2024-03-07,36,DPD3-14,61,61,0
2024-03-07,36,DPD30-59,12,12,0
2024-03-07,36,DPD60-89,0,0,0
2024-03-07,36,DPD90+,0,0,0
2024-03-07,38,Current,0,0,0
2024-03-07,38,DPD15-29,31,31,0
2024-03-07,38,DPD3-14,68,68,0
2024-03-07,38,DPD30-59,8,8,0
2024-03-07,38,DPD60-89,0,0,0
2024-03-07,38,DPD90+,0,0,0
2024-03-07,40,Current,3,3,0
2024-03-07,40,DPD15-29,13,13,0
2024-03-07,40,DPD3-14,29,29,0
2024-03-07,40,DPD30-59,5,5,0
2024-03-07,40,DPD60-89,0,0,0
2024-03-07,40,DPD90+,0,0,0
2024-03-07,42,Current,0,0,0
2024-03-07,42,DPD15-29,9,9,0
2024-03-07,42,DPD3-14,25,25,0
2024-03-07,42,DPD30-59,2,2,0
2024-03-07,42,DPD60-89,0,0,0
2024-03-07,42,DPD90+,0,0,0
2024-03-07,44,Current,0,0,0
2024-03-07,44,DPD15-29,32,32,0
2024-03-07,44,DPD3-14,43,43,0
2024-03-07,44,DPD30-59,9,9,0
2024-03-07,44,DPD60-89,0,0,0
2024-03-07,44,DPD90+,0,0,0
2024-03-07,46,Current,0,0,0
2024-03-07,46,DPD3-14,1,1,0
2024-03-07,46,DPD60-89,0,0,0
2024-03-07,48,Current,59,59,0
2024-03-07,48,DPD15-29,12,12,0
2024-03-07,48,DPD3-14,26,26,0
2024-03-07,48,DPD30-59,8,8,0
2024-03-07,48,DPD60-89,0,0,0
2024-03-07,48,DPD90+,0,0,0
2024-03-07,6,Current,0,0,0
2024-03-07,6,DPD3-14,1,1,0
2024-03-06,100,Current,0,0,0
2024-03-06,100,DPD3-14,0,0,0
2024-03-06,102,Current,0,0,0
2024-03-06,102,DPD30-59,0,0,0
2024-03-06,102,DPD60-89,0,0,0
2024-03-06,104,Current,0,0,0
2024-03-06,104,DPD15-29,1,1,0
2024-03-06,104,DPD60-89,0,0,0
2024-03-06,104,DPD90+,0,0,0
2024-03-06,20,Current,1,1,0
2024-03-06,20,DPD15-29,222,222,0
2024-03-06,20,DPD3-14,300,300,0
2024-03-06,20,DPD30-59,131,131,0
2024-03-06,20,DPD60-89,55,55,0
2024-03-06,20,DPD90+,69,69,0
2024-03-06,22,Current,0,0,0
2024-03-06,22,DPD15-29,0,0,0
2024-03-06,22,DPD3-14,1,1,0
2024-03-06,22,DPD30-59,1,1,0
2024-03-06,22,DPD60-89,0,0,0
2024-03-06,22,DPD90+,0,0,0
2024-03-06,24,Current,8,8,0
2024-03-06,24,DPD15-29,104,104,0
2024-03-06,24,DPD3-14,153,153,0
2024-03-06,24,DPD30-59,60,60,0
2024-03-06,24,DPD60-89,0,0,0
2024-03-06,24,DPD90+,0,0,0
2024-03-06,26,Current,0,0,0
2024-03-06,26,DPD15-29,19,19,0
2024-03-06,26,DPD3-14,22,22,0
2024-03-06,26,DPD30-59,7,7,0
2024-03-06,26,DPD60-89,0,0,0
2024-03-06,26,DPD90+,0,0,0
2024-03-06,32,Current,0,0,0
2024-03-06,32,DPD15-29,109,109,0
2024-03-06,32,DPD3-14,140,140,0
2024-03-06,32,DPD30-59,92,92,0
2024-03-06,32,DPD60-89,0,0,0
2024-03-06,32,DPD90+,0,0,0
2024-03-06,34,Current,0,0,0
2024-03-06,34,DPD15-29,43,43,0
2024-03-06,34,DPD3-14,61,61,0
2024-03-06,34,DPD30-59,41,41,0
2024-03-06,34,DPD60-89,0,0,0
2024-03-06,34,DPD90+,0,0,0
2024-03-06,36,Current,0,0,0
2024-03-06,36,DPD15-29,21,21,0
2024-03-06,36,DPD3-14,47,47,0
2024-03-06,36,DPD30-59,30,30,0
2024-03-06,36,DPD60-89,0,0,0
2024-03-06,36,DPD90+,0,0,0
2024-03-06,38,Current,0,0,0
2024-03-06,38,DPD15-29,33,33,0
2024-03-06,38,DPD3-14,43,43,0
2024-03-06,38,DPD30-59,16,16,0
2024-03-06,38,DPD60-89,0,0,0
2024-03-06,38,DPD90+,0,0,0
2024-03-06,40,Current,0,0,0
2024-03-06,40,DPD15-29,16,16,0
2024-03-06,40,DPD3-14,23,23,0
2024-03-06,40,DPD30-59,7,7,0
2024-03-06,40,DPD60-89,0,0,0
2024-03-06,40,DPD90+,0,0,0
2024-03-06,42,Current,0,0,0
2024-03-06,42,DPD15-29,9,9,0
2024-03-06,42,DPD3-14,16,16,0
2024-03-06,42,DPD30-59,6,6,0
2024-03-06,42,DPD60-89,0,0,0
2024-03-06,42,DPD90+,0,0,0
2024-03-06,44,Current,0,0,0
2024-03-06,44,DPD15-29,35,35,0
2024-03-06,44,DPD3-14,36,36,0
2024-03-06,44,DPD30-59,12,12,0
2024-03-06,44,DPD60-89,0,0,0
2024-03-06,44,DPD90+,0,0,0
2024-03-06,46,Current,0,0,0
2024-03-06,46,DPD3-14,0,0,0
2024-03-06,46,DPD60-89,0,0,0
2024-03-06,48,Current,8,8,0
2024-03-06,48,DPD15-29,14,14,0
2024-03-06,48,DPD3-14,18,18,0
2024-03-06,48,DPD30-59,7,7,0
2024-03-06,48,DPD60-89,0,0,0
2024-03-06,48,DPD90+,0,0,0
2024-03-06,6,Current,0,0,0
2024-03-06,6,DPD3-14,0,0,0
2024-03-05,100,Current,0,0,0
2024-03-05,102,Current,0,0,0
2024-03-05,102,DPD15-29,0,0,0
2024-03-05,102,DPD30-59,0,0,0
2024-03-05,102,DPD60-89,0,0,0
2024-03-05,104,Current,0,0,0
2024-03-05,104,DPD15-29,1,1,0
2024-03-05,104,DPD60-89,0,0,0
2024-03-05,104,DPD90+,0,0,0
2024-03-05,20,Current,0,0,0
2024-03-05,20,DPD15-29,191,191,0
2024-03-05,20,DPD3-14,525,525,0
2024-03-05,20,DPD30-59,15,15,0
2024-03-05,20,DPD60-89,37,37,0
2024-03-05,20,DPD90+,21,21,0
2024-03-05,22,Current,0,0,0
2024-03-05,22,DPD15-29,0,0,0
2024-03-05,22,DPD3-14,2,2,0
2024-03-05,22,DPD30-59,0,0,0
2024-03-05,22,DPD60-89,0,0,0
2024-03-05,22,DPD90+,0,0,0
2024-03-05,24,Current,33,33,0
2024-03-05,24,DPD15-29,113,113,0
2024-03-05,24,DPD3-14,294,294,0
2024-03-05,24,DPD30-59,8,8,0
2024-03-05,24,DPD60-89,0,0,0
2024-03-05,24,DPD90+,0,0,0
2024-03-05,26,Current,0,0,0
2024-03-05,26,DPD15-29,14,14,0
2024-03-05,26,DPD3-14,49,49,0
2024-03-05,26,DPD30-59,4,4,0
2024-03-05,26,DPD60-89,0,0,0
2024-03-05,26,DPD90+,0,0,0
2024-03-05,32,Current,0,0,0
2024-03-05,32,DPD15-29,87,87,0
2024-03-05,32,DPD3-14,232,232,0
2024-03-05,32,DPD30-59,5,5,0
2024-03-05,32,DPD60-89,0,0,0
2024-03-05,32,DPD90+,0,0,0
2024-03-05,34,Current,0,0,0
2024-03-05,34,DPD15-29,40,40,0
2024-03-05,34,DPD3-14,95,95,0
2024-03-05,34,DPD30-59,3,3,0
2024-03-05,34,DPD60-89,0,0,0
2024-03-05,34,DPD90+,0,0,0
2024-03-05,36,Current,0,0,0
2024-03-05,36,DPD15-29,25,25,0
2024-03-05,36,DPD3-14,82,82,0
2024-03-05,36,DPD30-59,1,1,0
2024-03-05,36,DPD60-89,0,0,0
2024-03-05,36,DPD90+,0,0,0
2024-03-05,38,Current,0,0,0
2024-03-05,38,DPD15-29,21,21,0
2024-03-05,38,DPD3-14,91,91,0
2024-03-05,38,DPD30-59,4,4,0
2024-03-05,38,DPD60-89,0,0,0
2024-03-05,38,DPD90+,0,0,0
2024-03-05,40,Current,0,0,0
2024-03-05,40,DPD15-29,10,10,0
2024-03-05,40,DPD3-14,46,46,0
2024-03-05,40,DPD30-59,0,0,0
2024-03-05,40,DPD60-89,0,0,0
2024-03-05,40,DPD90+,0,0,0
2024-03-05,42,Current,0,0,0
2024-03-05,42,DPD15-29,9,9,0
2024-03-05,42,DPD3-14,29,29,0
2024-03-05,42,DPD30-59,0,0,0
2024-03-05,42,DPD60-89,0,0,0
2024-03-05,42,DPD90+,0,0,0
2024-03-05,44,Current,0,0,0
2024-03-05,44,DPD15-29,32,32,0
2024-03-05,44,DPD3-14,65,65,0
2024-03-05,44,DPD30-59,3,3,0
2024-03-05,44,DPD60-89,0,0,0
2024-03-05,44,DPD90+,0,0,0
2024-03-05,46,Current,0,0,0
2024-03-05,46,DPD3-14,1,1,0
2024-03-05,46,DPD60-89,0,0,0
2024-03-05,48,Current,43,43,0
2024-03-05,48,DPD15-29,15,15,0
2024-03-05,48,DPD3-14,37,37,0
2024-03-05,48,DPD30-59,1,1,0
2024-03-05,48,DPD60-89,0,0,0
2024-03-05,48,DPD90+,0,0,0
2024-03-05,6,Current,0,0,0
2024-03-05,6,DPD3-14,1,1,0
2024-03-04,100,Current,0,0,0
2024-03-04,102,Current,0,0,0
2024-03-04,102,DPD15-29,0,0,0
2024-03-04,102,DPD30-59,0,0,0
2024-03-04,102,DPD60-89,0,0,0
2024-03-04,104,Current,0,0,0
2024-03-04,104,DPD15-29,0,0,0
2024-03-04,104,DPD60-89,0,0,0
2024-03-04,104,DPD90+,0,0,0
2024-03-04,20,Current,1,1,0
2024-03-04,20,DPD15-29,232,232,0
2024-03-04,20,DPD3-14,375,375,0
2024-03-04,20,DPD30-59,163,163,0
2024-03-04,20,DPD60-89,46,46,0
2024-03-04,20,DPD90+,19,19,0
2024-03-04,22,Current,0,0,0
2024-03-04,22,DPD15-29,0,0,0
2024-03-04,22,DPD3-14,0,0,0
2024-03-04,22,DPD30-59,0,0,0
2024-03-04,22,DPD60-89,0,0,0
2024-03-04,22,DPD90+,0,0,0
2024-03-04,24,Current,31,31,0
2024-03-04,24,DPD15-29,103,103,0
2024-03-04,24,DPD3-14,188,188,0
2024-03-04,24,DPD30-59,81,81,0
2024-03-04,24,DPD60-89,0,0,0
2024-03-04,24,DPD90+,0,0,0
2024-03-04,26,Current,0,0,0
2024-03-04,26,DPD15-29,16,16,0
2024-03-04,26,DPD3-14,23,23,0
2024-03-04,26,DPD30-59,11,11,0
2024-03-04,26,DPD60-89,0,0,0
2024-03-04,26,DPD90+,0,0,0
2024-03-04,32,Current,0,0,0
2024-03-04,32,DPD15-29,109,109,0
2024-03-04,32,DPD3-14,159,159,0
2024-03-04,32,DPD30-59,74,74,0
2024-03-04,32,DPD60-89,0,0,0
2024-03-04,32,DPD90+,0,0,0
2024-03-04,34,Current,0,0,0
2024-03-04,34,DPD15-29,44,44,0
2024-03-04,34,DPD3-14,73,73,0
2024-03-04,34,DPD30-59,33,33,0
2024-03-04,34,DPD60-89,0,0,0
2024-03-04,34,DPD90+,0,0,0
2024-03-04,36,Current,0,0,0
2024-03-04,36,DPD15-29,24,24,0
2024-03-04,36,DPD3-14,52,52,0
2024-03-04,36,DPD30-59,30,30,0
2024-03-04,36,DPD60-89,0,0,0
2024-03-04,36,DPD90+,0,0,0
2024-03-04,38,Current,0,0,0
2024-03-04,38,DPD15-29,27,27,0
2024-03-04,38,DPD3-14,62,62,0
2024-03-04,38,DPD30-59,17,17,0
2024-03-04,38,DPD60-89,0,0,0
2024-03-04,38,DPD90+,0,0,0
2024-03-04,40,Current,0,0,0
2024-03-04,40,DPD15-29,18,18,0
2024-03-04,40,DPD3-14,28,28,0
2024-03-04,40,DPD30-59,15,15,0
2024-03-04,40,DPD60-89,0,0,0
2024-03-04,40,DPD90+,0,0,0
2024-03-04,42,Current,0,0,0
2024-03-04,42,DPD15-29,8,8,0
2024-03-04,42,DPD3-14,20,20,0
2024-03-04,42,DPD30-59,11,11,0
2024-03-04,42,DPD60-89,0,0,0
2024-03-04,42,DPD90+,0,0,0
2024-03-04,44,Current,0,0,0
2024-03-04,44,DPD15-29,28,28,0
2024-03-04,44,DPD3-14,48,48,0
2024-03-04,44,DPD30-59,19,19,0
2024-03-04,44,DPD60-89,0,0,0
2024-03-04,44,DPD90+,0,0,0
2024-03-04,46,Current,0,0,0
2024-03-04,46,DPD15-29,0,0,0
2024-03-04,46,DPD3-14,0,0,0
2024-03-04,46,DPD60-89,0,0,0
2024-03-04,48,Current,45,45,0
2024-03-04,48,DPD15-29,11,11,0
2024-03-04,48,DPD3-14,17,17,0
2024-03-04,48,DPD30-59,11,11,0
2024-03-04,48,DPD60-89,0,0,0
2024-03-04,48,DPD90+,0,0,0
2024-03-04,6,Current,1,1,0
2024-03-04,6,DPD3-14,0,0,0
2024-03-03,100,Current,0,0,0
2024-03-03,102,Current,0,0,0
2024-03-03,102,DPD15-29,0,0,0
2024-03-03,102,DPD30-59,0,0,0
2024-03-03,102,DPD60-89,0,0,0
2024-03-03,104,Current,0,0,0
2024-03-03,104,DPD3-14,1,1,0
2024-03-03,104,DPD60-89,0,0,0
2024-03-03,104,DPD90+,0,0,0
2024-03-03,20,Current,4,4,0
2024-03-03,20,DPD15-29,199,199,0
2024-03-03,20,DPD3-14,448,448,0
2024-03-03,20,DPD30-59,47,47,0
2024-03-03,20,DPD60-89,9,9,0
2024-03-03,20,DPD90+,3,3,0
2024-03-03,22,Current,0,0,0
2024-03-03,22,DPD15-29,0,0,0
2024-03-03,22,DPD3-14,2,2,0
2024-03-03,22,DPD30-59,1,1,0
2024-03-03,22,DPD60-89,0,0,0
2024-03-03,22,DPD90+,0,0,0
2024-03-03,24,Current,77,77,0
2024-03-03,24,DPD15-29,113,113,0
2024-03-03,24,DPD3-14,259,259,0
2024-03-03,24,DPD30-59,39,39,0
2024-03-03,24,DPD60-89,0,0,0
2024-03-03,24,DPD90+,0,0,0
2024-03-03,26,Current,0,0,0
2024-03-03,26,DPD15-29,15,15,0
2024-03-03,26,DPD3-14,42,42,0
2024-03-03,26,DPD30-59,5,5,0
2024-03-03,26,DPD60-89,0,0,0
2024-03-03,26,DPD90+,0,0,0
2024-03-03,32,Current,0,0,0
2024-03-03,32,DPD15-29,84,84,0
2024-03-03,32,DPD3-14,209,209,0
2024-03-03,32,DPD30-59,23,23,0
2024-03-03,32,DPD60-89,0,0,0
2024-03-03,32,DPD90+,0,0,0
2024-03-03,34,Current,0,0,0
2024-03-03,34,DPD15-29,34,34,0
2024-03-03,34,DPD3-14,90,90,0
2024-03-03,34,DPD30-59,13,13,0
2024-03-03,34,DPD60-89,0,0,0
2024-03-03,34,DPD90+,0,0,0
2024-03-03,36,Current,0,0,0
2024-03-03,36,DPD15-29,23,23,0
2024-03-03,36,DPD3-14,72,72,0
2024-03-03,36,DPD30-59,13,13,0
2024-03-03,36,DPD60-89,0,0,0
2024-03-03,36,DPD90+,0,0,0
2024-03-03,38,Current,0,0,0
2024-03-03,38,DPD15-29,25,25,0
2024-03-03,38,DPD3-14,76,76,0
2024-03-03,38,DPD30-59,10,10,0
2024-03-03,38,DPD60-89,0,0,0
2024-03-03,38,DPD90+,0,0,0
2024-03-03,40,Current,0,0,0
2024-03-03,40,DPD15-29,15,15,0
2024-03-03,40,DPD3-14,33,33,0
2024-03-03,40,DPD30-59,4,4,0
2024-03-03,40,DPD60-89,0,0,0
2024-03-03,40,DPD90+,0,0,0
2024-03-03,42,Current,0,0,0
2024-03-03,42,DPD15-29,7,7,0
2024-03-03,42,DPD3-14,25,25,0
2024-03-03,42,DPD30-59,1,1,0
2024-03-03,42,DPD60-89,0,0,0
2024-03-03,42,DPD90+,0,0,0
2024-03-03,44,Current,0,0,0
2024-03-03,44,DPD15-29,33,33,0
2024-03-03,44,DPD3-14,44,44,0
2024-03-03,44,DPD30-59,8,8,0
2024-03-03,44,DPD60-89,0,0,0
2024-03-03,44,DPD90+,0,0,0
2024-03-03,46,Current,0,0,0
2024-03-03,46,DPD15-29,1,1,0
2024-03-03,46,DPD60-89,0,0,0
2024-03-03,48,Current,68,68,0
2024-03-03,48,DPD15-29,15,15,0
2024-03-03,48,DPD3-14,27,27,0
2024-03-03,48,DPD30-59,3,3,0
2024-03-03,48,DPD60-89,0,0,0
2024-03-03,48,DPD90+,0,0,0
2024-03-03,6,Current,0,0,0
2024-03-02,100,Current,0,0,0
2024-03-02,102,Current,0,0,0
2024-03-02,102,DPD15-29,0,0,0
2024-03-02,102,DPD30-59,0,0,0
2024-03-02,102,DPD60-89,0,0,0
2024-03-02,104,Current,0,0,0
2024-03-02,104,DPD3-14,1,1,0
2024-03-02,104,DPD60-89,0,0,0
2024-03-02,104,DPD90+,0,0,0
2024-03-02,20,Current,3,3,0
2024-03-02,20,DPD15-29,203,203,0
2024-03-02,20,DPD3-14,397,397,0
2024-03-02,20,DPD30-59,131,131,0
2024-03-02,20,DPD60-89,84,84,0
2024-03-02,20,DPD90+,101,101,0
2024-03-02,22,Current,0,0,0
2024-03-02,22,DPD15-29,0,0,0
2024-03-02,22,DPD3-14,0,0,0
2024-03-02,22,DPD30-59,1,1,0
2024-03-02,22,DPD60-89,0,0,0
2024-03-02,22,DPD90+,0,0,0
2024-03-02,24,Current,39,39,0
2024-03-02,24,DPD15-29,92,92,0
2024-03-02,24,DPD3-14,208,208,0
2024-03-02,24,DPD30-59,59,59,0
2024-03-02,24,DPD60-89,0,0,0
2024-03-02,24,DPD90+,0,0,0
2024-03-02,26,Current,0,0,0
2024-03-02,26,DPD15-29,15,15,0
2024-03-02,26,DPD3-14,25,25,0
2024-03-02,26,DPD30-59,6,6,0
2024-03-02,26,DPD60-89,0,0,0
2024-03-02,26,DPD90+,0,0,0
2024-03-02,32,Current,0,0,0
2024-03-02,32,DPD15-29,103,103,0
2024-03-02,32,DPD3-14,174,174,0
2024-03-02,32,DPD30-59,93,93,0
2024-03-02,32,DPD60-89,0,0,0
2024-03-02,32,DPD90+,0,0,0
2024-03-02,34,Current,0,0,0
2024-03-02,34,DPD15-29,35,35,0
2024-03-02,34,DPD3-14,82,82,0
2024-03-02,34,DPD30-59,42,42,0
2024-03-02,34,DPD60-89,0,0,0
2024-03-02,34,DPD90+,0,0,0
2024-03-02,36,Current,0,0,0
2024-03-02,36,DPD15-29,23,23,0
2024-03-02,36,DPD3-14,55,55,0
2024-03-02,36,DPD30-59,33,33,0
2024-03-02,36,DPD60-89,0,0,0
2024-03-02,36,DPD90+,0,0,0
2024-03-02,38,Current,0,0,0
2024-03-02,38,DPD15-29,25,25,0
2024-03-02,38,DPD3-14,64,64,0
2024-03-02,38,DPD30-59,16,16,0
2024-03-02,38,DPD60-89,0,0,0
2024-03-02,38,DPD90+,0,0,0
2024-03-02,40,Current,0,0,0
2024-03-02,40,DPD15-29,16,16,0
2024-03-02,40,DPD3-14,33,33,0
2024-03-02,40,DPD30-59,6,6,0
2024-03-02,40,DPD60-89,0,0,0
2024-03-02,40,DPD90+,0,0,0
2024-03-02,42,Current,0,0,0
2024-03-02,42,DPD15-29,11,11,0
2024-03-02,42,DPD3-14,22,22,0
2024-03-02,42,DPD30-59,7,7,0
2024-03-02,42,DPD60-89,0,0,0
2024-03-02,42,DPD90+,0,0,0
2024-03-02,44,Current,0,0,0
2024-03-02,44,DPD15-29,26,26,0
2024-03-02,44,DPD3-14,48,48,0
2024-03-02,44,DPD30-59,12,12,0
2024-03-02,44,DPD60-89,0,0,0
2024-03-02,44,DPD90+,0,0,0
2024-03-02,46,Current,0,0,0
2024-03-02,46,DPD15-29,0,0,0
2024-03-02,46,DPD60-89,0,0,0
2024-03-02,48,Current,38,38,0
2024-03-02,48,DPD15-29,11,11,0
2024-03-02,48,DPD3-14,17,17,0
2024-03-02,48,DPD30-59,8,8,0
2024-03-02,48,DPD60-89,0,0,0
2024-03-02,48,DPD90+,0,0,0
2024-03-02,6,Current,0,0,0
2024-03-01,100,Current,0,0,0
2024-03-01,102,Current,0,0,0
2024-03-01,102,DPD15-29,0,0,0
2024-03-01,102,DPD30-59,0,0,0
2024-03-01,102,DPD60-89,0,0,0
2024-03-01,104,Current,0,0,0
2024-03-01,104,DPD3-14,1,1,0
2024-03-01,104,DPD60-89,0,0,0
2024-03-01,104,DPD90+,0,0,0
2024-03-01,20,Current,5473,5473,0
2024-03-01,20,DPD15-29,244,244,0
2024-03-01,20,DPD3-14,396,396,0
2024-03-01,20,DPD30-59,55,55,0
2024-03-01,20,DPD60-89,41,41,0
2024-03-01,20,DPD90+,30,30,0
2024-03-01,22,Current,0,0,0
2024-03-01,22,DPD15-29,0,0,0
2024-03-01,22,DPD3-14,1,1,0
2024-03-01,22,DPD30-59,0,0,0
2024-03-01,22,DPD60-89,0,0,0
2024-03-01,22,DPD90+,0,0,0
2024-03-01,24,Current,3682,3682,0
2024-03-01,24,DPD15-29,110,110,0
2024-03-01,24,DPD3-14,245,245,0
2024-03-01,24,DPD30-59,19,19,0
2024-03-01,24,DPD60-89,9,9,0
2024-03-01,24,DPD90+,10,10,0
2024-03-01,26,Current,31,31,0
2024-03-01,26,DPD15-29,12,12,0
2024-03-01,26,DPD3-14,28,28,0
2024-03-01,26,DPD30-59,1,1,0
2024-03-01,26,DPD60-89,0,0,0
2024-03-01,26,DPD90+,0,0,0
2024-03-01,32,Current,366,366,0
2024-03-01,32,DPD15-29,67,67,0
2024-03-01,32,DPD3-14,168,168,0
2024-03-01,32,DPD30-59,12,12,0
2024-03-01,32,DPD60-89,5,5,0
2024-03-01,32,DPD90+,5,5,0
2024-03-01,34,Current,35,35,0
2024-03-01,34,DPD15-29,33,33,0
2024-03-01,34,DPD3-14,54,54,0
2024-03-01,34,DPD30-59,2,2,0
2024-03-01,34,DPD60-89,0,0,0
2024-03-01,34,DPD90+,0,0,0
2024-03-01,36,Current,339,339,0
2024-03-01,36,DPD15-29,21,21,0
2024-03-01,36,DPD3-14,54,54,0
2024-03-01,36,DPD30-59,4,4,0
2024-03-01,36,DPD60-89,5,5,0
2024-03-01,36,DPD90+,1,1,0
2024-03-01,38,Current,38,38,0
2024-03-01,38,DPD15-29,21,21,0
2024-03-01,38,DPD3-14,59,59,0
2024-03-01,38,DPD30-59,0,0,0
2024-03-01,38,DPD60-89,0,0,0
2024-03-01,38,DPD90+,0,0,0
2024-03-01,40,Current,354,354,0
2024-03-01,40,DPD15-29,12,12,0
2024-03-01,40,DPD3-14,24,24,0
2024-03-01,40,DPD30-59,0,0,0
2024-03-01,40,DPD60-89,2,2,0
2024-03-01,40,DPD90+,0,0,0
2024-03-01,42,Current,11,11,0
2024-03-01,42,DPD15-29,9,9,0
2024-03-01,42,DPD3-14,17,17,0
2024-03-01,42,DPD30-59,0,0,0
2024-03-01,42,DPD60-89,0,0,0
2024-03-01,42,DPD90+,0,0,0
2024-03-01,44,Current,225,225,0
2024-03-01,44,DPD15-29,33,33,0
2024-03-01,44,DPD3-14,41,41,0
2024-03-01,44,DPD30-59,2,2,0
2024-03-01,44,DPD60-89,0,0,0
2024-03-01,44,DPD90+,0,0,0
2024-03-01,46,Current,5,5,0
2024-03-01,46,DPD15-29,1,1,0
2024-03-01,46,DPD60-89,0,0,0
2024-03-01,48,Current,3953,3953,0
2024-03-01,48,DPD15-29,39,39,0
2024-03-01,48,DPD3-14,56,56,0
2024-03-01,48,DPD30-59,18,18,0
2024-03-01,48,DPD60-89,10,10,0
2024-03-01,48,DPD90+,8,8,0
2024-03-01,6,Current,2,2,0
2024-02-29,100,Current,0,0,0
2024-02-29,102,Current,0,0,0
2024-02-29,102,DPD15-29,0,0,0
2024-02-29,102,DPD3-14,2,2,0
2024-02-29,102,DPD30-59,0,0,0
2024-02-29,102,DPD60-89,0,0,0
2024-02-29,104,Current,0,0,0
2024-02-29,104,DPD3-14,1,1,0
2024-02-29,104,DPD60-89,0,0,0
2024-02-29,104,DPD90+,0,0,0
2024-02-29,20,Current,0,0,0
2024-02-29,20,DPD15-29,158,158,0
2024-02-29,20,DPD3-14,459,459,0
2024-02-29,20,DPD30-59,155,155,0
2024-02-29,20,DPD60-89,86,86,0
2024-02-29,20,DPD90+,18,18,0
2024-02-29,22,Current,0,0,0
2024-02-29,22,DPD15-29,0,0,0
2024-02-29,22,DPD3-14,0,0,0
2024-02-29,22,DPD30-59,0,0,0
2024-02-29,22,DPD90+,0,0,0
2024-02-29,24,Current,2,2,0
2024-02-29,24,DPD15-29,76,76,0
2024-02-29,24,DPD3-14,243,243,0
2024-02-29,24,DPD30-59,90,90,0
2024-02-29,24,DPD60-89,0,0,0
2024-02-29,24,DPD90+,0,0,0
2024-02-29,26,Current,0,0,0
2024-02-29,26,DPD15-29,5,5,0
2024-02-29,26,DPD3-14,40,40,0
2024-02-29,26,DPD30-59,9,9,0
2024-02-29,26,DPD60-89,0,0,0
2024-02-29,26,DPD90+,0,0,0
2024-02-29,32,Current,0,0,0
2024-02-29,32,DPD15-29,86,86,0
2024-02-29,32,DPD3-14,199,199,0
2024-02-29,32,DPD30-59,68,68,0
2024-02-29,32,DPD60-89,0,0,0
2024-02-29,32,DPD90+,0,0,0
2024-02-29,34,Current,0,0,0
2024-02-29,34,DPD15-29,23,23,0
2024-02-29,34,DPD3-14,96,96,0
2024-02-29,34,DPD30-59,32,32,0
2024-02-29,34,DPD60-89,0,0,0
2024-02-29,34,DPD90+,0,0,0
2024-02-29,36,Current,0,0,0
2024-02-29,36,DPD15-29,16,16,0
2024-02-29,36,DPD3-14,63,63,0
2024-02-29,36,DPD30-59,30,30,0
2024-02-29,36,DPD60-89,0,0,0
2024-02-29,36,DPD90+,0,0,0
2024-02-29,38,Current,0,0,0
2024-02-29,38,DPD15-29,12,12,0
2024-02-29,38,DPD3-14,85,85,0
2024-02-29,38,DPD30-59,20,20,0
2024-02-29,38,DPD60-89,0,0,0
2024-02-29,38,DPD90+,0,0,0
2024-02-29,40,Current,0,0,0
2024-02-29,40,DPD15-29,7,7,0
2024-02-29,40,DPD3-14,33,33,0
2024-02-29,40,DPD30-59,13,13,0
2024-02-29,40,DPD60-89,0,0,0
2024-02-29,40,DPD90+,0,0,0
2024-02-29,42,Current,0,0,0
2024-02-29,42,DPD15-29,7,7,0
2024-02-29,42,DPD3-14,24,24,0
2024-02-29,42,DPD30-59,8,8,0
2024-02-29,42,DPD60-89,0,0,0
2024-02-29,42,DPD90+,0,0,0
2024-02-29,44,Current,0,0,0
2024-02-29,44,DPD15-29,12,12,0
2024-02-29,44,DPD3-14,71,71,0
2024-02-29,44,DPD30-59,22,22,0
2024-02-29,44,DPD60-89,0,0,0
2024-02-29,44,DPD90+,0,0,0
2024-02-29,46,Current,0,0,0
2024-02-29,46,DPD15-29,0,0,0
2024-02-29,46,DPD90+,0,0,0
2024-02-29,48,Current,7,7,0
2024-02-29,48,DPD15-29,10,10,0
2024-02-29,48,DPD3-14,29,29,0
2024-02-29,48,DPD30-59,11,11,0
2024-02-29,48,DPD60-89,0,0,0
2024-02-29,48,DPD90+,0,0,0
2024-02-29,6,Current,0,0,0
2024-02-28,100,Current,0,0,0
2024-02-28,102,Current,0,0,0
2024-02-28,102,DPD15-29,0,0,0
2024-02-28,102,DPD3-14,0,0,0
2024-02-28,102,DPD30-59,0,0,0
2024-02-28,102,DPD60-89,0,0,0
2024-02-28,104,Current,0,0,0
2024-02-28,104,DPD3-14,1,1,0
2024-02-28,104,DPD60-89,0,0,0
2024-02-28,104,DPD90+,0,0,0
2024-02-28,20,Current,0,0,0
2024-02-28,20,DPD15-29,186,186,0
2024-02-28,20,DPD3-14,344,344,0
2024-02-28,20,DPD30-59,95,95,0
2024-02-28,20,DPD60-89,33,33,0
2024-02-28,20,DPD90+,56,56,0
2024-02-28,22,Current,0,0,0
2024-02-28,22,DPD15-29,0,0,0
2024-02-28,22,DPD3-14,1,1,0
2024-02-28,22,DPD30-59,1,1,0
2024-02-28,22,DPD60-89,0,0,0
2024-02-28,22,DPD90+,0,0,0
2024-02-28,24,Current,23,23,0
2024-02-28,24,DPD15-29,87,87,0
2024-02-28,24,DPD3-14,209,209,0
2024-02-28,24,DPD30-59,56,56,0
2024-02-28,24,DPD60-89,0,0,0
2024-02-28,24,DPD90+,0,0,0
2024-02-28,26,Current,0,0,0
2024-02-28,26,DPD15-29,16,16,0
2024-02-28,26,DPD3-14,23,23,0
2024-02-28,26,DPD30-59,9,9,0
2024-02-28,26,DPD60-89,0,0,0
2024-02-28,26,DPD90+,0,0,0
2024-02-28,32,Current,0,0,0
2024-02-28,32,DPD15-29,58,58,0
2024-02-28,32,DPD3-14,167,167,0
2024-02-28,32,DPD30-59,59,59,0
2024-02-28,32,DPD60-89,0,0,0
2024-02-28,32,DPD90+,0,0,0
2024-02-28,34,Current,0,0,0
2024-02-28,34,DPD15-29,32,32,0
2024-02-28,34,DPD3-14,63,63,0
2024-02-28,34,DPD30-59,38,38,0
2024-02-28,34,DPD60-89,0,0,0
2024-02-28,34,DPD90+,0,0,0
2024-02-28,36,Current,0,0,0
2024-02-28,36,DPD15-29,19,19,0
2024-02-28,36,DPD3-14,60,60,0
2024-02-28,36,DPD30-59,28,28,0
2024-02-28,36,DPD60-89,0,0,0
2024-02-28,36,DPD90+,0,0,0
2024-02-28,38,Current,0,0,0
2024-02-28,38,DPD15-29,19,19,0
2024-02-28,38,DPD3-14,61,61,0
2024-02-28,38,DPD30-59,15,15,0
2024-02-28,38,DPD60-89,0,0,0
2024-02-28,38,DPD90+,0,0,0
2024-02-28,40,Current,0,0,0
2024-02-28,40,DPD15-29,11,11,0
2024-02-28,40,DPD3-14,25,25,0
2024-02-28,40,DPD30-59,7,7,0
2024-02-28,40,DPD60-89,0,0,0
2024-02-28,40,DPD90+,0,0,0
2024-02-28,42,Current,0,0,0
2024-02-28,42,DPD15-29,9,9,0
2024-02-28,42,DPD3-14,9,9,0
2024-02-28,42,DPD30-59,2,2,0
2024-02-28,42,DPD60-89,0,0,0
2024-02-28,42,DPD90+,0,0,0
2024-02-28,44,Current,0,0,0
2024-02-28,44,DPD15-29,27,27,0
2024-02-28,44,DPD3-14,49,49,0
2024-02-28,44,DPD30-59,15,15,0
2024-02-28,44,DPD60-89,0,0,0
2024-02-28,44,DPD90+,0,0,0
2024-02-28,46,Current,0,0,0
2024-02-28,46,DPD15-29,1,1,0
2024-02-28,46,DPD60-89,0,0,0
2024-02-28,48,Current,20,20,0
2024-02-28,48,DPD15-29,14,14,0
2024-02-28,48,DPD3-14,22,22,0
2024-02-28,48,DPD30-59,5,5,0
2024-02-28,48,DPD60-89,0,0,0
2024-02-28,48,DPD90+,0,0,0
2024-02-28,6,Current,0,0,0
2024-02-27,100,Current,0,0,0
2024-02-27,102,Current,0,0,0
2024-02-27,102,DPD15-29,0,0,0
2024-02-27,102,DPD3-14,1,1,0
2024-02-27,102,DPD30-59,0,0,0
2024-02-27,102,DPD60-89,0,0,0
2024-02-27,104,Current,0,0,0
2024-02-27,104,DPD3-14,1,1,0
2024-02-27,104,DPD60-89,0,0,0
2024-02-27,104,DPD90+,0,0,0
2024-02-27,20,Current,3,3,0
2024-02-27,20,DPD15-29,190,190,0
2024-02-27,20,DPD3-14,459,459,0
2024-02-27,20,DPD30-59,129,129,0
2024-02-27,20,DPD60-89,80,80,0
2024-02-27,20,DPD90+,87,87,0
2024-02-27,22,Current,0,0,0
2024-02-27,22,DPD3-14,1,1,0
2024-02-27,22,DPD30-59,1,1,0
2024-02-27,22,DPD60-89,0,0,0
2024-02-27,22,DPD90+,0,0,0
2024-02-27,24,Current,47,47,0
2024-02-27,24,DPD15-29,87,87,0
2024-02-27,24,DPD3-14,230,230,0
2024-02-27,24,DPD30-59,60,60,0
2024-02-27,24,DPD60-89,0,0,0
2024-02-27,24,DPD90+,0,0,0
2024-02-27,26,Current,0,0,0
2024-02-27,26,DPD15-29,8,8,0
2024-02-27,26,DPD3-14,46,46,0
2024-02-27,26,DPD30-59,6,6,0
2024-02-27,26,DPD60-89,0,0,0
2024-02-27,26,DPD90+,0,0,0
2024-02-27,32,Current,0,0,0
2024-02-27,32,DPD15-29,104,104,0
2024-02-27,32,DPD3-14,206,206,0
2024-02-27,32,DPD30-59,70,70,0
2024-02-27,32,DPD60-89,0,0,0
2024-02-27,32,DPD90+,0,0,0
2024-02-27,34,Current,0,0,0
2024-02-27,34,DPD15-29,27,27,0
2024-02-27,34,DPD3-14,108,108,0
2024-02-27,34,DPD30-59,31,31,0
2024-02-27,34,DPD60-89,0,0,0
2024-02-27,34,DPD90+,0,0,0
2024-02-27,36,Current,0,0,0
2024-02-27,36,DPD15-29,17,17,0
2024-02-27,36,DPD3-14,56,56,0
2024-02-27,36,DPD30-59,27,27,0
2024-02-27,36,DPD60-89,0,0,0
2024-02-27,36,DPD90+,0,0,0
2024-02-27,38,Current,0,0,0
2024-02-27,38,DPD15-29,13,13,0
2024-02-27,38,DPD3-14,93,93,0
2024-02-27,38,DPD30-59,11,11,0
2024-02-27,38,DPD60-89,0,0,0
2024-02-27,38,DPD90+,0,0,0
2024-02-27,40,Current,0,0,0
2024-02-27,40,DPD15-29,11,11,0
2024-02-27,40,DPD3-14,33,33,0
2024-02-27,40,DPD30-59,7,7,0
2024-02-27,40,DPD60-89,0,0,0
2024-02-27,40,DPD90+,0,0,0
2024-02-27,42,Current,0,0,0
2024-02-27,42,DPD15-29,10,10,0
2024-02-27,42,DPD3-14,23,23,0
2024-02-27,42,DPD30-59,8,8,0
2024-02-27,42,DPD60-89,0,0,0
2024-02-27,42,DPD90+,0,0,0
2024-02-27,44,Current,0,0,0
2024-02-27,44,DPD15-29,18,18,0
2024-02-27,44,DPD3-14,71,71,0
2024-02-27,44,DPD30-59,13,13,0
2024-02-27,44,DPD60-89,0,0,0
2024-02-27,44,DPD90+,0,0,0
2024-02-27,46,Current,0,0,0
2024-02-27,46,DPD15-29,0,0,0
2024-02-27,46,DPD60-89,0,0,0
2024-02-27,48,Current,55,55,0
2024-02-27,48,DPD15-29,11,11,0
2024-02-27,48,DPD3-14,28,28,0
2024-02-27,48,DPD30-59,6,6,0
2024-02-27,48,DPD60-89,0,0,0
2024-02-27,48,DPD90+,0,0,0
2024-02-27,6,Current,0,0,0
2024-02-26,100,Current,0,0,0
2024-02-26,102,Current,0,0,0
2024-02-26,102,DPD15-29,0,0,0
2024-02-26,102,DPD3-14,0,0,0
2024-02-26,102,DPD30-59,1,1,0
2024-02-26,102,DPD60-89,0,0,0
2024-02-26,104,Current,0,0,0
2024-02-26,104,DPD3-14,1,1,0
2024-02-26,104,DPD60-89,0,0,0
2024-02-26,104,DPD90+,0,0,0
2024-02-26,20,Current,1,1,0
2024-02-26,20,DPD15-29,212,212,0
2024-02-26,20,DPD3-14,412,412,0
2024-02-26,20,DPD30-59,139,139,0
2024-02-26,20,DPD60-89,93,93,0
2024-02-26,20,DPD90+,20,20,0
2024-02-26,22,Current,0,0,0
2024-02-26,22,DPD3-14,1,1,0
2024-02-26,22,DPD30-59,0,0,0
2024-02-26,22,DPD60-89,0,0,0
2024-02-26,22,DPD90+,0,0,0
2024-02-26,24,Current,72,72,0
2024-02-26,24,DPD15-29,104,104,0
2024-02-26,24,DPD3-14,264,264,0
2024-02-26,24,DPD30-59,65,65,0
2024-02-26,24,DPD60-89,0,0,0
2024-02-26,24,DPD90+,0,0,0
2024-02-26,26,Current,0,0,0
2024-02-26,26,DPD15-29,18,18,0
2024-02-26,26,DPD3-14,31,31,0
2024-02-26,26,DPD30-59,10,10,0
2024-02-26,26,DPD60-89,0,0,0
2024-02-26,26,DPD90+,0,0,0
2024-02-26,32,Current,0,0,0
2024-02-26,32,DPD15-29,72,72,0
2024-02-26,32,DPD3-14,190,190,0
2024-02-26,32,DPD30-59,53,53,0
2024-02-26,32,DPD60-89,0,0,0
2024-02-26,32,DPD90+,0,0,0
2024-02-26,34,Current,0,0,0
2024-02-26,34,DPD15-29,49,49,0
2024-02-26,34,DPD3-14,80,80,0
2024-02-26,34,DPD30-59,29,29,0
2024-02-26,34,DPD60-89,0,0,0
2024-02-26,34,DPD90+,0,0,0
2024-02-26,36,Current,0,0,0
2024-02-26,36,DPD15-29,26,26,0
2024-02-26,36,DPD3-14,70,70,0
2024-02-26,36,DPD30-59,22,22,0
2024-02-26,36,DPD60-89,0,0,0
2024-02-26,36,DPD90+,0,0,0
2024-02-26,38,Current,0,0,0
2024-02-26,38,DPD15-29,23,23,0
2024-02-26,38,DPD3-14,65,65,0
2024-02-26,38,DPD30-59,12,12,0
2024-02-26,38,DPD60-89,0,0,0
2024-02-26,38,DPD90+,0,0,0
2024-02-26,40,Current,0,0,0
2024-02-26,40,DPD15-29,14,14,0
2024-02-26,40,DPD3-14,30,30,0
2024-02-26,40,DPD30-59,12,12,0
2024-02-26,40,DPD60-89,0,0,0
2024-02-26,40,DPD90+,0,0,0
2024-02-26,42,Current,0,0,0
2024-02-26,42,DPD15-29,8,8,0
2024-02-26,42,DPD3-14,14,14,0
2024-02-26,42,DPD30-59,8,8,0
2024-02-26,42,DPD60-89,0,0,0
2024-02-26,42,DPD90+,0,0,0
2024-02-26,44,Current,0,0,0
2024-02-26,44,DPD15-29,36,36,0
2024-02-26,44,DPD3-14,51,51,0
2024-02-26,44,DPD30-59,19,19,0
2024-02-26,44,DPD60-89,0,0,0
2024-02-26,44,DPD90+,0,0,0
2024-02-26,46,Current,0,0,0
2024-02-26,46,DPD15-29,1,1,0
2024-02-26,46,DPD60-89,0,0,0
2024-02-26,48,Current,78,78,0
2024-02-26,48,DPD15-29,14,14,0
2024-02-26,48,DPD3-14,34,34,0
2024-02-26,48,DPD30-59,10,10,0
2024-02-26,48,DPD60-89,0,0,0
2024-02-26,48,DPD90+,0,0,0
2024-02-26,6,Current,0,0,0
2024-02-25,100,Current,0,0,0
2024-02-25,102,Current,0,0,0
2024-02-25,102,DPD15-29,0,0,0
2024-02-25,102,DPD3-14,1,1,0
2024-02-25,102,DPD30-59,0,0,0
2024-02-25,102,DPD60-89,0,0,0
2024-02-25,104,Current,0,0,0
2024-02-25,104,DPD3-14,1,1,0
2024-02-25,104,DPD60-89,0,0,0
2024-02-25,104,DPD90+,0,0,0
2024-02-25,20,Current,1,1,0
2024-02-25,20,DPD15-29,179,179,0
2024-02-25,20,DPD3-14,472,472,0
2024-02-25,20,DPD30-59,24,24,0
2024-02-25,20,DPD60-89,0,0,0
2024-02-25,20,DPD90+,0,0,0
2024-02-25,22,Current,0,0,0
2024-02-25,22,DPD3-14,1,1,0
2024-02-25,22,DPD30-59,0,0,0
2024-02-25,22,DPD60-89,0,0,0
2024-02-25,22,DPD90+,0,0,0
2024-02-25,24,Current,15,15,0
2024-02-25,24,DPD15-29,87,87,0
2024-02-25,24,DPD3-14,221,221,0
2024-02-25,24,DPD30-59,12,12,0
2024-02-25,24,DPD60-89,0,0,0
2024-02-25,24,DPD90+,0,0,0
2024-02-25,26,Current,0,0,0
2024-02-25,26,DPD15-29,7,7,0
2024-02-25,26,DPD3-14,51,51,0
2024-02-25,26,DPD30-59,2,2,0
2024-02-25,26,DPD60-89,0,0,0
2024-02-25,26,DPD90+,0,0,0
2024-02-25,32,Current,0,0,0
2024-02-25,32,DPD15-29,103,103,0
2024-02-25,32,DPD3-14,192,192,0
2024-02-25,32,DPD30-59,15,15,0
2024-02-25,32,DPD60-89,0,0,0
2024-02-25,32,DPD90+,0,0,0
2024-02-25,34,Current,0,0,0
2024-02-25,34,DPD15-29,28,28,0
2024-02-25,34,DPD3-14,94,94,0
2024-02-25,34,DPD30-59,5,5,0
2024-02-25,34,DPD60-89,0,0,0
2024-02-25,34,DPD90+,0,0,0
2024-02-25,36,Current,0,0,0
2024-02-25,36,DPD15-29,25,25,0
2024-02-25,36,DPD3-14,56,56,0
2024-02-25,36,DPD30-59,8,8,0
2024-02-25,36,DPD60-89,0,0,0
2024-02-25,36,DPD90+,0,0,0
2024-02-25,38,Current,0,0,0
2024-02-25,38,DPD15-29,16,16,0
2024-02-25,38,DPD3-14,70,70,0
2024-02-25,38,DPD30-59,6,6,0
2024-02-25,38,DPD60-89,0,0,0
2024-02-25,38,DPD90+,0,0,0
2024-02-25,40,Current,0,0,0
2024-02-25,40,DPD15-29,11,11,0
2024-02-25,40,DPD3-14,33,33,0
2024-02-25,40,DPD30-59,1,1,0
2024-02-25,40,DPD60-89,0,0,0
2024-02-25,40,DPD90+,0,0,0
2024-02-25,42,Current,0,0,0
2024-02-25,42,DPD15-29,11,11,0
2024-02-25,42,DPD3-14,19,19,0
2024-02-25,42,DPD30-59,2,2,0
2024-02-25,42,DPD60-89,0,0,0
2024-02-25,42,DPD90+,0,0,0
2024-02-25,44,Current,0,0,0
2024-02-25,44,DPD15-29,19,19,0
2024-02-25,44,DPD3-14,64,64,0
2024-02-25,44,DPD30-59,0,0,0
2024-02-25,44,DPD60-89,0,0,0
2024-02-25,44,DPD90+,0,0,0
2024-02-25,46,Current,0,0,0
2024-02-25,46,DPD15-29,0,0,0
2024-02-25,46,DPD60-89,0,0,0
2024-02-25,48,Current,24,24,0
2024-02-25,48,DPD15-29,10,10,0
2024-02-25,48,DPD3-14,26,26,0
2024-02-25,48,DPD30-59,0,0,0
2024-02-25,48,DPD60-89,0,0,0
2024-02-25,48,DPD90+,0,0,0
2024-02-25,6,Current,0,0,0
2024-02-24,100,Current,0,0,0
2024-02-24,102,Current,0,0,0
2024-02-24,102,DPD15-29,0,0,0
2024-02-24,102,DPD3-14,0,0,0
2024-02-24,102,DPD30-59,0,0,0
2024-02-24,102,DPD60-89,0,0,0
2024-02-24,104,Current,0,0,0
2024-02-24,104,DPD3-14,1,1,0
2024-02-24,104,DPD60-89,0,0,0
2024-02-24,104,DPD90+,0,0,0
2024-02-24,20,Current,0,0,0
2024-02-24,20,DPD15-29,193,193,0
2024-02-24,20,DPD3-14,356,356,0
2024-02-24,20,DPD30-59,75,75,0
2024-02-24,20,DPD60-89,11,11,0
2024-02-24,20,DPD90+,2,2,0
2024-02-24,22,Current,0,0,0
2024-02-24,22,DPD3-14,0,0,0
2024-02-24,22,DPD30-59,1,1,0
2024-02-24,22,DPD60-89,0,0,0
2024-02-24,22,DPD90+,0,0,0
2024-02-24,24,Current,22,22,0
2024-02-24,24,DPD15-29,93,93,0
2024-02-24,24,DPD3-14,232,232,0
2024-02-24,24,DPD30-59,48,48,0
2024-02-24,24,DPD60-89,0,0,0
2024-02-24,24,DPD90+,0,0,0
2024-02-24,26,Current,0,0,0
2024-02-24,26,DPD15-29,16,16,0
2024-02-24,26,DPD3-14,29,29,0
2024-02-24,26,DPD30-59,9,9,0
2024-02-24,26,DPD60-89,0,0,0
2024-02-24,26,DPD90+,0,0,0
2024-02-24,32,Current,0,0,0
2024-02-24,32,DPD15-29,72,72,0
2024-02-24,32,DPD3-14,168,168,0
2024-02-24,32,DPD30-59,53,53,0
2024-02-24,32,DPD60-89,0,0,0
2024-02-24,32,DPD90+,0,0,0
2024-02-24,34,Current,0,0,0
2024-02-24,34,DPD15-29,46,46,0
2024-02-24,34,DPD3-14,67,67,0
2024-02-24,34,DPD30-59,28,28,0
2024-02-24,34,DPD60-89,0,0,0
2024-02-24,34,DPD90+,0,0,0
2024-02-24,36,Current,0,0,0
2024-02-24,36,DPD15-29,25,25,0
2024-02-24,36,DPD3-14,59,59,0
2024-02-24,36,DPD30-59,21,21,0
2024-02-24,36,DPD60-89,0,0,0
2024-02-24,36,DPD90+,0,0,0
2024-02-24,38,Current,0,0,0
2024-02-24,38,DPD15-29,20,20,0
2024-02-24,38,DPD3-14,53,53,0
2024-02-24,38,DPD30-59,10,10,0
2024-02-24,38,DPD60-89,0,0,0
2024-02-24,38,DPD90+,0,0,0
2024-02-24,40,Current,0,0,0
2024-02-24,40,DPD15-29,13,13,0
2024-02-24,40,DPD3-14,33,33,0
2024-02-24,40,DPD30-59,5,5,0
2024-02-24,40,DPD60-89,0,0,0
2024-02-24,40,DPD90+,0,0,0
2024-02-24,42,Current,0,0,0
2024-02-24,42,DPD15-29,7,7,0
2024-02-24,42,DPD3-14,13,13,0
2024-02-24,42,DPD30-59,2,2,0
2024-02-24,42,DPD60-89,0,0,0
2024-02-24,42,DPD90+,0,0,0
2024-02-24,44,Current,0,0,0
2024-02-24,44,DPD15-29,34,34,0
2024-02-24,44,DPD3-14,49,49,0
2024-02-24,44,DPD30-59,14,14,0
2024-02-24,44,DPD60-89,0,0,0
2024-02-24,44,DPD90+,0,0,0
2024-02-24,46,Current,0,0,0
2024-02-24,46,DPD15-29,1,1,0
2024-02-24,46,DPD60-89,0,0,0
2024-02-24,48,Current,31,31,0
2024-02-24,48,DPD15-29,11,11,0
2024-02-24,48,DPD3-14,29,29,0
2024-02-24,48,DPD30-59,7,7,0
2024-02-24,48,DPD60-89,0,0,0
2024-02-24,48,DPD90+,0,0,0
2024-02-24,6,Current,0,0,0
2024-02-23,100,Current,0,0,0
2024-02-23,102,Current,0,0,0
2024-02-23,102,DPD15-29,0,0,0
2024-02-23,102,DPD3-14,2,2,0
2024-02-23,102,DPD30-59,0,0,0
2024-02-23,102,DPD60-89,0,0,0
2024-02-23,104,Current,0,0,0
2024-02-23,104,DPD3-14,2,2,0
2024-02-23,104,DPD60-89,0,0,0
2024-02-23,104,DPD90+,0,0,0
2024-02-23,20,Current,305,305,0
2024-02-23,20,DPD15-29,194,194,0
2024-02-23,20,DPD3-14,467,467,0
2024-02-23,20,DPD30-59,140,140,0
2024-02-23,20,DPD60-89,91,91,0
2024-02-23,20,DPD90+,117,117,0
2024-02-23,22,Current,0,0,0
2024-02-23,22,DPD3-14,0,0,0
2024-02-23,22,DPD30-59,1,1,0
2024-02-23,22,DPD60-89,0,0,0
2024-02-23,22,DPD90+,0,0,0
2024-02-23,24,Current,240,240,0
2024-02-23,24,DPD15-29,94,94,0
2024-02-23,24,DPD3-14,236,236,0
2024-02-23,24,DPD30-59,66,66,0
2024-02-23,24,DPD60-89,0,0,0
2024-02-23,24,DPD90+,0,0,0
2024-02-23,26,Current,14,14,0
2024-02-23,26,DPD15-29,12,12,0
2024-02-23,26,DPD3-14,52,52,0
2024-02-23,26,DPD30-59,7,7,0
2024-02-23,26,DPD60-89,0,0,0
2024-02-23,26,DPD90+,0,0,0
2024-02-23,32,Current,118,118,0
2024-02-23,32,DPD15-29,101,101,0
2024-02-23,32,DPD3-14,193,193,0
2024-02-23,32,DPD30-59,74,74,0
2024-02-23,32,DPD60-89,1,1,0
2024-02-23,32,DPD90+,0,0,0
2024-02-23,34,Current,44,44,0
2024-02-23,34,DPD15-29,28,28,0
2024-02-23,34,DPD3-14,94,94,0
2024-02-23,34,DPD30-59,33,33,0
2024-02-23,34,DPD60-89,0,0,0
2024-02-23,34,DPD90+,0,0,0
2024-02-23,36,Current,46,46,0
2024-02-23,36,DPD15-29,35,35,0
2024-02-23,36,DPD3-14,55,55,0
2024-02-23,36,DPD30-59,25,25,0
2024-02-23,36,DPD60-89,0,0,0
2024-02-23,36,DPD90+,0,0,0
2024-02-23,38,Current,37,37,0
2024-02-23,38,DPD15-29,21,21,0
2024-02-23,38,DPD3-14,61,61,0
2024-02-23,38,DPD30-59,16,16,0
2024-02-23,38,DPD60-89,0,0,0
2024-02-23,38,DPD90+,0,0,0
2024-02-23,40,Current,19,19,0
2024-02-23,40,DPD15-29,12,12,0
2024-02-23,40,DPD3-14,32,32,0
2024-02-23,40,DPD30-59,7,7,0
2024-02-23,40,DPD60-89,0,0,0
2024-02-23,40,DPD90+,0,0,0
2024-02-23,42,Current,14,14,0
2024-02-23,42,DPD15-29,10,10,0
2024-02-23,42,DPD3-14,22,22,0
2024-02-23,42,DPD30-59,8,8,0
2024-02-23,42,DPD60-89,0,0,0
2024-02-23,42,DPD90+,0,0,0
2024-02-23,44,Current,39,39,0
2024-02-23,44,DPD15-29,13,13,0
2024-02-23,44,DPD3-14,67,67,0
2024-02-23,44,DPD30-59,12,12,0
2024-02-23,44,DPD60-89,0,0,0
2024-02-23,44,DPD90+,0,0,0
2024-02-23,46,Current,1,1,0
2024-02-23,46,DPD15-29,0,0,0
2024-02-23,46,DPD60-89,0,0,0
2024-02-23,48,Current,109,109,0
2024-02-23,48,DPD15-29,10,10,0
2024-02-23,48,DPD3-14,32,32,0
2024-02-23,48,DPD30-59,7,7,0
2024-02-23,48,DPD60-89,0,0,0
2024-02-23,48,DPD90+,0,0,0
2024-02-23,6,Current,0,0,0
2024-02-22,100,Current,0,0,0
2024-02-22,100,DPD15-29,0,0,0
2024-02-22,102,Current,0,0,0
2024-02-22,102,DPD15-29,0,0,0
2024-02-22,102,DPD3-14,0,0,0
2024-02-22,102,DPD30-59,1,1,0
2024-02-22,102,DPD60-89,0,0,0
2024-02-22,104,Current,0,0,0
2024-02-22,104,DPD3-14,1,1,0
2024-02-22,104,DPD60-89,0,0,0
2024-02-22,104,DPD90+,0,0,0
2024-02-22,20,Current,80,80,0
2024-02-22,20,DPD15-29,189,189,0
2024-02-22,20,DPD3-14,373,373,0
2024-02-22,20,DPD30-59,158,158,0
2024-02-22,20,DPD60-89,88,88,0
2024-02-22,20,DPD90+,14,14,0
2024-02-22,22,Current,0,0,0
2024-02-22,22,DPD3-14,0,0,0
2024-02-22,22,DPD30-59,0,0,0
2024-02-22,22,DPD60-89,0,0,0
2024-02-22,22,DPD90+,0,0,0
2024-02-22,24,Current,105,105,0
2024-02-22,24,DPD15-29,86,86,0
2024-02-22,24,DPD3-14,225,225,0
2024-02-22,24,DPD30-59,66,66,0
2024-02-22,24,DPD60-89,0,0,0
2024-02-22,24,DPD90+,1,1,0
2024-02-22,26,Current,3,3,0
2024-02-22,26,DPD15-29,18,18,0
2024-02-22,26,DPD3-14,31,31,0
2024-02-22,26,DPD30-59,11,11,0
2024-02-22,26,DPD60-89,0,0,0
2024-02-22,26,DPD90+,0,0,0
2024-02-22,32,Current,12,12,0
2024-02-22,32,DPD15-29,78,78,0
2024-02-22,32,DPD3-14,159,159,0
2024-02-22,32,DPD30-59,69,69,0
2024-02-22,32,DPD60-89,0,0,0
2024-02-22,32,DPD90+,0,0,0
2024-02-22,34,Current,1,1,0
2024-02-22,34,DPD15-29,42,42,0
2024-02-22,34,DPD3-14,65,65,0
2024-02-22,34,DPD30-59,33,33,0
2024-02-22,34,DPD60-89,0,0,0
2024-02-22,34,DPD90+,0,0,0
2024-02-22,36,Current,5,5,0
2024-02-22,36,DPD15-29,22,22,0
2024-02-22,36,DPD3-14,59,59,0
2024-02-22,36,DPD30-59,28,28,0
2024-02-22,36,DPD60-89,0,0,0
2024-02-22,36,DPD90+,0,0,0
2024-02-22,38,Current,5,5,0
2024-02-22,38,DPD15-29,15,15,0
2024-02-22,38,DPD3-14,55,55,0
2024-02-22,38,DPD30-59,14,14,0
2024-02-22,38,DPD60-89,0,0,0
2024-02-22,38,DPD90+,0,0,0
2024-02-22,40,Current,5,5,0
2024-02-22,40,DPD15-29,13,13,0
2024-02-22,40,DPD3-14,38,38,0
2024-02-22,40,DPD30-59,10,10,0
2024-02-22,40,DPD60-89,0,0,0
2024-02-22,40,DPD90+,0,0,0
2024-02-22,42,Current,2,2,0
2024-02-22,42,DPD15-29,8,8,0
2024-02-22,42,DPD3-14,10,10,0
2024-02-22,42,DPD30-59,8,8,0
2024-02-22,42,DPD60-89,0,0,0
2024-02-22,42,DPD90+,0,0,0
2024-02-22,44,Current,6,6,0
2024-02-22,44,DPD15-29,30,30,0
2024-02-22,44,DPD3-14,61,61,0
2024-02-22,44,DPD30-59,19,19,0
2024-02-22,44,DPD60-89,0,0,0
2024-02-22,44,DPD90+,0,0,0
2024-02-22,46,Current,0,0,0
2024-02-22,46,DPD15-29,0,0,0
2024-02-22,46,DPD60-89,0,0,0
2024-02-22,48,Current,64,64,0
2024-02-22,48,DPD15-29,11,11,0
2024-02-22,48,DPD3-14,33,33,0
2024-02-22,48,DPD30-59,10,10,0
2024-02-22,48,DPD60-89,0,0,0
2024-02-22,48,DPD90+,0,0,0
2024-02-22,6,Current,0,0,0
2024-02-21,100,Current,0,0,0
2024-02-21,100,DPD15-29,1,1,0
2024-02-21,102,Current,0,0,0
2024-02-21,102,DPD15-29,0,0,0
2024-02-21,102,DPD3-14,2,2,0
2024-02-21,102,DPD30-59,0,0,0
2024-02-21,102,DPD60-89,0,0,0
2024-02-21,104,Current,0,0,0
2024-02-21,104,DPD3-14,0,0,0
2024-02-21,104,DPD60-89,0,0,0
2024-02-21,104,DPD90+,0,0,0
2024-02-21,20,Current,4,4,0
2024-02-21,20,DPD15-29,236,236,0
2024-02-21,20,DPD3-14,486,486,0
2024-02-21,20,DPD30-59,34,34,0
2024-02-21,20,DPD60-89,2,2,0
2024-02-21,20,DPD90+,2,2,0
2024-02-21,22,Current,0,0,0
2024-02-21,22,DPD3-14,0,0,0
2024-02-21,22,DPD30-59,0,0,0
2024-02-21,22,DPD60-89,0,0,0
2024-02-21,22,DPD90+,0,0,0
2024-02-21,24,Current,76,76,0
2024-02-21,24,DPD15-29,119,119,0
2024-02-21,24,DPD3-14,235,235,0
2024-02-21,24,DPD30-59,26,26,0
2024-02-21,24,DPD60-89,0,0,0
2024-02-21,24,DPD90+,0,0,0
2024-02-21,26,Current,0,0,0
2024-02-21,26,DPD15-29,17,17,0
2024-02-21,26,DPD3-14,48,48,0
2024-02-21,26,DPD30-59,4,4,0
2024-02-21,26,DPD60-89,0,0,0
2024-02-21,26,DPD90+,0,0,0
2024-02-21,32,Current,0,0,0
2024-02-21,32,DPD15-29,129,129,0
2024-02-21,32,DPD3-14,201,201,0
2024-02-21,32,DPD30-59,26,26,0
2024-02-21,32,DPD60-89,0,0,0
2024-02-21,32,DPD90+,0,0,0
2024-02-21,34,Current,0,0,0
2024-02-21,34,DPD15-29,37,37,0
2024-02-21,34,DPD3-14,86,86,0
2024-02-21,34,DPD30-59,13,13,0
2024-02-21,34,DPD60-89,0,0,0
2024-02-21,34,DPD90+,0,0,0
2024-02-21,36,Current,0,0,0
2024-02-21,36,DPD15-29,42,42,0
2024-02-21,36,DPD3-14,54,54,0
2024-02-21,36,DPD30-59,11,11,0
2024-02-21,36,DPD60-89,0,0,0
2024-02-21,36,DPD90+,0,0,0
2024-02-21,38,Current,0,0,0
2024-02-21,38,DPD15-29,28,28,0
2024-02-21,38,DPD3-14,61,61,0
2024-02-21,38,DPD30-59,8,8,0
2024-02-21,38,DPD60-89,0,0,0
2024-02-21,38,DPD90+,0,0,0
2024-02-21,40,Current,0,0,0
2024-02-21,40,DPD15-29,14,14,0
2024-02-21,40,DPD3-14,36,36,0
2024-02-21,40,DPD30-59,4,4,0
2024-02-21,40,DPD60-89,0,0,0
2024-02-21,40,DPD90+,0,0,0
2024-02-21,42,Current,0,0,0
2024-02-21,42,DPD15-29,13,13,0
2024-02-21,42,DPD3-14,28,28,0
2024-02-21,42,DPD30-59,1,1,0
2024-02-21,42,DPD60-89,0,0,0
2024-02-21,42,DPD90+,0,0,0
2024-02-21,44,Current,0,0,0
2024-02-21,44,DPD15-29,18,18,0
2024-02-21,44,DPD3-14,61,61,0
2024-02-21,44,DPD30-59,6,6,0
2024-02-21,44,DPD60-89,0,0,0
2024-02-21,44,DPD90+,0,0,0
2024-02-21,46,Current,0,0,0
2024-02-21,46,DPD3-14,0,0,0
2024-02-21,46,DPD60-89,0,0,0
2024-02-21,48,Current,67,67,0
2024-02-21,48,DPD15-29,8,8,0
2024-02-21,48,DPD3-14,31,31,0
2024-02-21,48,DPD30-59,2,2,0
2024-02-21,48,DPD60-89,0,0,0
2024-02-21,48,DPD90+,0,0,0
2024-02-21,6,Current,0,0,0
2024-02-20,100,Current,0,0,0
2024-02-20,100,DPD15-29,0,0,0
2024-02-20,100,DPD3-14,0,0,0
2024-02-20,102,Current,0,0,0
2024-02-20,102,DPD3-14,0,0,0
2024-02-20,102,DPD30-59,0,0,0
2024-02-20,104,Current,0,0,0
2024-02-20,104,DPD60-89,0,0,0
2024-02-20,104,DPD90+,0,0,0
2024-02-20,20,Current,3,3,0
2024-02-20,20,DPD15-29,197,197,0
2024-02-20,20,DPD3-14,443,443,0
2024-02-20,20,DPD30-59,60,60,0
2024-02-20,20,DPD60-89,49,49,0
2024-02-20,20,DPD90+,82,82,0
2024-02-20,22,Current,0,0,0
2024-02-20,22,DPD15-29,0,0,0
2024-02-20,22,DPD3-14,0,0,0
2024-02-20,22,DPD30-59,1,1,0
2024-02-20,22,DPD60-89,0,0,0
2024-02-20,22,DPD90+,0,0,0
2024-02-20,24,Current,45,45,0
2024-02-20,24,DPD15-29,89,89,0
2024-02-20,24,DPD3-14,270,270,0
2024-02-20,24,DPD30-59,36,36,0
2024-02-20,24,DPD60-89,0,0,0
2024-02-20,24,DPD90+,0,0,0
2024-02-20,26,Current,0,0,0
2024-02-20,26,DPD15-29,16,16,0
2024-02-20,26,DPD3-14,40,40,0
2024-02-20,26,DPD30-59,6,6,0
2024-02-20,26,DPD60-89,0,0,0
2024-02-20,26,DPD90+,0,0,0
2024-02-20,32,Current,0,0,0
2024-02-20,32,DPD15-29,82,82,0
2024-02-20,32,DPD3-14,170,170,0
2024-02-20,32,DPD30-59,25,25,0
2024-02-20,32,DPD60-89,0,0,0
2024-02-20,32,DPD90+,0,0,0
2024-02-20,34,Current,0,0,0
2024-02-20,34,DPD15-29,51,51,0
2024-02-20,34,DPD3-14,71,71,0
2024-02-20,34,DPD30-59,19,19,0
2024-02-20,34,DPD60-89,0,0,0
2024-02-20,34,DPD90+,0,0,0
2024-02-20,36,Current,0,0,0
2024-02-20,36,DPD15-29,24,24,0
2024-02-20,36,DPD3-14,62,62,0
2024-02-20,36,DPD30-59,13,13,0
2024-02-20,36,DPD60-89,0,0,0
2024-02-20,36,DPD90+,0,0,0
2024-02-20,38,Current,0,0,0
2024-02-20,38,DPD15-29,19,19,0
2024-02-20,38,DPD3-14,66,66,0
2024-02-20,38,DPD30-59,4,4,0
2024-02-20,38,DPD60-89,0,0,0
2024-02-20,38,DPD90+,0,0,0
2024-02-20,40,Current,0,0,0
2024-02-20,40,DPD15-29,15,15,0
2024-02-20,40,DPD3-14,35,35,0
2024-02-20,40,DPD30-59,3,3,0
2024-02-20,40,DPD60-89,0,0,0
2024-02-20,40,DPD90+,0,0,0
2024-02-20,42,Current,0,0,0
2024-02-20,42,DPD15-29,8,8,0
2024-02-20,42,DPD3-14,14,14,0
2024-02-20,42,DPD30-59,1,1,0
2024-02-20,42,DPD60-89,0,0,0
2024-02-20,42,DPD90+,0,0,0
2024-02-20,44,Current,0,0,0
2024-02-20,44,DPD15-29,26,26,0
2024-02-20,44,DPD3-14,69,69,0
2024-02-20,44,DPD30-59,15,15,0
2024-02-20,44,DPD60-89,0,0,0
2024-02-20,44,DPD90+,0,0,0
2024-02-20,46,Current,0,0,0
2024-02-20,46,DPD3-14,1,1,0
2024-02-20,46,DPD60-89,0,0,0
2024-02-20,48,Current,52,52,0
2024-02-20,48,DPD15-29,11,11,0
2024-02-20,48,DPD3-14,43,43,0
2024-02-20,48,DPD30-59,5,5,0
2024-02-20,48,DPD60-89,0,0,0
2024-02-20,48,DPD90+,0,0,0
2024-02-20,6,Current,0,0,0
2024-02-19,100,Current,0,0,0
2024-02-19,100,DPD15-29,1,1,0
2024-02-19,102,Current,0,0,0
2024-02-19,102,DPD3-14,1,1,0
2024-02-19,102,DPD30-59,0,0,0
2024-02-19,104,Current,0,0,0
2024-02-19,104,DPD30-59,0,0,0
2024-02-19,104,DPD60-89,0,0,0
2024-02-19,104,DPD90+,0,0,0
2024-02-19,20,Current,91,91,0
2024-02-19,20,DPD15-29,240,240,0
2024-02-19,20,DPD3-14,464,464,0
2024-02-19,20,DPD30-59,177,177,0
2024-02-19,20,DPD60-89,86,86,0
2024-02-19,20,DPD90+,79,79,0
2024-02-19,22,Current,0,0,0
2024-02-19,22,DPD15-29,1,1,0
2024-02-19,22,DPD3-14,0,0,0
2024-02-19,22,DPD30-59,0,0,0
2024-02-19,22,DPD60-89,0,0,0
2024-02-19,22,DPD90+,0,0,0
2024-02-19,24,Current,151,151,0
2024-02-19,24,DPD15-29,128,128,0
2024-02-19,24,DPD3-14,216,216,0
2024-02-19,24,DPD30-59,73,73,0
2024-02-19,24,DPD60-89,0,0,0
2024-02-19,24,DPD90+,0,0,0
2024-02-19,26,Current,0,0,0
2024-02-19,26,DPD15-29,21,21,0
2024-02-19,26,DPD3-14,41,41,0
2024-02-19,26,DPD30-59,8,8,0
2024-02-19,26,DPD60-89,0,0,0
2024-02-19,26,DPD90+,0,0,0
2024-02-19,32,Current,0,0,0
2024-02-19,32,DPD15-29,134,134,0
2024-02-19,32,DPD3-14,170,170,0
2024-02-19,32,DPD30-59,107,107,0
2024-02-19,32,DPD60-89,0,0,0
2024-02-19,32,DPD90+,0,0,0
2024-02-19,34,Current,0,0,0
2024-02-19,34,DPD15-29,45,45,0
2024-02-19,34,DPD3-14,73,73,0
2024-02-19,34,DPD30-59,44,44,0
2024-02-19,34,DPD60-89,0,0,0
2024-02-19,34,DPD90+,0,0,0
2024-02-19,36,Current,0,0,0
2024-02-19,36,DPD15-29,46,46,0
2024-02-19,36,DPD3-14,49,49,0
2024-02-19,36,DPD30-59,25,25,0
2024-02-19,36,DPD60-89,0,0,0
2024-02-19,36,DPD90+,0,0,0
2024-02-19,38,Current,0,0,0
2024-02-19,38,DPD15-29,30,30,0
2024-02-19,38,DPD3-14,69,69,0
2024-02-19,38,DPD30-59,20,20,0
2024-02-19,38,DPD60-89,0,0,0
2024-02-19,38,DPD90+,0,0,0
2024-02-19,40,Current,0,0,0
2024-02-19,40,DPD15-29,15,15,0
2024-02-19,40,DPD3-14,32,32,0
2024-02-19,40,DPD30-59,8,8,0
2024-02-19,40,DPD60-89,0,0,0
2024-02-19,40,DPD90+,0,0,0
2024-02-19,42,Current,0,0,0
2024-02-19,42,DPD15-29,13,13,0
2024-02-19,42,DPD3-14,27,27,0
2024-02-19,42,DPD30-59,9,9,0
2024-02-19,42,DPD60-89,0,0,0
2024-02-19,42,DPD90+,0,0,0
2024-02-19,44,Current,0,0,0
2024-02-19,44,DPD15-29,16,16,0
2024-02-19,44,DPD3-14,61,61,0
2024-02-19,44,DPD30-59,19,19,0
2024-02-19,44,DPD60-89,0,0,0
2024-02-19,44,DPD90+,0,0,0
2024-02-19,46,Current,0,0,0
2024-02-19,46,DPD3-14,0,0,0
2024-02-19,46,DPD60-89,0,0,0
2024-02-19,48,Current,149,149,0
2024-02-19,48,DPD15-29,11,11,0
2024-02-19,48,DPD3-14,25,25,0
2024-02-19,48,DPD30-59,6,6,0
2024-02-19,48,DPD60-89,0,0,0
2024-02-19,48,DPD90+,0,0,0
2024-02-19,6,Current,0,0,0
2024-02-18,100,Current,0,0,0
2024-02-18,100,DPD15-29,0,0,0
2024-02-18,102,Current,0,0,0
2024-02-18,102,DPD3-14,0,0,0
2024-02-18,102,DPD30-59,2,2,0
2024-02-18,104,Current,0,0,0
2024-02-18,104,DPD30-59,0,0,0
2024-02-18,104,DPD60-89,0,0,0
2024-02-18,104,DPD90+,0,0,0
2024-02-18,20,Current,2,2,0
2024-02-18,20,DPD15-29,180,180,0
2024-02-18,20,DPD3-14,335,335,0
2024-02-18,20,DPD30-59,167,167,0
2024-02-18,20,DPD60-89,79,79,0
2024-02-18,20,DPD90+,24,24,0
2024-02-18,22,Current,0,0,0
2024-02-18,22,DPD15-29,0,0,0
2024-02-18,22,DPD3-14,0,0,0
2024-02-18,22,DPD30-59,0,0,0
2024-02-18,22,DPD60-89,0,0,0
2024-02-18,22,DPD90+,0,0,0
2024-02-18,24,Current,96,96,0
2024-02-18,24,DPD15-29,89,89,0
2024-02-18,24,DPD3-14,185,185,0
2024-02-18,24,DPD30-59,67,67,0
2024-02-18,24,DPD60-89,0,0,0
2024-02-18,24,DPD90+,0,0,0
2024-02-18,26,Current,0,0,0
2024-02-18,26,DPD15-29,18,18,0
2024-02-18,26,DPD3-14,36,36,0
2024-02-18,26,DPD30-59,14,14,0
2024-02-18,26,DPD60-89,0,0,0
2024-02-18,26,DPD90+,0,0,0
2024-02-18,32,Current,0,0,0
2024-02-18,32,DPD15-29,86,86,0
2024-02-18,32,DPD3-14,119,119,0
2024-02-18,32,DPD30-59,84,84,0
2024-02-18,32,DPD60-89,0,0,0
2024-02-18,32,DPD90+,0,0,0
2024-02-18,34,Current,0,0,0
2024-02-18,34,DPD15-29,53,53,0
2024-02-18,34,DPD3-14,58,58,0
2024-02-18,34,DPD30-59,38,38,0
2024-02-18,34,DPD60-89,0,0,0
2024-02-18,34,DPD90+,0,0,0
2024-02-18,36,Current,0,0,0
2024-02-18,36,DPD15-29,25,25,0
2024-02-18,36,DPD3-14,42,42,0
2024-02-18,36,DPD30-59,31,31,0
2024-02-18,36,DPD60-89,0,0,0
2024-02-18,36,DPD90+,0,0,0
2024-02-18,38,Current,0,0,0
2024-02-18,38,DPD15-29,23,23,0
2024-02-18,38,DPD3-14,42,42,0
2024-02-18,38,DPD30-59,16,16,0
2024-02-18,38,DPD60-89,0,0,0
2024-02-18,38,DPD90+,0,0,0
2024-02-18,40,Current,0,0,0
2024-02-18,40,DPD15-29,11,11,0
2024-02-18,40,DPD3-14,31,31,0
2024-02-18,40,DPD30-59,13,13,0
2024-02-18,40,DPD60-89,0,0,0
2024-02-18,40,DPD90+,0,0,0
2024-02-18,42,Current,0,0,0
2024-02-18,42,DPD15-29,8,8,0
2024-02-18,42,DPD3-14,10,10,0
2024-02-18,42,DPD30-59,10,10,0
2024-02-18,42,DPD60-89,0,0,0
2024-02-18,42,DPD90+,0,0,0
2024-02-18,44,Current,0,0,0
2024-02-18,44,DPD15-29,28,28,0
2024-02-18,44,DPD3-14,44,44,0
2024-02-18,44,DPD30-59,23,23,0
2024-02-18,44,DPD60-89,0,0,0
2024-02-18,44,DPD90+,0,0,0
2024-02-18,46,Current,0,0,0
2024-02-18,46,DPD3-14,1,1,0
2024-02-18,46,DPD60-89,0,0,0
2024-02-18,48,Current,84,84,0
2024-02-18,48,DPD15-29,10,10,0
2024-02-18,48,DPD3-14,39,39,0
2024-02-18,48,DPD30-59,11,11,0
2024-02-18,48,DPD60-89,0,0,0
2024-02-18,48,DPD90+,0,0,0
2024-02-18,6,Current,0,0,0
2024-02-17,100,Current,0,0,0
2024-02-17,100,DPD15-29,1,1,0
2024-02-17,100,DPD3-14,0,0,0
2024-02-17,102,Current,0,0,0
2024-02-17,102,DPD3-14,0,0,0
2024-02-17,102,DPD30-59,0,0,0
2024-02-17,104,Current,0,0,0
2024-02-17,104,DPD30-59,0,0,0
2024-02-17,104,DPD60-89,0,0,0
2024-02-17,104,DPD90+,0,0,0
2024-02-17,20,Current,7,7,0
2024-02-17,20,DPD15-29,220,220,0
2024-02-17,20,DPD3-14,254,254,0
2024-02-17,20,DPD30-59,29,29,0
2024-02-17,20,DPD60-89,10,10,0
2024-02-17,20,DPD90+,1,1,0
2024-02-17,22,Current,0,0,0
2024-02-17,22,DPD15-29,1,1,0
2024-02-17,22,DPD3-14,0,0,0
2024-02-17,22,DPD30-59,1,1,0
2024-02-17,22,DPD60-89,0,0,0
2024-02-17,22,DPD90+,0,0,0
2024-02-17,24,Current,75,75,0
2024-02-17,24,DPD15-29,115,115,0
2024-02-17,24,DPD3-14,120,120,0
2024-02-17,24,DPD30-59,21,21,0
2024-02-17,24,DPD60-89,0,0,0
2024-02-17,24,DPD90+,0,0,0
2024-02-17,26,Current,0,0,0
2024-02-17,26,DPD15-29,16,16,0
2024-02-17,26,DPD3-14,17,17,0
2024-02-17,26,DPD30-59,1,1,0
2024-02-17,26,DPD60-89,0,0,0
2024-02-17,26,DPD90+,0,0,0
2024-02-17,32,Current,0,0,0
2024-02-17,32,DPD15-29,130,130,0
2024-02-17,32,DPD3-14,109,109,0
2024-02-17,32,DPD30-59,11,11,0
2024-02-17,32,DPD60-89,0,0,0
2024-02-17,32,DPD90+,0,0,0
2024-02-17,34,Current,0,0,0
2024-02-17,34,DPD15-29,46,46,0
2024-02-17,34,DPD3-14,36,36,0
2024-02-17,34,DPD30-59,12,12,0
2024-02-17,34,DPD60-89,0,0,0
2024-02-17,34,DPD90+,0,0,0
2024-02-17,36,Current,0,0,0
2024-02-17,36,DPD15-29,43,43,0
2024-02-17,36,DPD3-14,21,21,0
2024-02-17,36,DPD30-59,8,8,0
2024-02-17,36,DPD60-89,0,0,0
2024-02-17,36,DPD90+,0,0,0
2024-02-17,38,Current,0,0,0
2024-02-17,38,DPD15-29,31,31,0
2024-02-17,38,DPD3-14,27,27,0
2024-02-17,38,DPD30-59,1,1,0
2024-02-17,38,DPD60-89,0,0,0
2024-02-17,38,DPD90+,0,0,0
2024-02-17,40,Current,0,0,0
2024-02-17,40,DPD15-29,14,14,0
2024-02-17,40,DPD3-14,18,18,0
2024-02-17,40,DPD30-59,3,3,0
2024-02-17,40,DPD60-89,0,0,0
2024-02-17,40,DPD90+,0,0,0
2024-02-17,42,Current,0,0,0
2024-02-17,42,DPD15-29,10,10,0
2024-02-17,42,DPD3-14,12,12,0
2024-02-17,42,DPD30-59,1,1,0
2024-02-17,42,DPD60-89,0,0,0
2024-02-17,42,DPD90+,0,0,0
2024-02-17,44,Current,0,0,0
2024-02-17,44,DPD15-29,13,13,0
2024-02-17,44,DPD3-14,27,27,0
2024-02-17,44,DPD30-59,11,11,0
2024-02-17,44,DPD60-89,0,0,0
2024-02-17,44,DPD90+,0,0,0
2024-02-17,46,Current,0,0,0
2024-02-17,46,DPD3-14,0,0,0
2024-02-17,46,DPD60-89,0,0,0
2024-02-17,48,Current,71,71,0
2024-02-17,48,DPD15-29,4,4,0
2024-02-17,48,DPD3-14,25,25,0
2024-02-17,48,DPD30-59,1,1,0
2024-02-17,48,DPD60-89,0,0,0
2024-02-17,48,DPD90+,0,0,0
2024-02-17,6,Current,0,0,0
2024-02-16,100,Current,0,0,0
2024-02-16,100,DPD15-29,0,0,0
2024-02-16,100,DPD3-14,0,0,0
2024-02-16,102,Current,0,0,0
2024-02-16,102,DPD15-29,0,0,0
2024-02-16,102,DPD3-14,0,0,0
2024-02-16,102,DPD30-59,0,0,0
2024-02-16,104,Current,0,0,0
2024-02-16,104,DPD30-59,0,0,0
2024-02-16,104,DPD60-89,0,0,0
2024-02-16,104,DPD90+,0,0,0
2024-02-16,20,Current,280,280,0
2024-02-16,20,DPD15-29,162,162,0
2024-02-16,20,DPD3-14,341,341,0
2024-02-16,20,DPD30-59,124,124,0
2024-02-16,20,DPD60-89,77,77,0
2024-02-16,20,DPD90+,117,117,0
2024-02-16,22,Current,0,0,0
2024-02-16,22,DPD15-29,1,1,0
2024-02-16,22,DPD3-14,0,0,0
2024-02-16,22,DPD30-59,0,0,0
2024-02-16,22,DPD60-89,0,0,0
2024-02-16,22,DPD90+,0,0,0
2024-02-16,24,Current,311,311,0
2024-02-16,24,DPD15-29,80,80,0
2024-02-16,24,DPD3-14,191,191,0
2024-02-16,24,DPD30-59,56,56,0
2024-02-16,24,DPD60-89,0,0,0
2024-02-16,24,DPD90+,0,0,0
2024-02-16,26,Current,14,14,0
2024-02-16,26,DPD15-29,20,20,0
2024-02-16,26,DPD3-14,33,33,0
2024-02-16,26,DPD30-59,6,6,0
2024-02-16,26,DPD60-89,0,0,0
2024-02-16,26,DPD90+,0,0,0
2024-02-16,32,Current,102,102,0
2024-02-16,32,DPD15-29,91,91,0
2024-02-16,32,DPD3-14,126,126,0
2024-02-16,32,DPD30-59,65,65,0
2024-02-16,32,DPD60-89,0,0,0
2024-02-16,32,DPD90+,0,0,0
2024-02-16,34,Current,46,46,0
2024-02-16,34,DPD15-29,52,52,0
2024-02-16,34,DPD3-14,55,55,0
2024-02-16,34,DPD30-59,32,32,0
2024-02-16,34,DPD60-89,0,0,0
2024-02-16,34,DPD90+,0,0,0
2024-02-16,36,Current,45,45,0
2024-02-16,36,DPD15-29,27,27,0
2024-02-16,36,DPD3-14,38,38,0
2024-02-16,36,DPD30-59,17,17,0
2024-02-16,36,DPD60-89,0,0,0
2024-02-16,36,DPD90+,0,0,0
2024-02-16,38,Current,30,30,0
2024-02-16,38,DPD15-29,25,25,0
2024-02-16,38,DPD3-14,42,42,0
2024-02-16,38,DPD30-59,11,11,0
2024-02-16,38,DPD60-89,0,0,0
2024-02-16,38,DPD90+,0,0,0
2024-02-16,40,Current,30,30,0
2024-02-16,40,DPD15-29,13,13,0
2024-02-16,40,DPD3-14,27,27,0
2024-02-16,40,DPD30-59,8,8,0
2024-02-16,40,DPD60-89,0,0,0
2024-02-16,40,DPD90+,0,0,0
2024-02-16,42,Current,12,12,0
2024-02-16,42,DPD15-29,7,7,0
2024-02-16,42,DPD3-14,11,11,0
2024-02-16,42,DPD30-59,8,8,0
2024-02-16,42,DPD60-89,0,0,0
2024-02-16,42,DPD90+,0,0,0
2024-02-16,44,Current,22,22,0
2024-02-16,44,DPD15-29,23,23,0
2024-02-16,44,DPD3-14,45,45,0
2024-02-16,44,DPD30-59,12,12,0
2024-02-16,44,DPD60-89,0,0,0
2024-02-16,44,DPD90+,0,0,0
2024-02-16,46,Current,0,0,0
2024-02-16,46,DPD3-14,1,1,0
2024-02-16,46,DPD60-89,0,0,0
2024-02-16,48,Current,161,161,0
2024-02-16,48,DPD15-29,8,8,0
2024-02-16,48,DPD3-14,36,36,0
2024-02-16,48,DPD30-59,4,4,0
2024-02-16,48,DPD60-89,0,0,0
2024-02-16,48,DPD90+,0,0,0
2024-02-16,6,Current,0,0,0
2024-02-15,100,Current,0,0,0
2024-02-15,100,DPD15-29,1,1,0
2024-02-15,100,DPD3-14,0,0,0
2024-02-15,102,Current,0,0,0
2024-02-15,102,DPD15-29,0,0,0
2024-02-15,102,DPD3-14,0,0,0
2024-02-15,102,DPD30-59,0,0,0
2024-02-15,102,DPD60-89,0,0,0
2024-02-15,104,Current,0,0,0
2024-02-15,104,DPD30-59,0,0,0
2024-02-15,104,DPD60-89,0,0,0
2024-02-15,104,DPD90+,0,0,0
2024-02-15,20,Current,5411,5411,0
2024-02-15,20,DPD15-29,295,295,0
2024-02-15,20,DPD3-14,370,370,0
2024-02-15,20,DPD30-59,165,165,0
2024-02-15,20,DPD60-89,56,56,0
2024-02-15,20,DPD90+,42,42,0
2024-02-15,22,Current,0,0,0
2024-02-15,22,DPD15-29,2,2,0
2024-02-15,22,DPD3-14,0,0,0
2024-02-15,22,DPD30-59,0,0,0
2024-02-15,22,DPD60-89,0,0,0
2024-02-15,22,DPD90+,0,0,0
2024-02-15,24,Current,3507,3507,0
2024-02-15,24,DPD15-29,137,137,0
2024-02-15,24,DPD3-14,184,184,0
2024-02-15,24,DPD30-59,57,57,0
2024-02-15,24,DPD60-89,10,10,0
2024-02-15,24,DPD90+,12,12,0
2024-02-15,26,Current,8,8,0
2024-02-15,26,DPD15-29,19,19,0
2024-02-15,26,DPD3-14,16,16,0
2024-02-15,26,DPD30-59,3,3,0
2024-02-15,26,DPD60-89,0,0,0
2024-02-15,26,DPD90+,0,0,0
2024-02-15,32,Current,294,294,0
2024-02-15,32,DPD15-29,126,126,0
2024-02-15,32,DPD3-14,137,137,0
2024-02-15,32,DPD30-59,64,64,0
2024-02-15,32,DPD60-89,6,6,0
2024-02-15,32,DPD90+,10,10,0
2024-02-15,34,Current,4,4,0
2024-02-15,34,DPD15-29,49,49,0
2024-02-15,34,DPD3-14,39,39,0
2024-02-15,34,DPD30-59,20,20,0
2024-02-15,34,DPD60-89,0,0,0
2024-02-15,34,DPD90+,0,0,0
2024-02-15,36,Current,308,308,0
2024-02-15,36,DPD15-29,50,50,0
2024-02-15,36,DPD3-14,32,32,0
2024-02-15,36,DPD30-59,19,19,0
2024-02-15,36,DPD60-89,3,3,0
2024-02-15,36,DPD90+,2,2,0
2024-02-15,38,Current,11,11,0
2024-02-15,38,DPD15-29,28,28,0
2024-02-15,38,DPD3-14,32,32,0
2024-02-15,38,DPD30-59,13,13,0
2024-02-15,38,DPD60-89,0,0,0
2024-02-15,38,DPD90+,1,1,0
2024-02-15,40,Current,342,342,0
2024-02-15,40,DPD15-29,15,15,0
2024-02-15,40,DPD3-14,24,24,0
2024-02-15,40,DPD30-59,8,8,0
2024-02-15,40,DPD60-89,0,0,0
2024-02-15,40,DPD90+,1,1,0
2024-02-15,42,Current,4,4,0
2024-02-15,42,DPD15-29,8,8,0
2024-02-15,42,DPD3-14,12,12,0
2024-02-15,42,DPD30-59,6,6,0
2024-02-15,42,DPD60-89,0,0,0
2024-02-15,42,DPD90+,0,0,0
2024-02-15,44,Current,214,214,0
2024-02-15,44,DPD15-29,22,22,0
2024-02-15,44,DPD3-14,34,34,0
2024-02-15,44,DPD30-59,13,13,0
2024-02-15,44,DPD60-89,0,0,0
2024-02-15,44,DPD90+,1,1,0
2024-02-15,46,Current,5,5,0
2024-02-15,46,DPD3-14,0,0,0
2024-02-15,46,DPD60-89,0,0,0
2024-02-15,48,Current,3795,3795,0
2024-02-15,48,DPD15-29,18,18,0
2024-02-15,48,DPD3-14,66,66,0
2024-02-15,48,DPD30-59,22,22,0
2024-02-15,48,DPD60-89,15,15,0
2024-02-15,48,DPD90+,11,11,0
2024-02-15,6,Current,1,1,0
2024-02-14,100,Current,0,0,0
2024-02-14,100,DPD15-29,0,0,0
2024-02-14,100,DPD3-14,0,0,0
2024-02-14,102,Current,0,0,0
2024-02-14,102,DPD15-29,0,0,0
2024-02-14,102,DPD3-14,1,1,0
2024-02-14,102,DPD30-59,2,2,0
2024-02-14,102,DPD60-89,0,0,0
2024-02-14,104,Current,0,0,0
2024-02-14,104,DPD30-59,0,0,0
2024-02-14,104,DPD60-89,0,0,0
2024-02-14,104,DPD90+,0,0,0
2024-02-14,20,Current,7,7,0
2024-02-14,20,DPD15-29,216,216,0
2024-02-14,20,DPD3-14,321,321,0
2024-02-14,20,DPD30-59,168,168,0
2024-02-14,20,DPD60-89,65,65,0
2024-02-14,20,DPD90+,15,15,0
2024-02-14,22,Current,0,0,0
2024-02-14,22,DPD15-29,1,1,0
2024-02-14,22,DPD3-14,0,0,0
2024-02-14,22,DPD30-59,0,0,0
2024-02-14,22,DPD60-89,0,0,0
2024-02-14,22,DPD90+,0,0,0
2024-02-14,24,Current,61,61,0
2024-02-14,24,DPD15-29,104,104,0
2024-02-14,24,DPD3-14,178,178,0
2024-02-14,24,DPD30-59,80,80,0
2024-02-14,24,DPD60-89,0,0,0
2024-02-14,24,DPD90+,0,0,0
2024-02-14,26,Current,0,0,0
2024-02-14,26,DPD15-29,25,25,0
2024-02-14,26,DPD3-14,28,28,0
2024-02-14,26,DPD30-59,13,13,0
2024-02-14,26,DPD60-89,0,0,0
2024-02-14,26,DPD90+,0,0,0
2024-02-14,32,Current,0,0,0
2024-02-14,32,DPD15-29,129,129,0
2024-02-14,32,DPD3-14,117,117,0
2024-02-14,32,DPD30-59,92,92,0
2024-02-14,32,DPD60-89,0,0,0
2024-02-14,32,DPD90+,0,0,0
2024-02-14,34,Current,0,0,0
2024-02-14,34,DPD15-29,74,74,0
2024-02-14,34,DPD3-14,59,59,0
2024-02-14,34,DPD30-59,36,36,0
2024-02-14,34,DPD60-89,0,0,0
2024-02-14,34,DPD90+,0,0,0
2024-02-14,36,Current,1,1,0
2024-02-14,36,DPD15-29,42,42,0
2024-02-14,36,DPD3-14,39,39,0
2024-02-14,36,DPD30-59,29,29,0
2024-02-14,36,DPD60-89,0,0,0
2024-02-14,36,DPD90+,0,0,0
2024-02-14,38,Current,0,0,0
2024-02-14,38,DPD15-29,30,30,0
2024-02-14,38,DPD3-14,41,41,0
2024-02-14,38,DPD30-59,19,19,0
2024-02-14,38,DPD60-89,0,0,0
2024-02-14,38,DPD90+,0,0,0
2024-02-14,40,Current,1,1,0
2024-02-14,40,DPD15-29,19,19,0
2024-02-14,40,DPD3-14,25,25,0
2024-02-14,40,DPD30-59,12,12,0
2024-02-14,40,DPD60-89,0,0,0
2024-02-14,40,DPD90+,0,0,0
2024-02-14,42,Current,0,0,0
2024-02-14,42,DPD15-29,12,12,0
2024-02-14,42,DPD3-14,13,13,0
2024-02-14,42,DPD30-59,7,7,0
2024-02-14,42,DPD60-89,0,0,0
2024-02-14,42,DPD90+,0,0,0
2024-02-14,44,Current,0,0,0
2024-02-14,44,DPD15-29,28,28,0
2024-02-14,44,DPD3-14,45,45,0
2024-02-14,44,DPD30-59,23,23,0
2024-02-14,44,DPD60-89,0,0,0
2024-02-14,44,DPD90+,0,0,0
2024-02-14,46,Current,0,0,0
2024-02-14,46,DPD3-14,1,1,0
2024-02-14,46,DPD60-89,0,0,0
2024-02-14,48,Current,63,63,0
2024-02-14,48,DPD15-29,11,11,0
2024-02-14,48,DPD3-14,34,34,0
2024-02-14,48,DPD30-59,11,11,0
2024-02-14,48,DPD60-89,0,0,0
2024-02-14,48,DPD90+,0,0,0
2024-02-14,6,Current,0,0,0
2024-02-13,100,Current,0,0,0
2024-02-13,100,DPD15-29,1,1,0
2024-02-13,100,DPD3-14,0,0,0
2024-02-13,102,Current,0,0,0
2024-02-13,102,DPD15-29,0,0,0
2024-02-13,102,DPD3-14,0,0,0
2024-02-13,102,DPD30-59,0,0,0
2024-02-13,104,Current,0,0,0
2024-02-13,104,DPD30-59,0,0,0
2024-02-13,104,DPD60-89,0,0,0
2024-02-13,104,DPD90+,0,0,0
2024-02-13,20,Current,85,85,0
2024-02-13,20,DPD15-29,303,303,0
2024-02-13,20,DPD3-14,234,234,0
2024-02-13,20,DPD30-59,25,25,0
2024-02-13,20,DPD60-89,46,46,0
2024-02-13,20,DPD90+,82,82,0
2024-02-13,22,Current,0,0,0
2024-02-13,22,DPD15-29,2,2,0
2024-02-13,22,DPD3-14,0,0,0
2024-02-13,22,DPD30-59,1,1,0
2024-02-13,22,DPD60-89,0,0,0
2024-02-13,24,Current,80,80,0
2024-02-13,24,DPD15-29,156,156,0
2024-02-13,24,DPD3-14,125,125,0
2024-02-13,24,DPD30-59,18,18,0
2024-02-13,24,DPD60-89,0,0,0
2024-02-13,24,DPD90+,0,0,0
2024-02-13,26,Current,0,0,0
2024-02-13,26,DPD15-29,22,22,0
2024-02-13,26,DPD3-14,18,18,0
2024-02-13,26,DPD30-59,0,0,0
2024-02-13,26,DPD60-89,0,0,0
2024-02-13,26,DPD90+,0,0,0
2024-02-13,32,Current,0,0,0
2024-02-13,32,DPD15-29,141,141,0
2024-02-13,32,DPD3-14,112,112,0
2024-02-13,32,DPD30-59,14,14,0
2024-02-13,32,DPD60-89,0,0,0
2024-02-13,32,DPD90+,0,0,0
2024-02-13,34,Current,0,0,0
2024-02-13,34,DPD15-29,51,51,0
2024-02-13,34,DPD3-14,33,33,0
2024-02-13,34,DPD30-59,10,10,0
2024-02-13,34,DPD60-89,0,0,0
2024-02-13,34,DPD90+,0,0,0
2024-02-13,36,Current,0,0,0
2024-02-13,36,DPD15-29,54,54,0
2024-02-13,36,DPD3-14,28,28,0
2024-02-13,36,DPD30-59,4,4,0
2024-02-13,36,DPD60-89,0,0,0
2024-02-13,36,DPD90+,0,0,0
2024-02-13,38,Current,0,0,0
2024-02-13,38,DPD15-29,37,37,0
2024-02-13,38,DPD3-14,28,28,0
2024-02-13,38,DPD30-59,2,2,0
2024-02-13,38,DPD60-89,0,0,0
2024-02-13,38,DPD90+,0,0,0
2024-02-13,40,Current,0,0,0
2024-02-13,40,DPD15-29,16,16,0
2024-02-13,40,DPD3-14,27,27,0
2024-02-13,40,DPD30-59,1,1,0
2024-02-13,40,DPD60-89,0,0,0
2024-02-13,40,DPD90+,0,0,0
2024-02-13,42,Current,0,0,0
2024-02-13,42,DPD15-29,12,12,0
2024-02-13,42,DPD3-14,11,11,0
2024-02-13,42,DPD30-59,1,1,0
2024-02-13,42,DPD60-89,0,0,0
2024-02-13,42,DPD90+,0,0,0
2024-02-13,44,Current,0,0,0
2024-02-13,44,DPD15-29,25,25,0
2024-02-13,44,DPD3-14,31,31,0
2024-02-13,44,DPD30-59,2,2,0
2024-02-13,44,DPD60-89,0,0,0
2024-02-13,44,DPD90+,0,0,0
2024-02-13,46,Current,0,0,0
2024-02-13,46,DPD3-14,0,0,0
2024-02-13,46,DPD60-89,0,0,0
2024-02-13,48,Current,97,97,0
2024-02-13,48,DPD15-29,5,5,0
2024-02-13,48,DPD3-14,24,24,0
2024-02-13,48,DPD30-59,1,1,0
2024-02-13,48,DPD60-89,0,0,0
2024-02-13,48,DPD90+,0,0,0
2024-02-13,6,Current,0,0,0
2024-02-12,100,Current,0,0,0
2024-02-12,100,DPD15-29,0,0,0
2024-02-12,100,DPD3-14,0,0,0
2024-02-12,102,Current,0,0,0
2024-02-12,102,DPD15-29,0,0,0
2024-02-12,102,DPD3-14,1,1,0
2024-02-12,102,DPD30-59,1,1,0
2024-02-12,104,Current,0,0,0
2024-02-12,104,DPD30-59,0,0,0
2024-02-12,104,DPD60-89,0,0,0
2024-02-12,104,DPD90+,0,0,0
2024-02-12,20,Current,114,114,0
2024-02-12,20,DPD15-29,251,251,0
2024-02-12,20,DPD3-14,336,336,0
2024-02-12,20,DPD30-59,163,163,0
2024-02-12,20,DPD60-89,42,42,0
2024-02-12,20,DPD90+,21,21,0
2024-02-12,22,Current,0,0,0
2024-02-12,22,DPD15-29,1,1,0
2024-02-12,22,DPD3-14,0,0,0
2024-02-12,22,DPD30-59,0,0,0
2024-02-12,22,DPD60-89,0,0,0
2024-02-12,24,Current,235,235,0
2024-02-12,24,DPD15-29,118,118,0
2024-02-12,24,DPD3-14,193,193,0
2024-02-12,24,DPD30-59,76,76,0
2024-02-12,24,DPD60-89,0,0,0
2024-02-12,24,DPD90+,0,0,0
2024-02-12,26,Current,0,0,0
2024-02-12,26,DPD15-29,30,30,0
2024-02-12,26,DPD3-14,30,30,0
2024-02-12,26,DPD30-59,15,15,0
2024-02-12,26,DPD60-89,0,0,0
2024-02-12,26,DPD90+,0,0,0
2024-02-12,32,Current,0,0,0
2024-02-12,32,DPD15-29,153,153,0
2024-02-12,32,DPD3-14,130,130,0
2024-02-12,32,DPD30-59,81,81,0
2024-02-12,32,DPD60-89,0,0,0
2024-02-12,32,DPD90+,0,0,0
2024-02-12,34,Current,0,0,0
2024-02-12,34,DPD15-29,72,72,0
2024-02-12,34,DPD3-14,65,65,0
2024-02-12,34,DPD30-59,36,36,0
2024-02-12,34,DPD60-89,0,0,0
2024-02-12,34,DPD90+,0,0,0
2024-02-12,36,Current,0,0,0
2024-02-12,36,DPD15-29,48,48,0
2024-02-12,36,DPD3-14,52,52,0
2024-02-12,36,DPD30-59,24,24,0
2024-02-12,36,DPD60-89,0,0,0
2024-02-12,36,DPD90+,0,0,0
2024-02-12,38,Current,0,0,0
2024-02-12,38,DPD15-29,36,36,0
2024-02-12,38,DPD3-14,47,47,0
2024-02-12,38,DPD30-59,13,13,0
2024-02-12,38,DPD60-89,0,0,0
2024-02-12,38,DPD90+,0,0,0
2024-02-12,40,Current,0,0,0
2024-02-12,40,DPD15-29,21,21,0
2024-02-12,40,DPD3-14,27,27,0
2024-02-12,40,DPD30-59,10,10,0
2024-02-12,40,DPD60-89,0,0,0
2024-02-12,40,DPD90+,0,0,0
2024-02-12,42,Current,0,0,0
2024-02-12,42,DPD15-29,12,12,0
2024-02-12,42,DPD3-14,17,17,0
2024-02-12,42,DPD30-59,12,12,0
2024-02-12,42,DPD60-89,0,0,0
2024-02-12,42,DPD90+,0,0,0
2024-02-12,44,Current,0,0,0
2024-02-12,44,DPD15-29,33,33,0
2024-02-12,44,DPD3-14,57,57,0
2024-02-12,44,DPD30-59,15,15,0
2024-02-12,44,DPD60-89,0,0,0
2024-02-12,44,DPD90+,0,0,0
2024-02-12,46,Current,0,0,0
2024-02-12,46,DPD3-14,1,1,0
2024-02-12,46,DPD60-89,0,0,0
2024-02-12,48,Current,224,224,0
2024-02-12,48,DPD15-29,14,14,0
2024-02-12,48,DPD3-14,33,33,0
2024-02-12,48,DPD30-59,9,9,0
2024-02-12,48,DPD60-89,0,0,0
2024-02-12,48,DPD90+,0,0,0
2024-02-12,6,Current,0,0,0
2024-02-11,100,Current,0,0,0
2024-02-11,100,DPD15-29,0,0,0
2024-02-11,100,DPD3-14,2,2,0
2024-02-11,102,Current,0,0,0
2024-02-11,102,DPD15-29,0,0,0
2024-02-11,102,DPD3-14,0,0,0
2024-02-11,102,DPD30-59,0,0,0
2024-02-11,104,Current,0,0,0
2024-02-11,104,DPD30-59,0,0,0
2024-02-11,104,DPD60-89,0,0,0
2024-02-11,104,DPD90+,0,0,0
2024-02-11,20,Current,4,4,0
2024-02-11,20,DPD15-29,198,198,0
2024-02-11,20,DPD3-14,325,325,0
2024-02-11,20,DPD30-59,104,104,0
2024-02-11,20,DPD60-89,81,81,0
2024-02-11,20,DPD90+,56,56,0
2024-02-11,22,Current,0,0,0
2024-02-11,22,DPD15-29,0,0,0
2024-02-11,22,DPD3-14,2,2,0
2024-02-11,22,DPD30-59,0,0,0
2024-02-11,22,DPD60-89,0,0,0
2024-02-11,24,Current,77,77,0
2024-02-11,24,DPD15-29,111,111,0
2024-02-11,24,DPD3-14,175,175,0
2024-02-11,24,DPD30-59,37,37,0
2024-02-11,24,DPD60-89,0,0,0
2024-02-11,24,DPD90+,0,0,0
2024-02-11,26,Current,0,0,0
2024-02-11,26,DPD15-29,17,17,0
2024-02-11,26,DPD3-14,24,24,0
2024-02-11,26,DPD30-59,2,2,0
2024-02-11,26,DPD60-89,0,0,0
2024-02-11,26,DPD90+,0,0,0
2024-02-11,32,Current,0,0,0
2024-02-11,32,DPD15-29,79,79,0
2024-02-11,32,DPD3-14,158,158,0
2024-02-11,32,DPD30-59,49,49,0
2024-02-11,32,DPD60-89,0,0,0
2024-02-11,32,DPD90+,0,0,0
2024-02-11,34,Current,0,0,0
2024-02-11,34,DPD15-29,32,32,0
2024-02-11,34,DPD3-14,55,55,0
2024-02-11,34,DPD30-59,21,21,0
2024-02-11,34,DPD60-89,0,0,0
2024-02-11,34,DPD90+,0,0,0
2024-02-11,36,Current,0,0,0
2024-02-11,36,DPD15-29,35,35,0
2024-02-11,36,DPD3-14,50,50,0
2024-02-11,36,DPD30-59,13,13,0
2024-02-11,36,DPD60-89,0,0,0
2024-02-11,36,DPD90+,0,0,0
2024-02-11,38,Current,0,0,0
2024-02-11,38,DPD15-29,23,23,0
2024-02-11,38,DPD3-14,36,36,0
2024-02-11,38,DPD30-59,11,11,0
2024-02-11,38,DPD60-89,0,0,0
2024-02-11,38,DPD90+,0,0,0
2024-02-11,40,Current,0,0,0
2024-02-11,40,DPD15-29,13,13,0
2024-02-11,40,DPD3-14,31,31,0
2024-02-11,40,DPD30-59,5,5,0
2024-02-11,40,DPD60-89,0,0,0
2024-02-11,40,DPD90+,0,0,0
2024-02-11,42,Current,0,0,0
2024-02-11,42,DPD15-29,6,6,0
2024-02-11,42,DPD3-14,15,15,0
2024-02-11,42,DPD30-59,6,6,0
2024-02-11,42,DPD60-89,0,0,0
2024-02-11,42,DPD90+,0,0,0
2024-02-11,44,Current,0,0,0
2024-02-11,44,DPD15-29,19,19,0
2024-02-11,44,DPD3-14,26,26,0
2024-02-11,44,DPD30-59,11,11,0
2024-02-11,44,DPD60-89,0,0,0
2024-02-11,44,DPD90+,0,0,0
2024-02-11,46,Current,0,0,0
2024-02-11,46,DPD3-14,0,0,0
2024-02-11,46,DPD60-89,0,0,0
2024-02-11,48,Current,104,104,0
2024-02-11,48,DPD15-29,2,2,0
2024-02-11,48,DPD3-14,23,23,0
2024-02-11,48,DPD30-59,7,7,0
2024-02-11,48,DPD60-89,0,0,0
2024-02-11,48,DPD90+,0,0,0
2024-02-11,6,Current,0,0,0
2024-02-10,100,Current,0,0,0
2024-02-10,100,DPD15-29,0,0,0
2024-02-10,100,DPD3-14,0,0,0
2024-02-10,102,Current,0,0,0
2024-02-10,102,DPD15-29,0,0,0
2024-02-10,102,DPD3-14,0,0,0
2024-02-10,102,DPD30-59,1,1,0
2024-02-10,104,Current,0,0,0
2024-02-10,104,DPD30-59,0,0,0
2024-02-10,104,DPD60-89,0,0,0
2024-02-10,104,DPD90+,0,0,0
2024-02-10,20,Current,7,7,0
2024-02-10,20,DPD15-29,211,211,0
2024-02-10,20,DPD3-14,243,243,0
2024-02-10,20,DPD30-59,163,163,0
2024-02-10,20,DPD60-89,70,70,0
2024-02-10,20,DPD90+,22,22,0
2024-02-10,22,Current,0,0,0
2024-02-10,22,DPD15-29,1,1,0
2024-02-10,22,DPD3-14,0,0,0
2024-02-10,22,DPD30-59,0,0,0
2024-02-10,22,DPD60-89,0,0,0
2024-02-10,24,Current,86,86,0
2024-02-10,24,DPD15-29,102,102,0
2024-02-10,24,DPD3-14,126,126,0
2024-02-10,24,DPD30-59,86,86,0
2024-02-10,24,DPD60-89,0,0,0
2024-02-10,24,DPD90+,0,0,0
2024-02-10,26,Current,0,0,0
2024-02-10,26,DPD15-29,30,30,0
2024-02-10,26,DPD3-14,18,18,0
2024-02-10,26,DPD30-59,8,8,0
2024-02-10,26,DPD60-89,0,0,0
2024-02-10,26,DPD90+,0,0,0
2024-02-10,32,Current,0,0,0
2024-02-10,32,DPD15-29,141,141,0
2024-02-10,32,DPD3-14,94,94,0
2024-02-10,32,DPD30-59,81,81,0
2024-02-10,32,DPD60-89,0,0,0
2024-02-10,32,DPD90+,0,0,0
2024-02-10,34,Current,0,0,0
2024-02-10,34,DPD15-29,65,65,0
2024-02-10,34,DPD3-14,48,48,0
2024-02-10,34,DPD30-59,31,31,0
2024-02-10,34,DPD60-89,0,0,0
2024-02-10,34,DPD90+,0,0,0
2024-02-10,36,Current,0,0,0
2024-02-10,36,DPD15-29,45,45,0
2024-02-10,36,DPD3-14,34,34,0
2024-02-10,36,DPD30-59,24,24,0
2024-02-10,36,DPD60-89,0,0,0
2024-02-10,36,DPD90+,0,0,0
2024-02-10,38,Current,0,0,0
2024-02-10,38,DPD15-29,32,32,0
2024-02-10,38,DPD3-14,25,25,0
2024-02-10,38,DPD30-59,17,17,0
2024-02-10,38,DPD60-89,0,0,0
2024-02-10,38,DPD90+,0,0,0
2024-02-10,40,Current,0,0,0
2024-02-10,40,DPD15-29,18,18,0
2024-02-10,40,DPD3-14,23,23,0
2024-02-10,40,DPD30-59,7,7,0
2024-02-10,40,DPD60-89,0,0,0
2024-02-10,40,DPD90+,0,0,0
2024-02-10,42,Current,0,0,0
2024-02-10,42,DPD15-29,11,11,0
2024-02-10,42,DPD3-14,11,11,0
2024-02-10,42,DPD30-59,6,6,0
2024-02-10,42,DPD60-89,0,0,0
2024-02-10,42,DPD90+,0,0,0
2024-02-10,44,Current,0,0,0
2024-02-10,44,DPD15-29,35,35,0
2024-02-10,44,DPD3-14,29,29,0
2024-02-10,44,DPD30-59,24,24,0
2024-02-10,44,DPD60-89,0,0,0
2024-02-10,44,DPD90+,0,0,0
2024-02-10,46,Current,0,0,0
2024-02-10,46,DPD3-14,0,0,0
2024-02-10,46,DPD60-89,0,0,0
2024-02-10,48,Current,95,95,0
2024-02-10,48,DPD15-29,12,12,0
2024-02-10,48,DPD3-14,20,20,0
2024-02-10,48,DPD30-59,10,10,0
2024-02-10,48,DPD60-89,0,0,0
2024-02-10,48,DPD90+,0,0,0
2024-02-10,6,Current,0,0,0
2024-02-09,100,Current,0,0,0
2024-02-09,100,DPD3-14,2,2,0
2024-02-09,102,Current,0,0,0
2024-02-09,102,DPD15-29,0,0,0
2024-02-09,102,DPD3-14,0,0,0
2024-02-09,102,DPD30-59,1,1,0
2024-02-09,104,Current,0,0,0
2024-02-09,104,DPD30-59,0,0,0
2024-02-09,104,DPD60-89,0,0,0
2024-02-09,104,DPD90+,0,0,0
2024-02-09,20,Current,251,251,0
2024-02-09,20,DPD15-29,225,225,0
2024-02-09,20,DPD3-14,383,383,0
2024-02-09,20,DPD30-59,154,154,0
2024-02-09,20,DPD60-89,11,11,0
2024-02-09,20,DPD90+,2,2,0
2024-02-09,22,Current,0,0,0
2024-02-09,22,DPD15-29,0,0,0
2024-02-09,22,DPD3-14,2,2,0
2024-02-09,22,DPD30-59,1,1,0
2024-02-09,22,DPD60-89,0,0,0
2024-02-09,24,Current,247,247,0
2024-02-09,24,DPD15-29,127,127,0
2024-02-09,24,DPD3-14,200,200,0
2024-02-09,24,DPD30-59,69,69,0
2024-02-09,24,DPD60-89,0,0,0
2024-02-09,24,DPD90+,0,0,0
2024-02-09,26,Current,20,20,0
2024-02-09,26,DPD15-29,19,19,0
2024-02-09,26,DPD3-14,30,30,0
2024-02-09,26,DPD30-59,11,11,0
2024-02-09,26,DPD60-89,0,0,0
2024-02-09,26,DPD90+,0,0,0
2024-02-09,32,Current,85,85,0
2024-02-09,32,DPD15-29,92,92,0
2024-02-09,32,DPD3-14,176,176,0
2024-02-09,32,DPD30-59,80,80,0
2024-02-09,32,DPD60-89,0,0,0
2024-02-09,32,DPD90+,0,0,0
2024-02-09,34,Current,38,38,0
2024-02-09,34,DPD15-29,35,35,0
2024-02-09,34,DPD3-14,62,62,0
2024-02-09,34,DPD30-59,32,32,0
2024-02-09,34,DPD60-89,0,0,0
2024-02-09,34,DPD90+,0,0,0
2024-02-09,36,Current,33,33,0
2024-02-09,36,DPD15-29,38,38,0
2024-02-09,36,DPD3-14,59,59,0
2024-02-09,36,DPD30-59,25,25,0
2024-02-09,36,DPD60-89,0,0,0
2024-02-09,36,DPD90+,0,0,0
2024-02-09,38,Current,29,29,0
2024-02-09,38,DPD15-29,25,25,0
2024-02-09,38,DPD3-14,39,39,0
2024-02-09,38,DPD30-59,12,12,0
2024-02-09,38,DPD60-89,0,0,0
2024-02-09,38,DPD90+,0,0,0
2024-02-09,40,Current,22,22,0
2024-02-09,40,DPD15-29,15,15,0
2024-02-09,40,DPD3-14,34,34,0
2024-02-09,40,DPD30-59,9,9,0
2024-02-09,40,DPD60-89,0,0,0
2024-02-09,40,DPD90+,0,0,0
2024-02-09,42,Current,17,17,0
2024-02-09,42,DPD15-29,7,7,0
2024-02-09,42,DPD3-14,18,18,0
2024-02-09,42,DPD30-59,10,10,0
2024-02-09,42,DPD60-89,0,0,0
2024-02-09,42,DPD90+,0,0,0
2024-02-09,44,Current,43,43,0
2024-02-09,44,DPD15-29,25,25,0
2024-02-09,44,DPD3-14,28,28,0
2024-02-09,44,DPD30-59,13,13,0
2024-02-09,44,DPD60-89,0,0,0
2024-02-09,44,DPD90+,0,0,0
2024-02-09,46,Current,1,1,0
2024-02-09,46,DPD60-89,0,0,0
2024-02-09,48,Current,104,104,0
2024-02-09,48,DPD15-29,5,5,0
2024-02-09,48,DPD3-14,24,24,0
2024-02-09,48,DPD30-59,7,7,0
2024-02-09,48,DPD60-89,0,0,0
2024-02-09,48,DPD90+,0,0,0
2024-02-09,6,Current,0,0,0
2024-02-08,100,Current,0,0,0
2024-02-08,100,DPD3-14,0,0,0
2024-02-08,102,Current,0,0,0
2024-02-08,102,DPD15-29,0,0,0
2024-02-08,102,DPD30-59,0,0,0
2024-02-08,104,Current,0,0,0
2024-02-08,104,DPD30-59,0,0,0
2024-02-08,104,DPD60-89,0,0,0
2024-02-08,104,DPD90+,0,0,0
2024-02-08,20,Current,0,0,0
2024-02-08,20,DPD15-29,228,228,0
2024-02-08,20,DPD3-14,257,257,0
2024-02-08,20,DPD30-59,87,87,0
2024-02-08,20,DPD60-89,118,118,0
2024-02-08,20,DPD90+,106,106,0
2024-02-08,22,Current,0,0,0
2024-02-08,22,DPD15-29,1,1,0
2024-02-08,22,DPD3-14,0,0,0
2024-02-08,22,DPD30-59,0,0,0
2024-02-08,22,DPD60-89,0,0,0
2024-02-08,24,Current,24,24,0
2024-02-08,24,DPD15-29,115,115,0
2024-02-08,24,DPD3-14,135,135,0
2024-02-08,24,DPD30-59,35,35,0
2024-02-08,24,DPD60-89,0,0,0
2024-02-08,24,DPD90+,0,0,0
2024-02-08,26,Current,0,0,0
2024-02-08,26,DPD15-29,32,32,0
2024-02-08,26,DPD3-14,17,17,0
2024-02-08,26,DPD30-59,2,2,0
2024-02-08,26,DPD60-89,0,0,0
2024-02-08,26,DPD90+,0,0,0
2024-02-08,32,Current,0,0,0
2024-02-08,32,DPD15-29,150,150,0
2024-02-08,32,DPD3-14,106,106,0
2024-02-08,32,DPD30-59,49,49,0
2024-02-08,32,DPD60-89,0,0,0
2024-02-08,32,DPD90+,0,0,0
2024-02-08,34,Current,0,0,0
2024-02-08,34,DPD15-29,67,67,0
2024-02-08,34,DPD3-14,52,52,0
2024-02-08,34,DPD30-59,21,21,0
2024-02-08,34,DPD60-89,0,0,0
2024-02-08,34,DPD90+,0,0,0
2024-02-08,36,Current,0,0,0
2024-02-08,36,DPD15-29,49,49,0
2024-02-08,36,DPD3-14,35,35,0
2024-02-08,36,DPD30-59,12,12,0
2024-02-08,36,DPD60-89,0,0,0
2024-02-08,36,DPD90+,0,0,0
2024-02-08,38,Current,0,0,0
2024-02-08,38,DPD15-29,38,38,0
2024-02-08,38,DPD3-14,26,26,0
2024-02-08,38,DPD30-59,13,13,0
2024-02-08,38,DPD60-89,0,0,0
2024-02-08,38,DPD90+,0,0,0
2024-02-08,40,Current,0,0,0
2024-02-08,40,DPD15-29,21,21,0
2024-02-08,40,DPD3-14,23,23,0
2024-02-08,40,DPD30-59,3,3,0
2024-02-08,40,DPD60-89,0,0,0
2024-02-08,40,DPD90+,0,0,0
2024-02-08,42,Current,0,0,0
2024-02-08,42,DPD15-29,12,12,0
2024-02-08,42,DPD3-14,11,11,0
2024-02-08,42,DPD30-59,2,2,0
2024-02-08,42,DPD60-89,0,0,0
2024-02-08,42,DPD90+,0,0,0
2024-02-08,44,Current,0,0,0
2024-02-08,44,DPD15-29,38,38,0
2024-02-08,44,DPD3-14,31,31,0
2024-02-08,44,DPD30-59,9,9,0
2024-02-08,44,DPD60-89,0,0,0
2024-02-08,44,DPD90+,0,0,0
2024-02-08,46,Current,0,0,0
2024-02-08,46,DPD60-89,0,0,0
2024-02-08,48,Current,23,23,0
2024-02-08,48,DPD15-29,15,15,0
2024-02-08,48,DPD3-14,22,22,0
2024-02-08,48,DPD30-59,6,6,0
2024-02-08,48,DPD60-89,0,0,0
2024-02-08,48,DPD90+,0,0,0
2024-02-08,6,Current,0,0,0
2024-02-07,100,Current,0,0,0
2024-02-07,100,DPD3-14,2,2,0
2024-02-07,102,Current,0,0,0
2024-02-07,102,DPD15-29,0,0,0
2024-02-07,102,DPD30-59,0,0,0
2024-02-07,104,Current,0,0,0
2024-02-07,104,DPD30-59,0,0,0
2024-02-07,104,DPD60-89,0,0,0
2024-02-07,104,DPD90+,0,0,0
2024-02-07,20,Current,3,3,0
2024-02-07,20,DPD15-29,225,225,0
2024-02-07,20,DPD3-14,379,379,0
2024-02-07,20,DPD30-59,24,24,0
2024-02-07,20,DPD60-89,23,23,0
2024-02-07,20,DPD90+,30,30,0
2024-02-07,22,Current,0,0,0
2024-02-07,22,DPD15-29,1,1,0
2024-02-07,22,DPD3-14,2,2,0
2024-02-07,22,DPD30-59,0,0,0
2024-02-07,22,DPD60-89,0,0,0
2024-02-07,24,Current,63,63,0
2024-02-07,24,DPD15-29,133,133,0
2024-02-07,24,DPD3-14,213,213,0
2024-02-07,24,DPD30-59,12,12,0
2024-02-07,24,DPD60-89,0,0,0
2024-02-07,24,DPD90+,0,0,0
2024-02-07,26,Current,0,0,0
2024-02-07,26,DPD15-29,16,16,0
2024-02-07,26,DPD3-14,31,31,0
2024-02-07,26,DPD30-59,2,2,0
2024-02-07,26,DPD60-89,0,0,0
2024-02-07,26,DPD90+,0,0,0
2024-02-07,32,Current,0,0,0
2024-02-07,32,DPD15-29,97,97,0
2024-02-07,32,DPD3-14,181,181,0
2024-02-07,32,DPD30-59,9,9,0
2024-02-07,32,DPD60-89,0,0,0
2024-02-07,32,DPD90+,0,0,0
2024-02-07,34,Current,0,0,0
2024-02-07,34,DPD15-29,44,44,0
2024-02-07,34,DPD3-14,63,63,0
2024-02-07,34,DPD30-59,6,6,0
2024-02-07,34,DPD60-89,0,0,0
2024-02-07,34,DPD90+,0,0,0
2024-02-07,36,Current,0,0,0
2024-02-07,36,DPD15-29,31,31,0
2024-02-07,36,DPD3-14,64,64,0
2024-02-07,36,DPD30-59,4,4,0
2024-02-07,36,DPD60-89,0,0,0
2024-02-07,36,DPD90+,0,0,0
2024-02-07,38,Current,0,0,0
2024-02-07,38,DPD15-29,23,23,0
2024-02-07,38,DPD3-14,48,48,0
2024-02-07,38,DPD30-59,4,4,0
2024-02-07,38,DPD60-89,0,0,0
2024-02-07,38,DPD90+,0,0,0
2024-02-07,40,Current,0,0,0
2024-02-07,40,DPD15-29,18,18,0
2024-02-07,40,DPD3-14,35,35,0
2024-02-07,40,DPD30-59,1,1,0
2024-02-07,40,DPD60-89,0,0,0
2024-02-07,40,DPD90+,0,0,0
2024-02-07,42,Current,0,0,0
2024-02-07,42,DPD15-29,7,7,0
2024-02-07,42,DPD3-14,22,22,0
2024-02-07,42,DPD30-59,3,3,0
2024-02-07,42,DPD60-89,0,0,0
2024-02-07,42,DPD90+,0,0,0
2024-02-07,44,Current,0,0,0
2024-02-07,44,DPD15-29,25,25,0
2024-02-07,44,DPD3-14,32,32,0
2024-02-07,44,DPD30-59,6,6,0
2024-02-07,44,DPD60-89,0,0,0
2024-02-07,44,DPD90+,0,0,0
2024-02-07,46,Current,0,0,0
2024-02-07,46,DPD60-89,0,0,0
2024-02-07,48,Current,35,35,0
2024-02-07,48,DPD15-29,6,6,0
2024-02-07,48,DPD3-14,23,23,0
2024-02-07,48,DPD30-59,3,3,0
2024-02-07,48,DPD60-89,0,0,0
2024-02-07,48,DPD90+,0,0,0
2024-02-07,6,Current,0,0,0
2024-02-06,100,Current,0,0,0
2024-02-06,100,DPD3-14,0,0,0
2024-02-06,102,Current,0,0,0
2024-02-06,102,DPD15-29,0,0,0
2024-02-06,102,DPD30-59,1,1,0
2024-02-06,104,Current,0,0,0
2024-02-06,104,DPD30-59,0,0,0
2024-02-06,104,DPD60-89,0,0,0
2024-02-06,104,DPD90+,0,0,0
2024-02-06,20,Current,17,17,0
2024-02-06,20,DPD15-29,229,229,0
2024-02-06,20,DPD3-14,267,267,0
2024-02-06,20,DPD30-59,178,178,0
2024-02-06,20,DPD60-89,38,38,0
2024-02-06,20,DPD90+,0,0,0
2024-02-06,22,Current,0,0,0
2024-02-06,22,DPD15-29,1,1,0
2024-02-06,22,DPD3-14,0,0,0
2024-02-06,22,DPD30-59,0,0,0
2024-02-06,22,DPD60-89,0,0,0
2024-02-06,24,Current,62,62,0
2024-02-06,24,DPD15-29,103,103,0
2024-02-06,24,DPD3-14,131,131,0
2024-02-06,24,DPD30-59,99,99,0
2024-02-06,24,DPD60-89,0,0,0
2024-02-06,24,DPD90+,0,0,0
2024-02-06,26,Current,0,0,0
2024-02-06,26,DPD15-29,29,29,0
2024-02-06,26,DPD3-14,19,19,0
2024-02-06,26,DPD30-59,11,11,0
2024-02-06,26,DPD60-89,0,0,0
2024-02-06,26,DPD90+,0,0,0
2024-02-06,32,Current,0,0,0
2024-02-06,32,DPD15-29,154,154,0
2024-02-06,32,DPD3-14,121,121,0
2024-02-06,32,DPD30-59,96,96,0
2024-02-06,32,DPD60-89,0,0,0
2024-02-06,32,DPD90+,0,0,0
2024-02-06,34,Current,0,0,0
2024-02-06,34,DPD15-29,67,67,0
2024-02-06,34,DPD3-14,58,58,0
2024-02-06,34,DPD30-59,38,38,0
2024-02-06,34,DPD60-89,0,0,0
2024-02-06,34,DPD90+,0,0,0
2024-02-06,36,Current,0,0,0
2024-02-06,36,DPD15-29,55,55,0
2024-02-06,36,DPD3-14,37,37,0
2024-02-06,36,DPD30-59,25,25,0
2024-02-06,36,DPD60-89,0,0,0
2024-02-06,36,DPD90+,0,0,0
2024-02-06,38,Current,0,0,0
2024-02-06,38,DPD15-29,39,39,0
2024-02-06,38,DPD3-14,36,36,0
2024-02-06,38,DPD30-59,18,18,0
2024-02-06,38,DPD60-89,0,0,0
2024-02-06,38,DPD90+,0,0,0
2024-02-06,40,Current,0,0,0
2024-02-06,40,DPD15-29,22,22,0
2024-02-06,40,DPD3-14,24,24,0
2024-02-06,40,DPD30-59,11,11,0
2024-02-06,40,DPD60-89,0,0,0
2024-02-06,40,DPD90+,0,0,0
2024-02-06,42,Current,0,0,0
2024-02-06,42,DPD15-29,10,10,0
2024-02-06,42,DPD3-14,14,14,0
2024-02-06,42,DPD30-59,8,8,0
2024-02-06,42,DPD60-89,0,0,0
2024-02-06,42,DPD90+,0,0,0
2024-02-06,44,Current,0,0,0
2024-02-06,44,DPD15-29,30,30,0
2024-02-06,44,DPD3-14,41,41,0
2024-02-06,44,DPD30-59,24,24,0
2024-02-06,44,DPD60-89,0,0,0
2024-02-06,44,DPD90+,0,0,0
2024-02-06,46,Current,0,0,0
2024-02-06,46,DPD60-89,0,0,0
2024-02-06,48,Current,55,55,0
2024-02-06,48,DPD15-29,19,19,0
2024-02-06,48,DPD3-14,14,14,0
2024-02-06,48,DPD30-59,15,15,0
2024-02-06,48,DPD60-89,0,0,0
2024-02-06,48,DPD90+,0,0,0
2024-02-06,6,Current,0,0,0
2024-02-05,100,Current,0,0,0
2024-02-05,100,DPD3-14,1,1,0
2024-02-05,102,Current,0,0,0
2024-02-05,102,DPD15-29,0,0,0
2024-02-05,102,DPD30-59,1,1,0
2024-02-05,104,Current,0,0,0
2024-02-05,104,DPD30-59,0,0,0
2024-02-05,104,DPD60-89,0,0,0
2024-02-05,104,DPD90+,0,0,0
2024-02-05,20,Current,243,243,0
2024-02-05,20,DPD15-29,214,214,0
2024-02-05,20,DPD3-14,503,503,0
2024-02-05,20,DPD30-59,186,186,0
2024-02-05,20,DPD60-89,54,54,0
2024-02-05,20,DPD90+,87,87,0
2024-02-05,22,Current,0,0,0
2024-02-05,22,DPD15-29,0,0,0
2024-02-05,22,DPD3-14,4,4,0
2024-02-05,22,DPD30-59,1,1,0
2024-02-05,22,DPD60-89,0,0,0
2024-02-05,24,Current,192,192,0
2024-02-05,24,DPD15-29,142,142,0
2024-02-05,24,DPD3-14,283,283,0
2024-02-05,24,DPD30-59,79,79,0
2024-02-05,24,DPD60-89,0,0,0
2024-02-05,24,DPD90+,0,0,0
2024-02-05,26,Current,0,0,0
2024-02-05,26,DPD15-29,13,13,0
2024-02-05,26,DPD3-14,45,45,0
2024-02-05,26,DPD30-59,13,13,0
2024-02-05,26,DPD60-89,0,0,0
2024-02-05,26,DPD90+,0,0,0
2024-02-05,32,Current,0,0,0
2024-02-05,32,DPD15-29,106,106,0
2024-02-05,32,DPD3-14,211,211,0
2024-02-05,32,DPD30-59,77,77,0
2024-02-05,32,DPD60-89,0,0,0
2024-02-05,32,DPD90+,0,0,0
2024-02-05,34,Current,0,0,0
2024-02-05,34,DPD15-29,41,41,0
2024-02-05,34,DPD3-14,81,81,0
2024-02-05,34,DPD30-59,30,30,0
2024-02-05,34,DPD60-89,0,0,0
2024-02-05,34,DPD90+,0,0,0
2024-02-05,36,Current,0,0,0
2024-02-05,36,DPD15-29,28,28,0
2024-02-05,36,DPD3-14,79,79,0
2024-02-05,36,DPD30-59,30,30,0
2024-02-05,36,DPD60-89,0,0,0
2024-02-05,36,DPD90+,0,0,0
2024-02-05,38,Current,0,0,0
2024-02-05,38,DPD15-29,24,24,0
2024-02-05,38,DPD3-14,75,75,0
2024-02-05,38,DPD30-59,13,13,0
2024-02-05,38,DPD60-89,0,0,0
2024-02-05,38,DPD90+,0,0,0
2024-02-05,40,Current,0,0,0
2024-02-05,40,DPD15-29,19,19,0
2024-02-05,40,DPD3-14,45,45,0
2024-02-05,40,DPD30-59,14,14,0
2024-02-05,40,DPD60-89,0,0,0
2024-02-05,40,DPD90+,0,0,0
2024-02-05,42,Current,0,0,0
2024-02-05,42,DPD15-29,7,7,0
2024-02-05,42,DPD3-14,29,29,0
2024-02-05,42,DPD30-59,11,11,0
2024-02-05,42,DPD60-89,0,0,0
2024-02-05,42,DPD90+,0,0,0
2024-02-05,44,Current,0,0,0
2024-02-05,44,DPD15-29,32,32,0
2024-02-05,44,DPD3-14,50,50,0
2024-02-05,44,DPD30-59,17,17,0
2024-02-05,44,DPD60-89,0,0,0
2024-02-05,44,DPD90+,0,0,0
2024-02-05,46,Current,0,0,0
2024-02-05,46,DPD3-14,1,1,0
2024-02-05,46,DPD60-89,0,0,0
2024-02-05,48,Current,240,240,0
2024-02-05,48,DPD15-29,10,10,0
2024-02-05,48,DPD3-14,26,26,0
2024-02-05,48,DPD30-59,11,11,0
2024-02-05,48,DPD60-89,0,0,0
2024-02-05,48,DPD90+,0,0,0
2024-02-05,6,Current,0,0,0
2024-02-04,100,Current,0,0,0
2024-02-04,100,DPD3-14,0,0,0
2024-02-04,102,Current,0,0,0
2024-02-04,102,DPD15-29,0,0,0
2024-02-04,102,DPD3-14,0,0,0
2024-02-04,102,DPD30-59,0,0,0
2024-02-04,104,Current,0,0,0
2024-02-04,104,DPD30-59,0,0,0
2024-02-04,104,DPD60-89,0,0,0
2024-02-04,104,DPD90+,0,0,0
2024-02-04,20,Current,39,39,0
2024-02-04,20,DPD15-29,199,199,0
2024-02-04,20,DPD3-14,227,227,0
2024-02-04,20,DPD30-59,82,82,0
2024-02-04,20,DPD60-89,104,104,0
2024-02-04,20,DPD90+,62,62,0
2024-02-04,22,Current,0,0,0
2024-02-04,22,DPD15-29,0,0,0
2024-02-04,22,DPD3-14,1,1,0
2024-02-04,22,DPD30-59,0,0,0
2024-02-04,22,DPD60-89,0,0,0
2024-02-04,24,Current,123,123,0
2024-02-04,24,DPD15-29,95,95,0
2024-02-04,24,DPD3-14,97,97,0
2024-02-04,24,DPD30-59,28,28,0
2024-02-04,24,DPD60-89,0,0,0
2024-02-04,24,DPD90+,0,0,0
2024-02-04,26,Current,0,0,0
2024-02-04,26,DPD15-29,21,21,0
2024-02-04,26,DPD3-14,24,24,0
2024-02-04,26,DPD30-59,3,3,0
2024-02-04,26,DPD60-89,0,0,0
2024-02-04,26,DPD90+,0,0,0
2024-02-04,32,Current,0,0,0
2024-02-04,32,DPD15-29,132,132,0
2024-02-04,32,DPD3-14,118,118,0
2024-02-04,32,DPD30-59,33,33,0
2024-02-04,32,DPD60-89,0,0,0
2024-02-04,32,DPD90+,0,0,0
2024-02-04,34,Current,0,0,0
2024-02-04,34,DPD15-29,65,65,0
2024-02-04,34,DPD3-14,51,51,0
2024-02-04,34,DPD30-59,14,14,0
2024-02-04,34,DPD60-89,0,0,0
2024-02-04,34,DPD90+,0,0,0
2024-02-04,36,Current,0,0,0
2024-02-04,36,DPD15-29,53,53,0
2024-02-04,36,DPD3-14,33,33,0
2024-02-04,36,DPD30-59,7,7,0
2024-02-04,36,DPD60-89,0,0,0
2024-02-04,36,DPD90+,0,0,0
2024-02-04,38,Current,0,0,0
2024-02-04,38,DPD15-29,32,32,0
2024-02-04,38,DPD3-14,38,38,0
2024-02-04,38,DPD30-59,7,7,0
2024-02-04,38,DPD60-89,0,0,0
2024-02-04,38,DPD90+,0,0,0
2024-02-04,40,Current,0,0,0
2024-02-04,40,DPD15-29,21,21,0
2024-02-04,40,DPD3-14,18,18,0
2024-02-04,40,DPD30-59,2,2,0
2024-02-04,40,DPD60-89,0,0,0
2024-02-04,40,DPD90+,0,0,0
2024-02-04,42,Current,0,0,0
2024-02-04,42,DPD15-29,9,9,0
2024-02-04,42,DPD3-14,8,8,0
2024-02-04,42,DPD30-59,2,2,0
2024-02-04,42,DPD60-89,0,0,0
2024-02-04,42,DPD90+,0,0,0
2024-02-04,44,Current,0,0,0
2024-02-04,44,DPD15-29,31,31,0
2024-02-04,44,DPD3-14,30,30,0
2024-02-04,44,DPD30-59,6,6,0
2024-02-04,44,DPD60-89,0,0,0
2024-02-04,44,DPD90+,0,0,0
2024-02-04,46,Current,0,0,0
2024-02-04,46,DPD3-14,0,0,0
2024-02-04,46,DPD30-59,0,0,0
2024-02-04,48,Current,112,112,0
2024-02-04,48,DPD15-29,18,18,0
2024-02-04,48,DPD3-14,8,8,0
2024-02-04,48,DPD30-59,6,6,0
2024-02-04,48,DPD60-89,0,0,0
2024-02-04,48,DPD90+,0,0,0
2024-02-04,6,Current,0,0,0
2024-02-03,100,Current,0,0,0
2024-02-03,100,DPD3-14,1,1,0
2024-02-03,102,Current,0,0,0
2024-02-03,102,DPD15-29,0,0,0
2024-02-03,102,DPD30-59,1,1,0
2024-02-03,104,Current,0,0,0
2024-02-03,104,DPD30-59,0,0,0
2024-02-03,104,DPD60-89,0,0,0
2024-02-03,104,DPD90+,0,0,0
2024-02-03,20,Current,16,16,0
2024-02-03,20,DPD15-29,175,175,0
2024-02-03,20,DPD3-14,349,349,0
2024-02-03,20,DPD30-59,215,215,0
2024-02-03,20,DPD60-89,62,62,0
2024-02-03,20,DPD90+,28,28,0
2024-02-03,22,Current,0,0,0
2024-02-03,22,DPD15-29,0,0,0
2024-02-03,22,DPD3-14,4,4,0
2024-02-03,22,DPD30-59,0,0,0
2024-02-03,22,DPD60-89,0,0,0
2024-02-03,24,Current,87,87,0
2024-02-03,24,DPD15-29,122,122,0
2024-02-03,24,DPD3-14,208,208,0
2024-02-03,24,DPD30-59,113,113,0
2024-02-03,24,DPD60-89,0,0,0
2024-02-03,24,DPD90+,0,0,0
2024-02-03,26,Current,0,0,0
2024-02-03,26,DPD15-29,9,9,0
2024-02-03,26,DPD3-14,35,35,0
2024-02-03,26,DPD30-59,11,11,0
2024-02-03,26,DPD60-89,0,0,0
2024-02-03,26,DPD90+,0,0,0
2024-02-03,32,Current,0,0,0
2024-02-03,32,DPD15-29,89,89,0
2024-02-03,32,DPD3-14,158,158,0
2024-02-03,32,DPD30-59,104,104,0
2024-02-03,32,DPD60-89,0,0,0
2024-02-03,32,DPD90+,0,0,0
2024-02-03,34,Current,0,0,0
2024-02-03,34,DPD15-29,36,36,0
2024-02-03,34,DPD3-14,61,61,0
2024-02-03,34,DPD30-59,40,40,0
2024-02-03,34,DPD60-89,0,0,0
2024-02-03,34,DPD90+,0,0,0
2024-02-03,36,Current,0,0,0
2024-02-03,36,DPD15-29,25,25,0
2024-02-03,36,DPD3-14,64,64,0
2024-02-03,36,DPD30-59,22,22,0
2024-02-03,36,DPD60-89,0,0,0
2024-02-03,36,DPD90+,0,0,0
2024-02-03,38,Current,0,0,0
2024-02-03,38,DPD15-29,18,18,0
2024-02-03,38,DPD3-14,57,57,0
2024-02-03,38,DPD30-59,20,20,0
2024-02-03,38,DPD60-89,0,0,0
2024-02-03,38,DPD90+,0,0,0
2024-02-03,40,Current,0,0,0
2024-02-03,40,DPD15-29,16,16,0
2024-02-03,40,DPD3-14,32,32,0
2024-02-03,40,DPD30-59,14,14,0
2024-02-03,40,DPD60-89,0,0,0
2024-02-03,40,DPD90+,0,0,0
2024-02-03,42,Current,0,0,0
2024-02-03,42,DPD15-29,10,10,0
2024-02-03,42,DPD3-14,18,18,0
2024-02-03,42,DPD30-59,9,9,0
2024-02-03,42,DPD60-89,0,0,0
2024-02-03,42,DPD90+,0,0,0
2024-02-03,44,Current,0,0,0
2024-02-03,44,DPD15-29,31,31,0
2024-02-03,44,DPD3-14,28,28,0
2024-02-03,44,DPD30-59,25,25,0
2024-02-03,44,DPD60-89,0,0,0
2024-02-03,44,DPD90+,0,0,0
2024-02-03,46,Current,0,0,0
2024-02-03,46,DPD30-59,1,1,0
2024-02-03,48,Current,80,80,0
2024-02-03,48,DPD15-29,10,10,0
2024-02-03,48,DPD3-14,14,14,0
2024-02-03,48,DPD30-59,13,13,0
2024-02-03,48,DPD60-89,0,0,0
2024-02-03,48,DPD90+,0,0,0
2024-02-03,6,Current,0,0,0
2024-02-02,100,Current,0,0,0
2024-02-02,100,DPD3-14,0,0,0
2024-02-02,102,Current,1,1,0
2024-02-02,102,DPD15-29,0,0,0
2024-02-02,102,DPD30-59,1,1,0
2024-02-02,104,Current,0,0,0
2024-02-02,104,DPD30-59,0,0,0
2024-02-02,104,DPD60-89,0,0,0
2024-02-02,104,DPD90+,0,0,0
2024-02-02,20,Current,330,330,0
2024-02-02,20,DPD15-29,232,232,0
2024-02-02,20,DPD3-14,289,289,0
2024-02-02,20,DPD30-59,144,144,0
2024-02-02,20,DPD60-89,18,18,0
2024-02-02,20,DPD90+,6,6,0
2024-02-02,22,Current,0,0,0
2024-02-02,22,DPD3-14,2,2,0
2024-02-02,22,DPD30-59,1,1,0
2024-02-02,22,DPD60-89,0,0,0
2024-02-02,24,Current,295,295,0
2024-02-02,24,DPD15-29,109,109,0
2024-02-02,24,DPD3-14,130,130,0
2024-02-02,24,DPD30-59,58,58,0
2024-02-02,24,DPD60-89,0,0,0
2024-02-02,24,DPD90+,0,0,0
2024-02-02,26,Current,25,25,0
2024-02-02,26,DPD15-29,19,19,0
2024-02-02,26,DPD3-14,28,28,0
2024-02-02,26,DPD30-59,8,8,0
2024-02-02,26,DPD60-89,0,0,0
2024-02-02,26,DPD90+,0,0,0
2024-02-02,32,Current,91,91,0
2024-02-02,32,DPD15-29,128,128,0
2024-02-02,32,DPD3-14,147,147,0
2024-02-02,32,DPD30-59,51,51,0
2024-02-02,32,DPD60-89,0,0,0
2024-02-02,32,DPD90+,0,0,0
2024-02-02,34,Current,27,27,0
2024-02-02,34,DPD15-29,61,61,0
2024-02-02,34,DPD3-14,65,65,0
2024-02-02,34,DPD30-59,23,23,0
2024-02-02,34,DPD60-89,0,0,0
2024-02-02,34,DPD90+,0,0,0
2024-02-02,36,Current,22,22,0
2024-02-02,36,DPD15-29,53,53,0
2024-02-02,36,DPD3-14,46,46,0
2024-02-02,36,DPD30-59,25,25,0
2024-02-02,36,DPD60-89,0,0,0
2024-02-02,36,DPD90+,0,0,0
2024-02-02,38,Current,45,45,0
2024-02-02,38,DPD15-29,31,31,0
2024-02-02,38,DPD3-14,47,47,0
2024-02-02,38,DPD30-59,13,13,0
2024-02-02,38,DPD60-89,0,0,0
2024-02-02,38,DPD90+,0,0,0
2024-02-02,40,Current,25,25,0
2024-02-02,40,DPD15-29,16,16,0
2024-02-02,40,DPD3-14,24,24,0
2024-02-02,40,DPD30-59,12,12,0
2024-02-02,40,DPD60-89,0,0,0
2024-02-02,40,DPD90+,0,0,0
2024-02-02,42,Current,15,15,0
2024-02-02,42,DPD15-29,9,9,0
2024-02-02,42,DPD3-14,9,9,0
2024-02-02,42,DPD30-59,8,8,0
2024-02-02,42,DPD60-89,0,0,0
2024-02-02,42,DPD90+,0,0,0
2024-02-02,44,Current,44,44,0
2024-02-02,44,DPD15-29,27,27,0
2024-02-02,44,DPD3-14,40,40,0
2024-02-02,44,DPD30-59,15,15,0
2024-02-02,44,DPD60-89,0,0,0
2024-02-02,44,DPD90+,0,0,0
2024-02-02,46,Current,0,0,0
2024-02-02,46,DPD30-59,0,0,0
2024-02-02,48,Current,109,109,0
2024-02-02,48,DPD15-29,17,17,0
2024-02-02,48,DPD3-14,16,16,0
2024-02-02,48,DPD30-59,5,5,0
2024-02-02,48,DPD60-89,0,0,0
2024-02-02,48,DPD90+,0,0,0
2024-02-02,6,Current,0,0,0
2024-02-01,100,Current,0,0,0
2024-02-01,100,DPD3-14,1,1,0
2024-02-01,102,Current,0,0,0
2024-02-01,102,DPD15-29,0,0,0
2024-02-01,102,DPD3-14,0,0,0
2024-02-01,102,DPD30-59,0,0,0
2024-02-01,104,Current,0,0,0
2024-02-01,104,DPD30-59,0,0,0
2024-02-01,104,DPD60-89,0,0,0
2024-02-01,104,DPD90+,0,0,0
2024-02-01,20,Current,5262,5262,0
2024-02-01,20,DPD15-29,246,246,0
2024-02-01,20,DPD3-14,632,632,0
2024-02-01,20,DPD30-59,98,98,0
2024-02-01,20,DPD60-89,35,35,0
2024-02-01,20,DPD90+,33,33,0
2024-02-01,22,Current,0,0,0
2024-02-01,22,DPD3-14,4,4,0
2024-02-01,22,DPD30-59,0,0,0
2024-02-01,22,DPD60-89,0,0,0
2024-02-01,22,DPD90+,0,0,0
2024-02-01,24,Current,3266,3266,0
2024-02-01,24,DPD15-29,140,140,0
2024-02-01,24,DPD3-14,332,332,0
2024-02-01,24,DPD30-59,40,40,0
2024-02-01,24,DPD60-89,9,9,0
2024-02-01,24,DPD90+,9,9,0
2024-02-01,26,Current,0,0,0
2024-02-01,26,DPD15-29,13,13,0
2024-02-01,26,DPD3-14,49,49,0
2024-02-01,26,DPD30-59,4,4,0
2024-02-01,26,DPD60-89,0,0,0
2024-02-01,26,DPD90+,0,0,0
2024-02-01,32,Current,277,277,0
2024-02-01,32,DPD15-29,92,92,0
2024-02-01,32,DPD3-14,243,243,0
2024-02-01,32,DPD30-59,37,37,0
2024-02-01,32,DPD60-89,5,5,0
2024-02-01,32,DPD90+,5,5,0
2024-02-01,34,Current,0,0,0
2024-02-01,34,DPD15-29,41,41,0
2024-02-01,34,DPD3-14,98,98,0
2024-02-01,34,DPD30-59,13,13,0
2024-02-01,34,DPD60-89,0,0,0
2024-02-01,34,DPD90+,0,0,0
2024-02-01,36,Current,308,308,0
2024-02-01,36,DPD15-29,27,27,0
2024-02-01,36,DPD3-14,90,90,0
2024-02-01,36,DPD30-59,14,14,0
2024-02-01,36,DPD60-89,1,1,0
2024-02-01,36,DPD90+,2,2,0
2024-02-01,38,Current,0,0,0
2024-02-01,38,DPD15-29,18,18,0
2024-02-01,38,DPD3-14,79,79,0
2024-02-01,38,DPD30-59,7,7,0
2024-02-01,38,DPD60-89,0,0,0
2024-02-01,38,DPD90+,0,0,0
2024-02-01,40,Current,336,336,0
2024-02-01,40,DPD15-29,20,20,0
2024-02-01,40,DPD3-14,57,57,0
2024-02-01,40,DPD30-59,7,7,0
2024-02-01,40,DPD60-89,0,0,0
2024-02-01,40,DPD90+,1,1,0
2024-02-01,42,Current,0,0,0
2024-02-01,42,DPD15-29,10,10,0
2024-02-01,42,DPD3-14,23,23,0
2024-02-01,42,DPD30-59,6,6,0
2024-02-01,42,DPD60-89,0,0,0
2024-02-01,42,DPD90+,0,0,0
2024-02-01,44,Current,209,209,0
2024-02-01,44,DPD15-29,36,36,0
2024-02-01,44,DPD3-14,46,46,0
2024-02-01,44,DPD30-59,3,3,0
2024-02-01,44,DPD60-89,1,1,0
2024-02-01,44,DPD90+,1,1,0
2024-02-01,46,Current,6,6,0
2024-02-01,46,DPD3-14,1,1,0
2024-02-01,46,DPD30-59,0,0,0
2024-02-01,48,Current,3603,3603,0
2024-02-01,48,DPD15-29,32,32,0
2024-02-01,48,DPD3-14,63,63,0
2024-02-01,48,DPD30-59,19,19,0
2024-02-01,48,DPD60-89,17,17,0
2024-02-01,48,DPD90+,11,11,0
2024-02-01,6,Current,1,1,0
2024-01-31,100,Current,0,0,0
2024-01-31,100,DPD3-14,0,0,0
2024-01-31,102,Current,0,0,0
2024-01-31,102,DPD15-29,0,0,0
2024-01-31,102,DPD3-14,0,0,0
2024-01-31,102,DPD30-59,0,0,0
2024-01-31,104,Current,0,0,0
2024-01-31,104,DPD60-89,0,0,0
2024-01-31,104,DPD90+,0,0,0
2024-01-31,20,Current,6,6,0
2024-01-31,20,DPD15-29,258,258,0
2024-01-31,20,DPD3-14,404,404,0
2024-01-31,20,DPD30-59,50,50,0
2024-01-31,20,DPD60-89,134,134,0
2024-01-31,20,DPD90+,125,125,0
2024-01-31,22,Current,0,0,0
2024-01-31,22,DPD3-14,2,2,0
2024-01-31,22,DPD30-59,0,0,0
2024-01-31,22,DPD60-89,0,0,0
2024-01-31,22,DPD90+,0,0,0
2024-01-31,24,Current,43,43,0
2024-01-31,24,DPD15-29,143,143,0
2024-01-31,24,DPD3-14,201,201,0
2024-01-31,24,DPD30-59,13,13,0
2024-01-31,24,DPD60-89,0,0,0
2024-01-31,24,DPD90+,0,0,0
2024-01-31,26,Current,0,0,0
2024-01-31,26,DPD15-29,23,23,0
2024-01-31,26,DPD3-14,36,36,0
2024-01-31,26,DPD30-59,2,2,0
2024-01-31,26,DPD60-89,0,0,0
2024-01-31,26,DPD90+,0,0,0
2024-01-31,32,Current,0,0,0
2024-01-31,32,DPD15-29,136,136,0
2024-01-31,32,DPD3-14,196,196,0
2024-01-31,32,DPD30-59,26,26,0
2024-01-31,32,DPD60-89,0,0,0
2024-01-31,32,DPD90+,0,0,0
2024-01-31,34,Current,0,0,0
2024-01-31,34,DPD15-29,66,66,0
2024-01-31,34,DPD3-14,83,83,0
2024-01-31,34,DPD30-59,12,12,0
2024-01-31,34,DPD60-89,0,0,0
2024-01-31,34,DPD90+,0,0,0
2024-01-31,36,Current,0,0,0
2024-01-31,36,DPD15-29,48,48,0
2024-01-31,36,DPD3-14,63,63,0
2024-01-31,36,DPD30-59,4,4,0
2024-01-31,36,DPD60-89,0,0,0
2024-01-31,36,DPD90+,0,0,0
2024-01-31,38,Current,0,0,0
2024-01-31,38,DPD15-29,34,34,0
2024-01-31,38,DPD3-14,61,61,0
2024-01-31,38,DPD30-59,5,5,0
2024-01-31,38,DPD60-89,0,0,0
2024-01-31,38,DPD90+,0,0,0
2024-01-31,40,Current,0,0,0
2024-01-31,40,DPD15-29,17,17,0
2024-01-31,40,DPD3-14,36,36,0
2024-01-31,40,DPD30-59,0,0,0
2024-01-31,40,DPD60-89,0,0,0
2024-01-31,40,DPD90+,0,0,0
2024-01-31,42,Current,0,0,0
2024-01-31,42,DPD15-29,12,12,0
2024-01-31,42,DPD3-14,16,16,0
2024-01-31,42,DPD30-59,1,1,0
2024-01-31,42,DPD60-89,0,0,0
2024-01-31,42,DPD90+,0,0,0
2024-01-31,44,Current,0,0,0
2024-01-31,44,DPD15-29,34,34,0
2024-01-31,44,DPD3-14,57,57,0
2024-01-31,44,DPD30-59,4,4,0
2024-01-31,44,DPD60-89,0,0,0
2024-01-31,44,DPD90+,0,0,0
2024-01-31,46,Current,0,0,0
2024-01-31,46,DPD3-14,0,0,0
2024-01-31,46,DPD60-89,0,0,0
2024-01-31,48,Current,54,54,0
2024-01-31,48,DPD15-29,20,20,0
2024-01-31,48,DPD3-14,22,22,0
2024-01-31,48,DPD30-59,3,3,0
2024-01-31,48,DPD60-89,0,0,0
2024-01-31,48,DPD90+,0,0,0
2024-01-31,6,Current,0,0,0
2024-01-30,100,Current,0,0,0
2024-01-30,100,DPD3-14,0,0,0
2024-01-30,102,Current,0,0,0
2024-01-30,102,DPD15-29,0,0,0
2024-01-30,102,DPD3-14,0,0,0
2024-01-30,102,DPD30-59,1,1,0
2024-01-30,104,Current,0,0,0
2024-01-30,104,DPD60-89,0,0,0
2024-01-30,104,DPD90+,0,0,0
2024-01-30,20,Current,12,12,0
2024-01-30,20,DPD15-29,158,158,0
2024-01-30,20,DPD3-14,393,393,0
2024-01-30,20,DPD30-59,298,298,0
2024-01-30,20,DPD60-89,35,35,0
2024-01-30,20,DPD90+,23,23,0
2024-01-30,22,Current,0,0,0
2024-01-30,22,DPD3-14,2,2,0
2024-01-30,22,DPD30-59,0,0,0
2024-01-30,22,DPD60-89,0,0,0
2024-01-30,22,DPD90+,0,0,0
2024-01-30,24,Current,42,42,0
2024-01-30,24,DPD15-29,102,102,0
2024-01-30,24,DPD3-14,217,217,0
2024-01-30,24,DPD30-59,158,158,0
2024-01-30,24,DPD60-89,0,0,0
2024-01-30,24,DPD90+,0,0,0
2024-01-30,26,Current,0,0,0
2024-01-30,26,DPD15-29,15,15,0
2024-01-30,26,DPD3-14,32,32,0
2024-01-30,26,DPD30-59,20,20,0
2024-01-30,26,DPD60-89,0,0,0
2024-01-30,26,DPD90+,0,0,0
2024-01-30,32,Current,0,0,0
2024-01-30,32,DPD15-29,70,70,0
2024-01-30,32,DPD3-14,173,173,0
2024-01-30,32,DPD30-59,155,155,0
2024-01-30,32,DPD60-89,0,0,0
2024-01-30,32,DPD90+,0,0,0
2024-01-30,34,Current,0,0,0
2024-01-30,34,DPD15-29,40,40,0
2024-01-30,34,DPD3-14,64,64,0
2024-01-30,34,DPD30-59,57,57,0
2024-01-30,34,DPD60-89,0,0,0
2024-01-30,34,DPD90+,0,0,0
2024-01-30,36,Current,0,0,0
2024-01-30,36,DPD15-29,20,20,0
2024-01-30,36,DPD3-14,64,64,0
2024-01-30,36,DPD30-59,41,41,0
2024-01-30,36,DPD60-89,0,0,0
2024-01-30,36,DPD90+,0,0,0
2024-01-30,38,Current,0,0,0
2024-01-30,38,DPD15-29,13,13,0
2024-01-30,38,DPD3-14,64,64,0
2024-01-30,38,DPD30-59,28,28,0
2024-01-30,38,DPD60-89,0,0,0
2024-01-30,38,DPD90+,0,0,0
2024-01-30,40,Current,0,0,0
2024-01-30,40,DPD15-29,18,18,0
2024-01-30,40,DPD3-14,27,27,0
2024-01-30,40,DPD30-59,19,19,0
2024-01-30,40,DPD60-89,0,0,0
2024-01-30,40,DPD90+,0,0,0
2024-01-30,42,Current,0,0,0
2024-01-30,42,DPD15-29,11,11,0
2024-01-30,42,DPD3-14,19,19,0
2024-01-30,42,DPD30-59,17,17,0
2024-01-30,42,DPD60-89,0,0,0
2024-01-30,42,DPD90+,0,0,0
2024-01-30,44,Current,0,0,0
2024-01-30,44,DPD15-29,21,21,0
2024-01-30,44,DPD3-14,44,44,0
2024-01-30,44,DPD30-59,33,33,0
2024-01-30,44,DPD60-89,0,0,0
2024-01-30,44,DPD90+,0,0,0
2024-01-30,46,Current,0,0,0
2024-01-30,46,DPD60-89,0,0,0
2024-01-30,48,Current,53,53,0
2024-01-30,48,DPD15-29,9,9,0
2024-01-30,48,DPD3-14,24,24,0
2024-01-30,48,DPD30-59,21,21,0
2024-01-30,48,DPD60-89,0,0,0
2024-01-30,48,DPD90+,0,0,0
2024-01-30,6,Current,0,0,0
2024-01-29,100,Current,0,0,0
2024-01-29,100,DPD3-14,0,0,0
2024-01-29,102,Current,0,0,0
2024-01-29,102,DPD15-29,0,0,0
2024-01-29,102,DPD3-14,0,0,0
2024-01-29,102,DPD30-59,1,1,0
2024-01-29,104,Current,0,0,0
2024-01-29,104,DPD60-89,0,0,0
2024-01-29,104,DPD90+,0,0,0
2024-01-29,20,Current,81,81,0
2024-01-29,20,DPD15-29,201,201,0
2024-01-29,20,DPD3-14,528,528,0
2024-01-29,20,DPD30-59,145,145,0
2024-01-29,20,DPD60-89,23,23,0
2024-01-29,20,DPD90+,88,88,0
2024-01-29,22,Current,0,0,0
2024-01-29,22,DPD3-14,2,2,0
2024-01-29,22,DPD30-59,1,1,0
2024-01-29,22,DPD60-89,0,0,0
2024-01-29,22,DPD90+,0,0,0
2024-01-29,24,Current,150,150,0
2024-01-29,24,DPD15-29,115,115,0
2024-01-29,24,DPD3-14,236,236,0
2024-01-29,24,DPD30-59,56,56,0
2024-01-29,24,DPD60-89,0,0,0
2024-01-29,24,DPD90+,0,0,0
2024-01-29,26,Current,1,1,0
2024-01-29,26,DPD15-29,10,10,0
2024-01-29,26,DPD3-14,58,58,0
2024-01-29,26,DPD30-59,8,8,0
2024-01-29,26,DPD60-89,0,0,0
2024-01-29,26,DPD90+,0,0,0
2024-01-29,32,Current,1,1,0
2024-01-29,32,DPD15-29,99,99,0
2024-01-29,32,DPD3-14,255,255,0
2024-01-29,32,DPD30-59,49,49,0
2024-01-29,32,DPD60-89,0,0,0
2024-01-29,32,DPD90+,0,0,0
2024-01-29,34,Current,0,0,0
2024-01-29,34,DPD15-29,34,34,0
2024-01-29,34,DPD3-14,123,123,0
2024-01-29,34,DPD30-59,24,24,0
2024-01-29,34,DPD60-89,0,0,0
2024-01-29,34,DPD90+,0,0,0
2024-01-29,36,Current,2,2,0
2024-01-29,36,DPD15-29,29,29,0
2024-01-29,36,DPD3-14,87,87,0
2024-01-29,36,DPD30-59,27,27,0
2024-01-29,36,DPD60-89,0,0,0
2024-01-29,36,DPD90+,0,0,0
2024-01-29,38,Current,1,1,0
2024-01-29,38,DPD15-29,30,30,0
2024-01-29,38,DPD3-14,85,85,0
2024-01-29,38,DPD30-59,13,13,0
2024-01-29,38,DPD60-89,0,0,0
2024-01-29,38,DPD90+,0,0,0
2024-01-29,40,Current,5,5,0
2024-01-29,40,DPD15-29,7,7,0
2024-01-29,40,DPD3-14,52,52,0
2024-01-29,40,DPD30-59,11,11,0
2024-01-29,40,DPD60-89,0,0,0
2024-01-29,40,DPD90+,0,0,0
2024-01-29,42,Current,0,0,0
2024-01-29,42,DPD15-29,8,8,0
2024-01-29,42,DPD3-14,26,26,0
2024-01-29,42,DPD30-59,7,7,0
2024-01-29,42,DPD60-89,0,0,0
2024-01-29,42,DPD90+,0,0,0
2024-01-29,44,Current,2,2,0
2024-01-29,44,DPD15-29,26,26,0
2024-01-29,44,DPD3-14,80,80,0
2024-01-29,44,DPD30-59,18,18,0
2024-01-29,44,DPD60-89,0,0,0
2024-01-29,44,DPD90+,0,0,0
2024-01-29,46,Current,0,0,0
2024-01-29,46,DPD30-59,0,0,0
2024-01-29,48,Current,153,153,0
2024-01-29,48,DPD15-29,14,14,0
2024-01-29,48,DPD3-14,33,33,0
2024-01-29,48,DPD30-59,5,5,0
2024-01-29,48,DPD60-89,0,0,0
2024-01-29,48,DPD90+,0,0,0
2024-01-29,6,Current,0,0,0
2024-01-28,100,Current,0,0,0
2024-01-28,102,Current,0,0,0
2024-01-28,102,DPD15-29,0,0,0
2024-01-28,102,DPD3-14,0,0,0
2024-01-28,102,DPD30-59,0,0,0
2024-01-28,104,Current,0,0,0
2024-01-28,104,DPD3-14,0,0,0
2024-01-28,104,DPD60-89,0,0,0
2024-01-28,104,DPD90+,0,0,0
2024-01-28,20,Current,19,19,0
2024-01-28,20,DPD15-29,136,136,0
2024-01-28,20,DPD3-14,373,373,0
2024-01-28,20,DPD30-59,50,50,0
2024-01-28,20,DPD60-89,33,33,0
2024-01-28,20,DPD90+,2,2,0
2024-01-28,22,Current,0,0,0
2024-01-28,22,DPD3-14,1,1,0
2024-01-28,22,DPD30-59,0,0,0
2024-01-28,22,DPD60-89,0,0,0
2024-01-28,22,DPD90+,0,0,0
2024-01-28,24,Current,63,63,0
2024-01-28,24,DPD15-29,95,95,0
2024-01-28,24,DPD3-14,216,216,0
2024-01-28,24,DPD30-59,14,14,0
2024-01-28,24,DPD60-89,0,0,0
2024-01-28,24,DPD90+,0,0,0
2024-01-28,26,Current,0,0,0
2024-01-28,26,DPD15-29,11,11,0
2024-01-28,26,DPD3-14,32,32,0
2024-01-28,26,DPD30-59,4,4,0
2024-01-28,26,DPD60-89,0,0,0
2024-01-28,26,DPD90+,0,0,0
2024-01-28,32,Current,0,0,0
2024-01-28,32,DPD15-29,59,59,0
2024-01-28,32,DPD3-14,164,164,0
2024-01-28,32,DPD30-59,21,21,0
2024-01-28,32,DPD60-89,0,0,0
2024-01-28,32,DPD90+,0,0,0
2024-01-28,34,Current,0,0,0
2024-01-28,34,DPD15-29,30,30,0
2024-01-28,34,DPD3-14,66,66,0
2024-01-28,34,DPD30-59,14,14,0
2024-01-28,34,DPD60-89,0,0,0
2024-01-28,34,DPD90+,0,0,0
2024-01-28,36,Current,0,0,0
2024-01-28,36,DPD15-29,17,17,0
2024-01-28,36,DPD3-14,59,59,0
2024-01-28,36,DPD30-59,8,8,0
2024-01-28,36,DPD60-89,0,0,0
2024-01-28,36,DPD90+,0,0,0
2024-01-28,38,Current,0,0,0
2024-01-28,38,DPD15-29,11,11,0
2024-01-28,38,DPD3-14,61,61,0
2024-01-28,38,DPD30-59,5,5,0
2024-01-28,38,DPD60-89,0,0,0
2024-01-28,38,DPD90+,0,0,0
2024-01-28,40,Current,0,0,0
2024-01-28,40,DPD15-29,17,17,0
2024-01-28,40,DPD3-14,25,25,0
2024-01-28,40,DPD30-59,4,4,0
2024-01-28,40,DPD60-89,0,0,0
2024-01-28,40,DPD90+,0,0,0
2024-01-28,42,Current,0,0,0
2024-01-28,42,DPD15-29,11,11,0
2024-01-28,42,DPD3-14,13,13,0
2024-01-28,42,DPD30-59,2,2,0
2024-01-28,42,DPD60-89,0,0,0
2024-01-28,42,DPD90+,0,0,0
2024-01-28,44,Current,0,0,0
2024-01-28,44,DPD15-29,19,19,0
2024-01-28,44,DPD3-14,48,48,0
2024-01-28,44,DPD30-59,4,4,0
2024-01-28,44,DPD60-89,0,0,0
2024-01-28,44,DPD90+,0,0,0
2024-01-28,46,Current,0,0,0
2024-01-28,46,DPD30-59,0,0,0
2024-01-28,48,Current,57,57,0
2024-01-28,48,DPD15-29,9,9,0
2024-01-28,48,DPD3-14,18,18,0
2024-01-28,48,DPD30-59,3,3,0
2024-01-28,48,DPD60-89,0,0,0
2024-01-28,48,DPD90+,0,0,0
2024-01-28,6,Current,0,0,0
2024-01-27,100,Current,0,0,0
2024-01-27,102,Current,0,0,0
2024-01-27,102,DPD15-29,1,1,0
2024-01-27,102,DPD3-14,0,0,0
2024-01-27,102,DPD30-59,1,1,0
2024-01-27,104,Current,0,0,0
2024-01-27,104,DPD3-14,1,1,0
2024-01-27,104,DPD60-89,0,0,0
2024-01-27,104,DPD90+,0,0,0
2024-01-27,20,Current,9,9,0
2024-01-27,20,DPD15-29,211,211,0
2024-01-27,20,DPD3-14,433,433,0
2024-01-27,20,DPD30-59,250,250,0
2024-01-27,20,DPD60-89,129,129,0
2024-01-27,20,DPD90+,68,68,0
2024-01-27,22,Current,0,0,0
2024-01-27,22,DPD3-14,2,2,0
2024-01-27,22,DPD30-59,0,0,0
2024-01-27,22,DPD60-89,0,0,0
2024-01-27,22,DPD90+,0,0,0
2024-01-27,24,Current,74,74,0
2024-01-27,24,DPD15-29,121,121,0
2024-01-27,24,DPD3-14,204,204,0
2024-01-27,24,DPD30-59,121,121,0
2024-01-27,24,DPD60-89,0,0,0
2024-01-27,24,DPD90+,0,0,0
2024-01-27,26,Current,0,0,0
2024-01-27,26,DPD15-29,13,13,0
2024-01-27,26,DPD3-14,50,50,0
2024-01-27,26,DPD30-59,16,16,0
2024-01-27,26,DPD60-89,0,0,0
2024-01-27,26,DPD90+,0,0,0
2024-01-27,32,Current,0,0,0
2024-01-27,32,DPD15-29,99,99,0
2024-01-27,32,DPD3-14,219,219,0
2024-01-27,32,DPD30-59,123,123,0
2024-01-27,32,DPD60-89,0,0,0
2024-01-27,32,DPD90+,0,0,0
2024-01-27,34,Current,0,0,0
2024-01-27,34,DPD15-29,38,38,0
2024-01-27,34,DPD3-14,112,112,0
2024-01-27,34,DPD30-59,48,48,0
2024-01-27,34,DPD60-89,0,0,0
2024-01-27,34,DPD90+,0,0,0
2024-01-27,36,Current,0,0,0
2024-01-27,36,DPD15-29,39,39,0
2024-01-27,36,DPD3-14,75,75,0
2024-01-27,36,DPD30-59,37,37,0
2024-01-27,36,DPD60-89,0,0,0
2024-01-27,36,DPD90+,0,0,0
2024-01-27,38,Current,0,0,0
2024-01-27,38,DPD15-29,33,33,0
2024-01-27,38,DPD3-14,78,78,0
2024-01-27,38,DPD30-59,25,25,0
2024-01-27,38,DPD60-89,0,0,0
2024-01-27,38,DPD90+,0,0,0
2024-01-27,40,Current,0,0,0
2024-01-27,40,DPD15-29,9,9,0
2024-01-27,40,DPD3-14,38,38,0
2024-01-27,40,DPD30-59,19,19,0
2024-01-27,40,DPD60-89,0,0,0
2024-01-27,40,DPD90+,0,0,0
2024-01-27,42,Current,0,0,0
2024-01-27,42,DPD15-29,8,8,0
2024-01-27,42,DPD3-14,22,22,0
2024-01-27,42,DPD30-59,11,11,0
2024-01-27,42,DPD60-89,0,0,0
2024-01-27,42,DPD90+,0,0,0
2024-01-27,44,Current,0,0,0
2024-01-27,44,DPD15-29,26,26,0
2024-01-27,44,DPD3-14,66,66,0
2024-01-27,44,DPD30-59,26,26,0
2024-01-27,44,DPD60-89,0,0,0
2024-01-27,44,DPD90+,0,0,0
2024-01-27,46,Current,0,0,0
2024-01-27,46,DPD30-59,0,0,0
2024-01-27,48,Current,67,67,0
2024-01-27,48,DPD15-29,14,14,0
2024-01-27,48,DPD3-14,32,32,0
2024-01-27,48,DPD30-59,22,22,0
2024-01-27,48,DPD60-89,0,0,0
2024-01-27,48,DPD90+,0,0,0
2024-01-27,6,Current,0,0,0
2024-01-26,100,Current,0,0,0
2024-01-26,102,Current,1,1,0
2024-01-26,102,DPD15-29,0,0,0
2024-01-26,102,DPD3-14,0,0,0
2024-01-26,102,DPD30-59,0,0,0
2024-01-26,104,Current,0,0,0
2024-01-26,104,DPD3-14,0,0,0
2024-01-26,104,DPD60-89,0,0,0
2024-01-26,104,DPD90+,0,0,0
2024-01-26,20,Current,328,328,0
2024-01-26,20,DPD15-29,151,151,0
2024-01-26,20,DPD3-14,343,343,0
2024-01-26,20,DPD30-59,95,95,0
2024-01-26,20,DPD60-89,20,20,0
2024-01-26,20,DPD90+,45,45,0
2024-01-26,22,Current,0,0,0
2024-01-26,22,DPD3-14,1,1,0
2024-01-26,22,DPD30-59,0,0,0
2024-01-26,22,DPD60-89,0,0,0
2024-01-26,22,DPD90+,0,0,0
2024-01-26,24,Current,291,291,0
2024-01-26,24,DPD15-29,83,83,0
2024-01-26,24,DPD3-14,217,217,0
2024-01-26,24,DPD30-59,44,44,0
2024-01-26,24,DPD60-89,1,1,0
2024-01-26,24,DPD90+,0,0,0
2024-01-26,26,Current,32,32,0
2024-01-26,26,DPD15-29,16,16,0
2024-01-26,26,DPD3-14,29,29,0
2024-01-26,26,DPD30-59,5,5,0
2024-01-26,26,DPD60-89,0,0,0
2024-01-26,26,DPD90+,0,0,0
2024-01-26,32,Current,113,113,0
2024-01-26,32,DPD15-29,71,71,0
2024-01-26,32,DPD3-14,161,161,0
2024-01-26,32,DPD30-59,45,45,0
2024-01-26,32,DPD60-89,0,0,0
2024-01-26,32,DPD90+,0,0,0
2024-01-26,34,Current,50,50,0
2024-01-26,34,DPD15-29,39,39,0
2024-01-26,34,DPD3-14,71,71,0
2024-01-26,34,DPD30-59,14,14,0
2024-01-26,34,DPD60-89,0,0,0
2024-01-26,34,DPD90+,0,0,0
2024-01-26,36,Current,49,49,0
2024-01-26,36,DPD15-29,20,20,0
2024-01-26,36,DPD3-14,55,55,0
2024-01-26,36,DPD30-59,7,7,0
2024-01-26,36,DPD60-89,0,0,0
2024-01-26,36,DPD90+,0,0,0
2024-01-26,38,Current,45,45,0
2024-01-26,38,DPD15-29,16,16,0
2024-01-26,38,DPD3-14,59,59,0
2024-01-26,38,DPD30-59,5,5,0
2024-01-26,38,DPD60-89,0,0,0
2024-01-26,38,DPD90+,0,0,0
2024-01-26,40,Current,32,32,0
2024-01-26,40,DPD15-29,17,17,0
2024-01-26,40,DPD3-14,27,27,0
2024-01-26,40,DPD30-59,3,3,0
2024-01-26,40,DPD60-89,0,0,0
2024-01-26,40,DPD90+,0,0,0
2024-01-26,42,Current,11,11,0
2024-01-26,42,DPD15-29,9,9,0
2024-01-26,42,DPD3-14,14,14,0
2024-01-26,42,DPD30-59,6,6,0
2024-01-26,42,DPD60-89,0,0,0
2024-01-26,42,DPD90+,0,0,0
2024-01-26,44,Current,57,57,0
2024-01-26,44,DPD15-29,24,24,0
2024-01-26,44,DPD3-14,46,46,0
2024-01-26,44,DPD30-59,7,7,0
2024-01-26,44,DPD60-89,0,0,0
2024-01-26,44,DPD90+,0,0,0
2024-01-26,46,Current,1,1,0
2024-01-26,46,DPD30-59,1,1,0
2024-01-26,48,Current,120,120,0
2024-01-26,48,DPD15-29,10,10,0
2024-01-26,48,DPD3-14,15,15,0
2024-01-26,48,DPD30-59,3,3,0
2024-01-26,48,DPD60-89,0,0,0
2024-01-26,48,DPD90+,0,0,0
2024-01-26,6,Current,0,0,0
2024-01-25,100,Current,0,0,0
2024-01-25,100,DPD15-29,0,0,0
2024-01-25,102,Current,0,0,0
2024-01-25,102,DPD15-29,1,1,0
2024-01-25,102,DPD3-14,0,0,0
2024-01-25,102,DPD30-59,0,0,0
2024-01-25,104,Current,0,0,0
2024-01-25,104,DPD3-14,1,1,0
2024-01-25,104,DPD60-89,0,0,0
2024-01-25,104,DPD90+,0,0,0
2024-01-25,20,Current,10,10,0
2024-01-25,20,DPD15-29,251,251,0
2024-01-25,20,DPD3-14,452,452,0
2024-01-25,20,DPD30-59,116,116,0
2024-01-25,20,DPD60-89,20,20,0
2024-01-25,20,DPD90+,4,4,0
2024-01-25,22,Current,0,0,0
2024-01-25,22,DPD15-29,1,1,0
2024-01-25,22,DPD3-14,2,2,0
2024-01-25,22,DPD30-59,1,1,0
2024-01-25,22,DPD60-89,0,0,0
2024-01-25,22,DPD90+,0,0,0
2024-01-25,24,Current,44,44,0
2024-01-25,24,DPD15-29,134,134,0
2024-01-25,24,DPD3-14,228,228,0
2024-01-25,24,DPD30-59,43,43,0
2024-01-25,24,DPD60-89,0,0,0
2024-01-25,24,DPD90+,0,0,0
2024-01-25,26,Current,0,0,0
2024-01-25,26,DPD15-29,15,15,0
2024-01-25,26,DPD3-14,52,52,0
2024-01-25,26,DPD30-59,4,4,0
2024-01-25,26,DPD60-89,0,0,0
2024-01-25,26,DPD90+,0,0,0
2024-01-25,32,Current,0,0,0
2024-01-25,32,DPD15-29,114,114,0
2024-01-25,32,DPD3-14,213,213,0
2024-01-25,32,DPD30-59,45,45,0
2024-01-25,32,DPD60-89,0,0,0
2024-01-25,32,DPD90+,0,0,0
2024-01-25,34,Current,0,0,0
2024-01-25,34,DPD15-29,50,50,0
2024-01-25,34,DPD3-14,113,113,0
2024-01-25,34,DPD30-59,17,17,0
2024-01-25,34,DPD60-89,0,0,0
2024-01-25,34,DPD90+,0,0,0
2024-01-25,36,Current,0,0,0
2024-01-25,36,DPD15-29,45,45,0
2024-01-25,36,DPD3-14,79,79,0
2024-01-25,36,DPD30-59,15,15,0
2024-01-25,36,DPD60-89,0,0,0
2024-01-25,36,DPD90+,0,0,0
2024-01-25,38,Current,0,0,0
2024-01-25,38,DPD15-29,31,31,0
2024-01-25,38,DPD3-14,76,76,0
2024-01-25,38,DPD30-59,6,6,0
2024-01-25,38,DPD60-89,0,0,0
2024-01-25,38,DPD90+,0,0,0
2024-01-25,40,Current,0,0,0
2024-01-25,40,DPD15-29,11,11,0
2024-01-25,40,DPD3-14,44,44,0
2024-01-25,40,DPD30-59,11,11,0
2024-01-25,40,DPD60-89,0,0,0
2024-01-25,40,DPD90+,0,0,0
2024-01-25,42,Current,0,0,0
2024-01-25,42,DPD15-29,8,8,0
2024-01-25,42,DPD3-14,22,22,0
2024-01-25,42,DPD30-59,4,4,0
2024-01-25,42,DPD60-89,0,0,0
2024-01-25,42,DPD90+,0,0,0
2024-01-25,44,Current,0,0,0
2024-01-25,44,DPD15-29,28,28,0
2024-01-25,44,DPD3-14,60,60,0
2024-01-25,44,DPD30-59,13,13,0
2024-01-25,44,DPD60-89,0,0,0
2024-01-25,44,DPD90+,0,0,0
2024-01-25,46,Current,0,0,0
2024-01-25,46,DPD30-59,0,0,0
2024-01-25,48,Current,39,39,0
2024-01-25,48,DPD15-29,16,16,0
2024-01-25,48,DPD3-14,40,40,0
2024-01-25,48,DPD30-59,3,3,0
2024-01-25,48,DPD60-89,0,0,0
2024-01-25,48,DPD90+,0,0,0
2024-01-25,6,Current,0,0,0
2024-01-24,100,Current,0,0,0
2024-01-24,100,DPD15-29,0,0,0
2024-01-24,102,Current,0,0,0
2024-01-24,102,DPD15-29,0,0,0
2024-01-24,102,DPD3-14,0,0,0
2024-01-24,102,DPD30-59,0,0,0
2024-01-24,104,Current,0,0,0
2024-01-24,104,DPD3-14,0,0,0
2024-01-24,104,DPD60-89,0,0,0
2024-01-24,104,DPD90+,0,0,0
2024-01-24,20,Current,43,43,0
2024-01-24,20,DPD15-29,152,152,0
2024-01-24,20,DPD3-14,335,335,0
2024-01-24,20,DPD30-59,29,29,0
2024-01-24,20,DPD60-89,50,50,0
2024-01-24,20,DPD90+,3,3,0
2024-01-24,22,Current,0,0,0
2024-01-24,22,DPD15-29,0,0,0
2024-01-24,22,DPD3-14,0,0,0
2024-01-24,22,DPD30-59,0,0,0
2024-01-24,22,DPD60-89,0,0,0
2024-01-24,22,DPD90+,0,0,0
2024-01-24,24,Current,105,105,0
2024-01-24,24,DPD15-29,56,56,0
2024-01-24,24,DPD3-14,236,236,0
2024-01-24,24,DPD30-59,11,11,0
2024-01-24,24,DPD60-89,0,0,0
2024-01-24,24,DPD90+,0,0,0
2024-01-24,26,Current,0,0,0
2024-01-24,26,DPD15-29,13,13,0
2024-01-24,26,DPD3-14,29,29,0
2024-01-24,26,DPD30-59,1,1,0
2024-01-24,26,DPD60-89,0,0,0
2024-01-24,26,DPD90+,0,0,0
2024-01-24,32,Current,0,0,0
2024-01-24,32,DPD15-29,84,84,0
2024-01-24,32,DPD3-14,174,174,0
2024-01-24,32,DPD30-59,21,21,0
2024-01-24,32,DPD60-89,0,0,0
2024-01-24,32,DPD90+,0,0,0
2024-01-24,34,Current,0,0,0
2024-01-24,34,DPD15-29,38,38,0
2024-01-24,34,DPD3-14,73,73,0
2024-01-24,34,DPD30-59,10,10,0
2024-01-24,34,DPD60-89,0,0,0
2024-01-24,34,DPD90+,0,0,0
2024-01-24,36,Current,0,0,0
2024-01-24,36,DPD15-29,22,22,0
2024-01-24,36,DPD3-14,53,53,0
2024-01-24,36,DPD30-59,7,7,0
2024-01-24,36,DPD60-89,0,0,0
2024-01-24,36,DPD90+,0,0,0
2024-01-24,38,Current,0,0,0
2024-01-24,38,DPD15-29,18,18,0
2024-01-24,38,DPD3-14,54,54,0
2024-01-24,38,DPD30-59,6,6,0
2024-01-24,38,DPD60-89,0,0,0
2024-01-24,38,DPD90+,0,0,0
2024-01-24,40,Current,0,0,0
2024-01-24,40,DPD15-29,16,16,0
2024-01-24,40,DPD3-14,32,32,0
2024-01-24,40,DPD30-59,0,0,0
2024-01-24,40,DPD60-89,0,0,0
2024-01-24,40,DPD90+,0,0,0
2024-01-24,42,Current,0,0,0
2024-01-24,42,DPD15-29,8,8,0
2024-01-24,42,DPD3-14,15,15,0
2024-01-24,42,DPD30-59,1,1,0
2024-01-24,42,DPD60-89,0,0,0
2024-01-24,42,DPD90+,0,0,0
2024-01-24,44,Current,0,0,0
2024-01-24,44,DPD15-29,24,24,0
2024-01-24,44,DPD3-14,55,55,0
2024-01-24,44,DPD30-59,2,2,0
2024-01-24,44,DPD60-89,0,0,0
2024-01-24,44,DPD90+,0,0,0
2024-01-24,46,Current,0,0,0
2024-01-24,46,DPD15-29,1,1,0
2024-01-24,46,DPD30-59,0,0,0
2024-01-24,48,Current,97,97,0
2024-01-24,48,DPD15-29,8,8,0
2024-01-24,48,DPD3-14,19,19,0
2024-01-24,48,DPD30-59,1,1,0
2024-01-24,48,DPD60-89,0,0,0
2024-01-24,48,DPD90+,0,0,0
2024-01-24,6,Current,0,0,0
2024-01-23,100,Current,0,0,0
2024-01-23,100,DPD15-29,1,1,0
2024-01-23,102,Current,0,0,0
2024-01-23,102,DPD15-29,1,1,0
2024-01-23,102,DPD3-14,0,0,0
2024-01-23,102,DPD30-59,1,1,0
2024-01-23,104,Current,0,0,0
2024-01-23,104,DPD3-14,1,1,0
2024-01-23,104,DPD60-89,0,0,0
2024-01-23,20,Current,22,22,0
2024-01-23,20,DPD15-29,263,263,0
2024-01-23,20,DPD3-14,453,453,0
2024-01-23,20,DPD30-59,324,324,0
2024-01-23,20,DPD60-89,110,110,0
2024-01-23,20,DPD90+,132,132,0
2024-01-23,22,Current,0,0,0
2024-01-23,22,DPD15-29,1,1,0
2024-01-23,22,DPD3-14,1,1,0
2024-01-23,22,DPD30-59,0,0,0
2024-01-23,22,DPD60-89,0,0,0
2024-01-23,22,DPD90+,0,0,0
2024-01-23,24,Current,53,53,0
2024-01-23,24,DPD15-29,129,129,0
2024-01-23,24,DPD3-14,238,238,0
2024-01-23,24,DPD30-59,152,152,0
2024-01-23,24,DPD60-89,0,0,0
2024-01-23,24,DPD90+,0,0,0
2024-01-23,26,Current,0,0,0
2024-01-23,26,DPD15-29,15,15,0
2024-01-23,26,DPD3-14,45,45,0
2024-01-23,26,DPD30-59,21,21,0
2024-01-23,26,DPD60-89,0,0,0
2024-01-23,26,DPD90+,0,0,0
2024-01-23,32,Current,0,0,0
2024-01-23,32,DPD15-29,115,115,0
2024-01-23,32,DPD3-14,210,210,0
2024-01-23,32,DPD30-59,162,162,0
2024-01-23,32,DPD60-89,0,0,0
2024-01-23,32,DPD90+,0,0,0
2024-01-23,34,Current,0,0,0
2024-01-23,34,DPD15-29,57,57,0
2024-01-23,34,DPD3-14,97,97,0
2024-01-23,34,DPD30-59,67,67,0
2024-01-23,34,DPD60-89,0,0,0
2024-01-23,34,DPD90+,0,0,0
2024-01-23,36,Current,0,0,0
2024-01-23,36,DPD15-29,39,39,0
2024-01-23,36,DPD3-14,76,76,0
2024-01-23,36,DPD30-59,50,50,0
2024-01-23,36,DPD60-89,0,0,0
2024-01-23,36,DPD90+,0,0,0
2024-01-23,38,Current,0,0,0
2024-01-23,38,DPD15-29,26,26,0
2024-01-23,38,DPD3-14,72,72,0
2024-01-23,38,DPD30-59,35,35,0
2024-01-23,38,DPD60-89,0,0,0
2024-01-23,38,DPD90+,0,0,0
2024-01-23,40,Current,0,0,0
2024-01-23,40,DPD15-29,10,10,0
2024-01-23,40,DPD3-14,37,37,0
2024-01-23,40,DPD30-59,24,24,0
2024-01-23,40,DPD60-89,0,0,0
2024-01-23,40,DPD90+,0,0,0
2024-01-23,42,Current,0,0,0
2024-01-23,42,DPD15-29,10,10,0
2024-01-23,42,DPD3-14,23,23,0
2024-01-23,42,DPD30-59,17,17,0
2024-01-23,42,DPD60-89,0,0,0
2024-01-23,42,DPD90+,0,0,0
2024-01-23,44,Current,0,0,0
2024-01-23,44,DPD15-29,30,30,0
2024-01-23,44,DPD3-14,66,66,0
2024-01-23,44,DPD30-59,38,38,0
2024-01-23,44,DPD60-89,0,0,0
2024-01-23,44,DPD90+,0,0,0
2024-01-23,46,Current,0,0,0
2024-01-23,46,DPD15-29,0,0,0
2024-01-23,46,DPD30-59,0,0,0
2024-01-23,48,Current,43,43,0
2024-01-23,48,DPD15-29,19,19,0
2024-01-23,48,DPD3-14,43,43,0
2024-01-23,48,DPD30-59,23,23,0
2024-01-23,48,DPD60-89,0,0,0
2024-01-23,48,DPD90+,0,0,0
2024-01-23,6,Current,0,0,0
2024-01-22,100,Current,0,0,0
2024-01-22,100,DPD15-29,0,0,0
2024-01-22,100,DPD3-14,0,0,0
2024-01-22,102,Current,0,0,0
2024-01-22,102,DPD15-29,0,0,0
2024-01-22,102,DPD3-14,0,0,0
2024-01-22,102,DPD30-59,0,0,0
2024-01-22,104,Current,0,0,0
2024-01-22,104,DPD3-14,1,1,0
2024-01-22,104,DPD60-89,0,0,0
2024-01-22,20,Current,56,56,0
2024-01-22,20,DPD15-29,166,166,0
2024-01-22,20,DPD3-14,366,366,0
2024-01-22,20,DPD30-59,94,94,0
2024-01-22,20,DPD60-89,26,26,0
2024-01-22,20,DPD90+,17,17,0
2024-01-22,22,Current,0,0,0
2024-01-22,22,DPD15-29,0,0,0
2024-01-22,22,DPD3-14,1,1,0
2024-01-22,22,DPD30-59,0,0,0
2024-01-22,22,DPD60-89,0,0,0
2024-01-22,22,DPD90+,0,0,0
2024-01-22,24,Current,88,88,0
2024-01-22,24,DPD15-29,64,64,0
2024-01-22,24,DPD3-14,238,238,0
2024-01-22,24,DPD30-59,43,43,0
2024-01-22,24,DPD60-89,0,0,0
2024-01-22,24,DPD90+,0,0,0
2024-01-22,26,Current,0,0,0
2024-01-22,26,DPD15-29,14,14,0
2024-01-22,26,DPD3-14,29,29,0
2024-01-22,26,DPD30-59,7,7,0
2024-01-22,26,DPD60-89,0,0,0
2024-01-22,26,DPD90+,0,0,0
2024-01-22,32,Current,0,0,0
2024-01-22,32,DPD15-29,89,89,0
2024-01-22,32,DPD3-14,190,190,0
2024-01-22,32,DPD30-59,40,40,0
2024-01-22,32,DPD60-89,0,0,0
2024-01-22,32,DPD90+,0,0,0
2024-01-22,34,Current,0,0,0
2024-01-22,34,DPD15-29,46,46,0
2024-01-22,34,DPD3-14,88,88,0
2024-01-22,34,DPD30-59,10,10,0
2024-01-22,34,DPD60-89,0,0,0
2024-01-22,34,DPD90+,0,0,0
2024-01-22,36,Current,0,0,0
2024-01-22,36,DPD15-29,27,27,0
2024-01-22,36,DPD3-14,51,51,0
2024-01-22,36,DPD30-59,7,7,0
2024-01-22,36,DPD60-89,0,0,0
2024-01-22,36,DPD90+,0,0,0
2024-01-22,38,Current,0,0,0
2024-01-22,38,DPD15-29,14,14,0
2024-01-22,38,DPD3-14,56,56,0
2024-01-22,38,DPD30-59,4,4,0
2024-01-22,38,DPD60-89,0,0,0
2024-01-22,38,DPD90+,0,0,0
2024-01-22,40,Current,0,0,0
2024-01-22,40,DPD15-29,14,14,0
2024-01-22,40,DPD3-14,37,37,0
2024-01-22,40,DPD30-59,3,3,0
2024-01-22,40,DPD60-89,0,0,0
2024-01-22,40,DPD90+,0,0,0
2024-01-22,42,Current,0,0,0
2024-01-22,42,DPD15-29,10,10,0
2024-01-22,42,DPD3-14,18,18,0
2024-01-22,42,DPD30-59,5,5,0
2024-01-22,42,DPD60-89,0,0,0
2024-01-22,42,DPD90+,0,0,0
2024-01-22,44,Current,0,0,0
2024-01-22,44,DPD15-29,23,23,0
2024-01-22,44,DPD3-14,72,72,0
2024-01-22,44,DPD30-59,8,8,0
2024-01-22,44,DPD60-89,0,0,0
2024-01-22,44,DPD90+,0,0,0
2024-01-22,46,Current,0,0,0
2024-01-22,46,DPD30-59,1,1,0
2024-01-22,48,Current,97,97,0
2024-01-22,48,DPD15-29,7,7,0
2024-01-22,48,DPD3-14,25,25,0
2024-01-22,48,DPD30-59,3,3,0
2024-01-22,48,DPD60-89,0,0,0
2024-01-22,48,DPD90+,0,0,0
2024-01-22,6,Current,0,0,0
2024-01-21,100,Current,0,0,0
2024-01-21,100,DPD15-29,1,1,0
2024-01-21,100,DPD3-14,1,1,0
2024-01-21,102,Current,0,0,0
2024-01-21,102,DPD15-29,1,1,0
2024-01-21,102,DPD3-14,1,1,0
2024-01-21,102,DPD30-59,0,0,0
2024-01-21,104,Current,0,0,0
2024-01-21,104,DPD3-14,0,0,0
2024-01-21,104,DPD30-59,0,0,0
2024-01-21,104,DPD60-89,0,0,0
2024-01-21,20,Current,70,70,0
2024-01-21,20,DPD15-29,255,255,0
2024-01-21,20,DPD3-14,507,507,0
2024-01-21,20,DPD30-59,83,83,0
2024-01-21,20,DPD60-89,54,54,0
2024-01-21,20,DPD90+,56,56,0
2024-01-21,22,Current,0,0,0
2024-01-21,22,DPD15-29,1,1,0
2024-01-21,22,DPD3-14,0,0,0
2024-01-21,22,DPD30-59,1,1,0
2024-01-21,22,DPD60-89,0,0,0
2024-01-21,22,DPD90+,0,0,0
2024-01-21,24,Current,113,113,0
2024-01-21,24,DPD15-29,127,127,0
2024-01-21,24,DPD3-14,254,254,0
2024-01-21,24,DPD30-59,40,40,0
2024-01-21,24,DPD60-89,0,0,0
2024-01-21,24,DPD90+,0,0,0
2024-01-21,26,Current,0,0,0
2024-01-21,26,DPD15-29,16,16,0
2024-01-21,26,DPD3-14,42,42,0
2024-01-21,26,DPD30-59,5,5,0
2024-01-21,26,DPD60-89,0,0,0
2024-01-21,26,DPD90+,0,0,0
2024-01-21,32,Current,0,0,0
2024-01-21,32,DPD15-29,115,115,0
2024-01-21,32,DPD3-14,224,224,0
2024-01-21,32,DPD30-59,45,45,0
2024-01-21,32,DPD60-89,0,0,0
2024-01-21,32,DPD90+,0,0,0
2024-01-21,34,Current,0,0,0
2024-01-21,34,DPD15-29,57,57,0
2024-01-21,34,DPD3-14,116,116,0
2024-01-21,34,DPD30-59,12,12,0
2024-01-21,34,DPD60-89,0,0,0
2024-01-21,34,DPD90+,0,0,0
2024-01-21,36,Current,0,0,0
2024-01-21,36,DPD15-29,34,34,0
2024-01-21,36,DPD3-14,87,87,0
2024-01-21,36,DPD30-59,13,13,0
2024-01-21,36,DPD60-89,0,0,0
2024-01-21,36,DPD90+,0,0,0
2024-01-21,38,Current,0,0,0
2024-01-21,38,DPD15-29,22,22,0
2024-01-21,38,DPD3-14,83,83,0
2024-01-21,38,DPD30-59,7,7,0
2024-01-21,38,DPD60-89,0,0,0
2024-01-21,38,DPD90+,0,0,0
2024-01-21,40,Current,0,0,0
2024-01-21,40,DPD15-29,12,12,0
2024-01-21,40,DPD3-14,40,40,0
2024-01-21,40,DPD30-59,7,7,0
2024-01-21,40,DPD60-89,0,0,0
2024-01-21,40,DPD90+,0,0,0
2024-01-21,42,Current,0,0,0
2024-01-21,42,DPD15-29,12,12,0
2024-01-21,42,DPD3-14,29,29,0
2024-01-21,42,DPD30-59,3,3,0
2024-01-21,42,DPD60-89,0,0,0
2024-01-21,42,DPD90+,0,0,0
2024-01-21,44,Current,0,0,0
2024-01-21,44,DPD15-29,27,27,0
2024-01-21,44,DPD3-14,65,65,0
2024-01-21,44,DPD30-59,12,12,0
2024-01-21,44,DPD60-89,0,0,0
2024-01-21,44,DPD90+,0,0,0
2024-01-21,46,Current,0,0,0
2024-01-21,46,DPD30-59,0,0,0
2024-01-21,48,Current,107,107,0
2024-01-21,48,DPD15-29,17,17,0
2024-01-21,48,DPD3-14,42,42,0
2024-01-21,48,DPD30-59,2,2,0
2024-01-21,48,DPD60-89,0,0,0
2024-01-21,48,DPD90+,0,0,0
2024-01-21,6,Current,0,0,0
2024-01-21,6,DPD3-14,0,0,0
2024-01-20,100,Current,0,0,0
2024-01-20,100,DPD15-29,0,0,0
2024-01-20,100,DPD3-14,0,0,0
2024-01-20,102,Current,0,0,0
2024-01-20,102,DPD15-29,0,0,0
2024-01-20,102,DPD3-14,0,0,0
2024-01-20,102,DPD30-59,1,1,0
2024-01-20,104,Current,0,0,0
2024-01-20,104,DPD30-59,1,1,0
2024-01-20,104,DPD60-89,0,0,0
2024-01-20,20,Current,45,45,0
2024-01-20,20,DPD15-29,164,164,0
2024-01-20,20,DPD3-14,304,304,0
2024-01-20,20,DPD30-59,151,151,0
2024-01-20,20,DPD60-89,32,32,0
2024-01-20,20,DPD90+,2,2,0
2024-01-20,22,Current,0,0,0
2024-01-20,22,DPD15-29,0,0,0
2024-01-20,22,DPD3-14,1,1,0
2024-01-20,22,DPD30-59,0,0,0
2024-01-20,22,DPD60-89,0,0,0
2024-01-20,22,DPD90+,0,0,0
2024-01-20,24,Current,112,112,0
2024-01-20,24,DPD15-29,60,60,0
2024-01-20,24,DPD3-14,194,194,0
2024-01-20,24,DPD30-59,85,85,0
2024-01-20,24,DPD60-89,0,0,0
2024-01-20,24,DPD90+,0,0,0
2024-01-20,26,Current,0,0,0
2024-01-20,26,DPD15-29,13,13,0
2024-01-20,26,DPD3-14,26,26,0
2024-01-20,26,DPD30-59,10,10,0
2024-01-20,26,DPD60-89,0,0,0
2024-01-20,26,DPD90+,0,0,0
2024-01-20,32,Current,0,0,0
2024-01-20,32,DPD15-29,90,90,0
2024-01-20,32,DPD3-14,167,167,0
2024-01-20,32,DPD30-59,79,79,0
2024-01-20,32,DPD60-89,0,0,0
2024-01-20,32,DPD90+,0,0,0
2024-01-20,34,Current,0,0,0
2024-01-20,34,DPD15-29,43,43,0
2024-01-20,34,DPD3-14,68,68,0
2024-01-20,34,DPD30-59,28,28,0
2024-01-20,34,DPD60-89,0,0,0
2024-01-20,34,DPD90+,0,0,0
2024-01-20,36,Current,0,0,0
2024-01-20,36,DPD15-29,25,25,0
2024-01-20,36,DPD3-14,44,44,0
2024-01-20,36,DPD30-59,22,22,0
2024-01-20,36,DPD60-89,0,0,0
2024-01-20,36,DPD90+,0,0,0
2024-01-20,38,Current,0,0,0
2024-01-20,38,DPD15-29,10,10,0
2024-01-20,38,DPD3-14,44,44,0
2024-01-20,38,DPD30-59,19,19,0
2024-01-20,38,DPD60-89,0,0,0
2024-01-20,38,DPD90+,0,0,0
2024-01-20,40,Current,0,0,0
2024-01-20,40,DPD15-29,12,12,0
2024-01-20,40,DPD3-14,28,28,0
2024-01-20,40,DPD30-59,13,13,0
2024-01-20,40,DPD60-89,0,0,0
2024-01-20,40,DPD90+,0,0,0
2024-01-20,42,Current,0,0,0
2024-01-20,42,DPD15-29,9,9,0
2024-01-20,42,DPD3-14,16,16,0
2024-01-20,42,DPD30-59,12,12,0
2024-01-20,42,DPD60-89,0,0,0
2024-01-20,42,DPD90+,0,0,0
2024-01-20,44,Current,0,0,0
2024-01-20,44,DPD15-29,24,24,0
2024-01-20,44,DPD3-14,57,57,0
2024-01-20,44,DPD30-59,21,21,0
2024-01-20,44,DPD60-89,0,0,0
2024-01-20,44,DPD90+,0,0,0
2024-01-20,46,Current,0,0,0
2024-01-20,46,DPD30-59,0,0,0
2024-01-20,48,Current,100,100,0
2024-01-20,48,DPD15-29,4,4,0
2024-01-20,48,DPD3-14,22,22,0
2024-01-20,48,DPD30-59,13,13,0
2024-01-20,48,DPD60-89,0,0,0
2024-01-20,48,DPD90+,0,0,0
2024-01-20,6,Current,0,0,0
2024-01-20,6,DPD3-14,0,0,0
2024-01-19,100,Current,0,0,0
2024-01-19,100,DPD15-29,1,1,0
2024-01-19,100,DPD3-14,1,1,0
2024-01-19,102,Current,1,1,0
2024-01-19,102,DPD15-29,1,1,0
2024-01-19,102,DPD3-14,1,1,0
2024-01-19,102,DPD30-59,0,0,0
2024-01-19,104,Current,0,0,0
2024-01-19,104,DPD30-59,0,0,0
2024-01-19,104,DPD60-89,0,0,0
2024-01-19,20,Current,440,440,0
2024-01-19,20,DPD15-29,279,279,0
2024-01-19,20,DPD3-14,483,483,0
2024-01-19,20,DPD30-59,218,218,0
2024-01-19,20,DPD60-89,86,86,0
2024-01-19,20,DPD90+,85,85,0
2024-01-19,22,Current,0,0,0
2024-01-19,22,DPD15-29,2,2,0
2024-01-19,22,DPD3-14,0,0,0
2024-01-19,22,DPD30-59,0,0,0
2024-01-19,22,DPD60-89,0,0,0
2024-01-19,22,DPD90+,0,0,0
2024-01-19,24,Current,381,381,0
2024-01-19,24,DPD15-29,146,146,0
2024-01-19,24,DPD3-14,244,244,0
2024-01-19,24,DPD30-59,101,101,0
2024-01-19,24,DPD60-89,0,0,0
2024-01-19,24,DPD90+,0,0,0
2024-01-19,26,Current,26,26,0
2024-01-19,26,DPD15-29,21,21,0
2024-01-19,26,DPD3-14,40,40,0
2024-01-19,26,DPD30-59,16,16,0
2024-01-19,26,DPD60-89,0,0,0
2024-01-19,26,DPD90+,0,0,0
2024-01-19,32,Current,141,141,0
2024-01-19,32,DPD15-29,132,132,0
2024-01-19,32,DPD3-14,205,205,0
2024-01-19,32,DPD30-59,114,114,0
2024-01-19,32,DPD60-89,0,0,0
2024-01-19,32,DPD90+,1,1,0
2024-01-19,34,Current,55,55,0
2024-01-19,34,DPD15-29,67,67,0
2024-01-19,34,DPD3-14,115,115,0
2024-01-19,34,DPD30-59,46,46,0
2024-01-19,34,DPD60-89,0,0,0
2024-01-19,34,DPD90+,0,0,0
2024-01-19,36,Current,64,64,0
2024-01-19,36,DPD15-29,40,40,0
2024-01-19,36,DPD3-14,81,81,0
2024-01-19,36,DPD30-59,40,40,0
2024-01-19,36,DPD60-89,0,0,0
2024-01-19,36,DPD90+,0,0,0
2024-01-19,38,Current,42,42,0
2024-01-19,38,DPD15-29,28,28,0
2024-01-19,38,DPD3-14,74,74,0
2024-01-19,38,DPD30-59,19,19,0
2024-01-19,38,DPD60-89,0,0,0
2024-01-19,38,DPD90+,0,0,0
2024-01-19,40,Current,31,31,0
2024-01-19,40,DPD15-29,13,13,0
2024-01-19,40,DPD3-14,40,40,0
2024-01-19,40,DPD30-59,14,14,0
2024-01-19,40,DPD60-89,0,0,0
2024-01-19,40,DPD90+,0,0,0
2024-01-19,42,Current,29,29,0
2024-01-19,42,DPD15-29,15,15,0
2024-01-19,42,DPD3-14,29,29,0
2024-01-19,42,DPD30-59,7,7,0
2024-01-19,42,DPD60-89,0,0,0
2024-01-19,42,DPD90+,0,0,0
2024-01-19,44,Current,48,48,0
2024-01-19,44,DPD15-29,29,29,0
2024-01-19,44,DPD3-14,65,65,0
2024-01-19,44,DPD30-59,17,17,0
2024-01-19,44,DPD60-89,0,0,0
2024-01-19,44,DPD90+,0,0,0
2024-01-19,46,Current,0,0,0
2024-01-19,46,DPD30-59,0,0,0
2024-01-19,48,Current,205,205,0
2024-01-19,48,DPD15-29,16,16,0
2024-01-19,48,DPD3-14,38,38,0
2024-01-19,48,DPD30-59,14,14,0
2024-01-19,48,DPD60-89,0,0,0
2024-01-19,48,DPD90+,0,0,0
2024-01-19,6,Current,0,0,0
2024-01-19,6,DPD3-14,0,0,0
2024-01-18,100,Current,0,0,0
2024-01-18,100,DPD15-29,0,0,0
2024-01-18,100,DPD3-14,0,0,0
2024-01-18,102,Current,30,30,0
2024-01-18,102,DPD15-29,0,0,0
2024-01-18,102,DPD3-14,0,0,0
2024-01-18,102,DPD30-59,0,0,0
2024-01-18,104,Current,35,35,0
2024-01-18,104,DPD30-59,0,0,0
2024-01-18,104,DPD60-89,0,0,0
2024-01-18,20,Current,29653,29653,0
2024-01-18,20,DPD15-29,245,245,0
2024-01-18,20,DPD3-14,306,306,0
2024-01-18,20,DPD30-59,78,78,0
2024-01-18,20,DPD60-89,39,39,0
2024-01-18,20,DPD90+,108,108,0
2024-01-18,22,Current,0,0,0
2024-01-18,22,DPD15-29,0,0,0
2024-01-18,22,DPD3-14,0,0,0
2024-01-18,22,DPD30-59,0,0,0
2024-01-18,22,DPD60-89,0,0,0
2024-01-18,22,DPD90+,0,0,0
2024-01-18,24,Current,25315,25315,0
2024-01-18,24,DPD15-29,85,85,0
2024-01-18,24,DPD3-14,187,187,0
2024-01-18,24,DPD30-59,35,35,0
2024-01-18,24,DPD60-89,2,2,0
2024-01-18,24,DPD90+,0,0,0
2024-01-18,26,Current,3226,3226,0
2024-01-18,26,DPD15-29,19,19,0
2024-01-18,26,DPD3-14,26,26,0
2024-01-18,26,DPD30-59,4,4,0
2024-01-18,26,DPD60-89,0,0,0
2024-01-18,26,DPD90+,0,0,0
2024-01-18,32,Current,8977,8977,0
2024-01-18,32,DPD15-29,120,120,0
2024-01-18,32,DPD3-14,126,126,0
2024-01-18,32,DPD30-59,32,32,0
2024-01-18,32,DPD60-89,0,0,0
2024-01-18,32,DPD90+,1,1,0
2024-01-18,34,Current,3338,3338,0
2024-01-18,34,DPD15-29,53,53,0
2024-01-18,34,DPD3-14,59,59,0
2024-01-18,34,DPD30-59,13,13,0
2024-01-18,34,DPD60-89,0,0,0
2024-01-18,34,DPD90+,0,0,0
2024-01-18,36,Current,4697,4697,0
2024-01-18,36,DPD15-29,39,39,0
2024-01-18,36,DPD3-14,43,43,0
2024-01-18,36,DPD30-59,9,9,0
2024-01-18,36,DPD60-89,0,0,0
2024-01-18,36,DPD90+,0,0,0
2024-01-18,38,Current,5462,5462,0
2024-01-18,38,DPD15-29,18,18,0
2024-01-18,38,DPD3-14,40,40,0
2024-01-18,38,DPD30-59,5,5,0
2024-01-18,38,DPD60-89,1,1,0
2024-01-18,38,DPD90+,0,0,0
2024-01-18,40,Current,3686,3686,0
2024-01-18,40,DPD15-29,14,14,0
2024-01-18,40,DPD3-14,27,27,0
2024-01-18,40,DPD30-59,5,5,0
2024-01-18,40,DPD60-89,0,0,0
2024-01-18,40,DPD90+,0,0,0
2024-01-18,42,Current,1594,1594,0
2024-01-18,42,DPD15-29,8,8,0
2024-01-18,42,DPD3-14,16,16,0
2024-01-18,42,DPD30-59,2,2,0
2024-01-18,42,DPD60-89,0,0,0
2024-01-18,42,DPD90+,0,0,0
2024-01-18,44,Current,5406,5406,0
2024-01-18,44,DPD15-29,34,34,0
2024-01-18,44,DPD3-14,42,42,0
2024-01-18,44,DPD30-59,5,5,0
2024-01-18,44,DPD60-89,0,0,0
2024-01-18,44,DPD90+,0,0,0
2024-01-18,46,Current,25,25,0
2024-01-18,46,DPD15-29,1,1,0
2024-01-18,46,DPD30-59,1,1,0
2024-01-18,48,Current,5794,5794,0
2024-01-18,48,DPD15-29,12,12,0
2024-01-18,48,DPD3-14,26,26,0
2024-01-18,48,DPD30-59,3,3,0
2024-01-18,48,DPD60-89,0,0,0
2024-01-18,48,DPD90+,0,0,0
2024-01-18,6,Current,1,1,0
2024-01-18,6,DPD3-14,0,0,0
2024-01-17,100,Current,0,0,0
2024-01-17,100,DPD15-29,1,1,0
2024-01-17,100,DPD3-14,0,0,0
2024-01-17,102,Current,0,0,0
2024-01-17,102,DPD15-29,1,1,0
2024-01-17,102,DPD3-14,0,0,0
2024-01-17,104,Current,0,0,0
2024-01-17,104,DPD30-59,0,0,0
2024-01-17,104,DPD90+,0,0,0
2024-01-17,20,Current,21,21,0
2024-01-17,20,DPD15-29,298,298,0
2024-01-17,20,DPD3-14,323,323,0
2024-01-17,20,DPD30-59,57,57,0
2024-01-17,20,DPD60-89,14,14,0
2024-01-17,20,DPD90+,5,5,0
2024-01-17,22,Current,0,0,0
2024-01-17,22,DPD15-29,2,2,0
2024-01-17,22,DPD30-59,1,1,0
2024-01-17,22,DPD60-89,0,0,0
2024-01-17,22,DPD90+,0,0,0
2024-01-17,24,Current,29,29,0
2024-01-17,24,DPD15-29,143,143,0
2024-01-17,24,DPD3-14,176,176,0
2024-01-17,24,DPD30-59,44,44,0
2024-01-17,24,DPD60-89,0,0,0
2024-01-17,24,DPD90+,0,0,0
2024-01-17,26,Current,0,0,0
2024-01-17,26,DPD15-29,26,26,0
2024-01-17,26,DPD3-14,17,17,0
2024-01-17,26,DPD30-59,5,5,0
2024-01-17,26,DPD60-89,0,0,0
2024-01-17,26,DPD90+,0,0,0
2024-01-17,32,Current,0,0,0
2024-01-17,32,DPD15-29,156,156,0
2024-01-17,32,DPD3-14,113,113,0
2024-01-17,32,DPD30-59,53,53,0
2024-01-17,32,DPD60-89,0,0,0
2024-01-17,32,DPD90+,0,0,0
2024-01-17,34,Current,0,0,0
2024-01-17,34,DPD15-29,68,68,0
2024-01-17,34,DPD3-14,65,65,0
2024-01-17,34,DPD30-59,15,15,0
2024-01-17,34,DPD60-89,0,0,0
2024-01-17,34,DPD90+,0,0,0
2024-01-17,36,Current,0,0,0
2024-01-17,36,DPD15-29,45,45,0
2024-01-17,36,DPD3-14,53,53,0
2024-01-17,36,DPD30-59,13,13,0
2024-01-17,36,DPD60-89,0,0,0
2024-01-17,36,DPD90+,0,0,0
2024-01-17,38,Current,0,0,0
2024-01-17,38,DPD15-29,41,41,0
2024-01-17,38,DPD3-14,37,37,0
2024-01-17,38,DPD30-59,6,6,0
2024-01-17,38,DPD60-89,0,0,0
2024-01-17,38,DPD90+,0,0,0
2024-01-17,40,Current,0,0,0
2024-01-17,40,DPD15-29,21,21,0
2024-01-17,40,DPD3-14,19,19,0
2024-01-17,40,DPD30-59,7,7,0
2024-01-17,40,DPD60-89,0,0,0
2024-01-17,40,DPD90+,0,0,0
2024-01-17,42,Current,0,0,0
2024-01-17,42,DPD15-29,15,15,0
2024-01-17,42,DPD3-14,14,14,0
2024-01-17,42,DPD30-59,2,2,0
2024-01-17,42,DPD60-89,0,0,0
2024-01-17,42,DPD90+,0,0,0
2024-01-17,44,Current,0,0,0
2024-01-17,44,DPD15-29,33,33,0
2024-01-17,44,DPD3-14,33,33,0
2024-01-17,44,DPD30-59,12,12,0
2024-01-17,44,DPD60-89,0,0,0
2024-01-17,44,DPD90+,0,0,0
2024-01-17,46,Current,0,0,0
2024-01-17,46,DPD15-29,0,0,0
2024-01-17,46,DPD30-59,0,0,0
2024-01-17,48,Current,42,42,0
2024-01-17,48,DPD15-29,16,16,0
2024-01-17,48,DPD3-14,33,33,0
2024-01-17,48,DPD30-59,4,4,0
2024-01-17,48,DPD60-89,0,0,0
2024-01-17,48,DPD90+,0,0,0
2024-01-17,6,Current,0,0,0
2024-01-16,100,Current,0,0,0
2024-01-16,100,DPD15-29,0,0,0
2024-01-16,100,DPD3-14,0,0,0
2024-01-16,102,Current,0,0,0
2024-01-16,102,DPD15-29,0,0,0
2024-01-16,102,DPD3-14,0,0,0
2024-01-16,104,Current,0,0,0
2024-01-16,104,DPD30-59,1,1,0
2024-01-16,104,DPD90+,0,0,0
2024-01-16,20,Current,27,27,0
2024-01-16,20,DPD15-29,246,246,0
2024-01-16,20,DPD3-14,332,332,0
2024-01-16,20,DPD30-59,238,238,0
2024-01-16,20,DPD60-89,61,61,0
2024-01-16,20,DPD90+,5,5,0
2024-01-16,22,Current,0,0,0
2024-01-16,22,DPD15-29,1,1,0
2024-01-16,22,DPD3-14,2,2,0
2024-01-16,22,DPD30-59,0,0,0
2024-01-16,22,DPD60-89,0,0,0
2024-01-16,22,DPD90+,0,0,0
2024-01-16,24,Current,28,28,0
2024-01-16,24,DPD15-29,98,98,0
2024-01-16,24,DPD3-14,197,197,0
2024-01-16,24,DPD30-59,108,108,0
2024-01-16,24,DPD60-89,0,0,0
2024-01-16,24,DPD90+,0,0,0
2024-01-16,26,Current,0,0,0
2024-01-16,26,DPD15-29,19,19,0
2024-01-16,26,DPD3-14,27,27,0
2024-01-16,26,DPD30-59,16,16,0
2024-01-16,26,DPD60-89,0,0,0
2024-01-16,26,DPD90+,0,0,0
2024-01-16,32,Current,0,0,0
2024-01-16,32,DPD15-29,129,129,0
2024-01-16,32,DPD3-14,134,134,0
2024-01-16,32,DPD30-59,118,118,0
2024-01-16,32,DPD60-89,0,0,0
2024-01-16,32,DPD90+,0,0,0
2024-01-16,34,Current,0,0,0
2024-01-16,34,DPD15-29,51,51,0
2024-01-16,34,DPD3-14,61,61,0
2024-01-16,34,DPD30-59,44,44,0
2024-01-16,34,DPD60-89,0,0,0
2024-01-16,34,DPD90+,0,0,0
2024-01-16,36,Current,0,0,0
2024-01-16,36,DPD15-29,34,34,0
2024-01-16,36,DPD3-14,41,41,0
2024-01-16,36,DPD30-59,35,35,0
2024-01-16,36,DPD60-89,0,0,0
2024-01-16,36,DPD90+,0,0,0
2024-01-16,38,Current,0,0,0
2024-01-16,38,DPD15-29,17,17,0
2024-01-16,38,DPD3-14,48,48,0
2024-01-16,38,DPD30-59,28,28,0
2024-01-16,38,DPD60-89,0,0,0
2024-01-16,38,DPD90+,0,0,0
2024-01-16,40,Current,0,0,0
2024-01-16,40,DPD15-29,12,12,0
2024-01-16,40,DPD3-14,32,32,0
2024-01-16,40,DPD30-59,17,17,0
2024-01-16,40,DPD60-89,0,0,0
2024-01-16,40,DPD90+,0,0,0
2024-01-16,42,Current,0,0,0
2024-01-16,42,DPD15-29,8,8,0
2024-01-16,42,DPD3-14,22,22,0
2024-01-16,42,DPD30-59,14,14,0
2024-01-16,42,DPD60-89,0,0,0
2024-01-16,42,DPD90+,0,0,0
2024-01-16,44,Current,0,0,0
2024-01-16,44,DPD15-29,23,23,0
2024-01-16,44,DPD3-14,41,41,0
2024-01-16,44,DPD30-59,30,30,0
2024-01-16,44,DPD60-89,0,0,0
2024-01-16,44,DPD90+,0,0,0
2024-01-16,46,Current,0,0,0
2024-01-16,46,DPD15-29,0,0,0
2024-01-16,46,DPD30-59,1,1,0
2024-01-16,48,Current,38,38,0
2024-01-16,48,DPD15-29,10,10,0
2024-01-16,48,DPD3-14,33,33,0
2024-01-16,48,DPD30-59,13,13,0
2024-01-16,48,DPD60-89,0,0,0
2024-01-16,48,DPD90+,0,0,0
2024-01-16,6,Current,0,0,0
2024-01-15,100,Current,0,0,0
2024-01-15,100,DPD15-29,1,1,0
2024-01-15,100,DPD3-14,0,0,0
2024-01-15,102,Current,0,0,0
2024-01-15,102,DPD15-29,1,1,0
2024-01-15,102,DPD3-14,0,0,0
2024-01-15,102,DPD30-59,0,0,0
2024-01-15,104,Current,0,0,0
2024-01-15,104,DPD30-59,0,0,0
2024-01-15,104,DPD90+,0,0,0
2024-01-15,20,Current,5194,5194,0
2024-01-15,20,DPD15-29,316,316,0
2024-01-15,20,DPD3-14,467,467,0
2024-01-15,20,DPD30-59,301,301,0
2024-01-15,20,DPD60-89,156,156,0
2024-01-15,20,DPD90+,141,141,0
2024-01-15,22,Current,0,0,0
2024-01-15,22,DPD15-29,2,2,0
2024-01-15,22,DPD3-14,1,1,0
2024-01-15,22,DPD30-59,0,0,0
2024-01-15,22,DPD60-89,0,0,0
2024-01-15,22,DPD90+,0,0,0
2024-01-15,24,Current,3172,3172,0
2024-01-15,24,DPD15-29,136,136,0
2024-01-15,24,DPD3-14,243,243,0
2024-01-15,24,DPD30-59,148,148,0
2024-01-15,24,DPD60-89,7,7,0
2024-01-15,24,DPD90+,11,11,0
2024-01-15,26,Current,0,0,0
2024-01-15,26,DPD15-29,19,19,0
2024-01-15,26,DPD3-14,25,25,0
2024-01-15,26,DPD30-59,19,19,0
2024-01-15,26,DPD60-89,0,0,0
2024-01-15,26,DPD90+,0,0,0
2024-01-15,32,Current,285,285,0
2024-01-15,32,DPD15-29,145,145,0
2024-01-15,32,DPD3-14,160,160,0
2024-01-15,32,DPD30-59,141,141,0
2024-01-15,32,DPD60-89,8,8,0
2024-01-15,32,DPD90+,2,2,0
2024-01-15,34,Current,0,0,0
2024-01-15,34,DPD15-29,64,64,0
2024-01-15,34,DPD3-14,70,70,0
2024-01-15,34,DPD30-59,52,52,0
2024-01-15,34,DPD60-89,0,0,0
2024-01-15,34,DPD90+,0,0,0
2024-01-15,36,Current,307,307,0
2024-01-15,36,DPD15-29,53,53,0
2024-01-15,36,DPD3-14,61,61,0
2024-01-15,36,DPD30-59,48,48,0
2024-01-15,36,DPD60-89,2,2,0
2024-01-15,36,DPD90+,1,1,0
2024-01-15,38,Current,0,0,0
2024-01-15,38,DPD15-29,33,33,0
2024-01-15,38,DPD3-14,46,46,0
2024-01-15,38,DPD30-59,22,22,0
2024-01-15,38,DPD60-89,0,0,0
2024-01-15,38,DPD90+,0,0,0
2024-01-15,40,Current,338,338,0
2024-01-15,40,DPD15-29,24,24,0
2024-01-15,40,DPD3-14,30,30,0
2024-01-15,40,DPD30-59,16,16,0
2024-01-15,40,DPD60-89,2,2,0
2024-01-15,40,DPD90+,2,2,0
2024-01-15,42,Current,0,0,0
2024-01-15,42,DPD15-29,13,13,0
2024-01-15,42,DPD3-14,14,14,0
2024-01-15,42,DPD30-59,11,11,0
2024-01-15,42,DPD60-89,0,0,0
2024-01-15,42,DPD90+,0,0,0
2024-01-15,44,Current,211,211,0
2024-01-15,44,DPD15-29,30,30,0
2024-01-15,44,DPD3-14,46,46,0
2024-01-15,44,DPD30-59,17,17,0
2024-01-15,44,DPD60-89,1,1,0
2024-01-15,44,DPD90+,1,1,0
2024-01-15,46,Current,6,6,0
2024-01-15,46,DPD3-14,0,0,0
2024-01-15,46,DPD30-59,0,0,0
2024-01-15,48,Current,3555,3555,0
2024-01-15,48,DPD15-29,28,28,0
2024-01-15,48,DPD3-14,76,76,0
2024-01-15,48,DPD30-59,33,33,0
2024-01-15,48,DPD60-89,15,15,0
2024-01-15,48,DPD90+,6,6,0
2024-01-15,6,Current,0,0,0
2024-01-14,100,Current,0,0,0
2024-01-14,100,DPD15-29,0,0,0
2024-01-14,100,DPD3-14,0,0,0
2024-01-14,102,Current,0,0,0
2024-01-14,102,DPD15-29,1,1,0
2024-01-14,102,DPD3-14,0,0,0
2024-01-14,104,Current,0,0,0
2024-01-14,104,DPD30-59,0,0,0
2024-01-14,104,DPD90+,0,0,0
2024-01-14,20,Current,74,74,0
2024-01-14,20,DPD15-29,290,290,0
2024-01-14,20,DPD3-14,247,247,0
2024-01-14,20,DPD30-59,32,32,0
2024-01-14,20,DPD60-89,27,27,0
2024-01-14,20,DPD90+,17,17,0
2024-01-14,22,Current,0,0,0
2024-01-14,22,DPD15-29,1,1,0
2024-01-14,22,DPD3-14,1,1,0
2024-01-14,22,DPD30-59,0,0,0
2024-01-14,22,DPD90+,0,0,0
2024-01-14,24,Current,89,89,0
2024-01-14,24,DPD15-29,126,126,0
2024-01-14,24,DPD3-14,151,151,0
2024-01-14,24,DPD30-59,16,16,0
2024-01-14,24,DPD60-89,0,0,0
2024-01-14,24,DPD90+,0,0,0
2024-01-14,26,Current,0,0,0
2024-01-14,26,DPD15-29,25,25,0
2024-01-14,26,DPD3-14,22,22,0
2024-01-14,26,DPD30-59,2,2,0
2024-01-14,26,DPD60-89,0,0,0
2024-01-14,26,DPD90+,0,0,0
2024-01-14,32,Current,0,0,0
2024-01-14,32,DPD15-29,157,157,0
2024-01-14,32,DPD3-14,112,112,0
2024-01-14,32,DPD30-59,19,19,0
2024-01-14,32,DPD60-89,0,0,0
2024-01-14,32,DPD90+,0,0,0
2024-01-14,34,Current,0,0,0
2024-01-14,34,DPD15-29,59,59,0
2024-01-14,34,DPD3-14,48,48,0
2024-01-14,34,DPD30-59,3,3,0
2024-01-14,34,DPD60-89,0,0,0
2024-01-14,34,DPD90+,0,0,0
2024-01-14,36,Current,0,0,0
2024-01-14,36,DPD15-29,42,42,0
2024-01-14,36,DPD3-14,33,33,0
2024-01-14,36,DPD30-59,3,3,0
2024-01-14,36,DPD60-89,0,0,0
2024-01-14,36,DPD90+,0,0,0
2024-01-14,38,Current,0,0,0
2024-01-14,38,DPD15-29,25,25,0
2024-01-14,38,DPD3-14,37,37,0
2024-01-14,38,DPD30-59,2,2,0
2024-01-14,38,DPD60-89,0,0,0
2024-01-14,38,DPD90+,0,0,0
2024-01-14,40,Current,0,0,0
2024-01-14,40,DPD15-29,19,19,0
2024-01-14,40,DPD3-14,25,25,0
2024-01-14,40,DPD30-59,4,4,0
2024-01-14,40,DPD60-89,0,0,0
2024-01-14,40,DPD90+,0,0,0
2024-01-14,42,Current,0,0,0
2024-01-14,42,DPD15-29,13,13,0
2024-01-14,42,DPD3-14,13,13,0
2024-01-14,42,DPD30-59,1,1,0
2024-01-14,42,DPD60-89,0,0,0
2024-01-14,42,DPD90+,0,0,0
2024-01-14,44,Current,0,0,0
2024-01-14,44,DPD15-29,29,29,0
2024-01-14,44,DPD3-14,35,35,0
2024-01-14,44,DPD30-59,5,5,0
2024-01-14,44,DPD60-89,0,0,0
2024-01-14,44,DPD90+,0,0,0
2024-01-14,46,Current,0,0,0
2024-01-14,46,DPD3-14,1,1,0
2024-01-14,46,DPD30-59,0,0,0
2024-01-14,48,Current,93,93,0
2024-01-14,48,DPD15-29,11,11,0
2024-01-14,48,DPD3-14,24,24,0
2024-01-14,48,DPD30-59,3,3,0
2024-01-14,48,DPD60-89,0,0,0
2024-01-14,48,DPD90+,0,0,0
2024-01-14,6,Current,0,0,0
2024-01-13,100,Current,0,0,0
2024-01-13,100,DPD15-29,1,1,0
2024-01-13,100,DPD3-14,0,0,0
2024-01-13,102,Current,0,0,0
2024-01-13,102,DPD15-29,1,1,0
2024-01-13,102,DPD3-14,0,0,0
2024-01-13,104,Current,0,0,0
2024-01-13,104,DPD30-59,1,1,0
2024-01-13,104,DPD90+,0,0,0
2024-01-13,20,Current,91,91,0
2024-01-13,20,DPD15-29,297,297,0
2024-01-13,20,DPD3-14,322,322,0
2024-01-13,20,DPD30-59,247,247,0
2024-01-13,20,DPD60-89,104,104,0
2024-01-13,20,DPD90+,6,6,0
2024-01-13,22,Current,0,0,0
2024-01-13,22,DPD15-29,2,2,0
2024-01-13,22,DPD3-14,0,0,0
2024-01-13,22,DPD30-59,0,0,0
2024-01-13,22,DPD90+,0,0,0
2024-01-13,24,Current,83,83,0
2024-01-13,24,DPD15-29,137,137,0
2024-01-13,24,DPD3-14,175,175,0
2024-01-13,24,DPD30-59,110,110,0
2024-01-13,24,DPD60-89,0,0,0
2024-01-13,24,DPD90+,0,0,0
2024-01-13,26,Current,0,0,0
2024-01-13,26,DPD15-29,19,19,0
2024-01-13,26,DPD3-14,21,21,0
2024-01-13,26,DPD30-59,11,11,0
2024-01-13,26,DPD60-89,0,0,0
2024-01-13,26,DPD90+,0,0,0
2024-01-13,32,Current,0,0,0
2024-01-13,32,DPD15-29,149,149,0
2024-01-13,32,DPD3-14,141,141,0
2024-01-13,32,DPD30-59,117,117,0
2024-01-13,32,DPD60-89,0,0,0
2024-01-13,32,DPD90+,0,0,0
2024-01-13,34,Current,0,0,0
2024-01-13,34,DPD15-29,70,70,0
2024-01-13,34,DPD3-14,63,63,0
2024-01-13,34,DPD30-59,55,55,0
2024-01-13,34,DPD60-89,0,0,0
2024-01-13,34,DPD90+,0,0,0
2024-01-13,36,Current,0,0,0
2024-01-13,36,DPD15-29,53,53,0
2024-01-13,36,DPD3-14,51,51,0
2024-01-13,36,DPD30-59,37,37,0
2024-01-13,36,DPD60-89,0,0,0
2024-01-13,36,DPD90+,0,0,0
2024-01-13,38,Current,0,0,0
2024-01-13,38,DPD15-29,39,39,0
2024-01-13,38,DPD3-14,41,41,0
2024-01-13,38,DPD30-59,26,26,0
2024-01-13,38,DPD60-89,0,0,0
2024-01-13,38,DPD90+,0,0,0
2024-01-13,40,Current,0,0,0
2024-01-13,40,DPD15-29,19,19,0
2024-01-13,40,DPD3-14,24,24,0
2024-01-13,40,DPD30-59,13,13,0
2024-01-13,40,DPD60-89,0,0,0
2024-01-13,40,DPD90+,0,0,0
2024-01-13,42,Current,0,0,0
2024-01-13,42,DPD15-29,16,16,0
2024-01-13,42,DPD3-14,14,14,0
2024-01-13,42,DPD30-59,12,12,0
2024-01-13,42,DPD60-89,0,0,0
2024-01-13,42,DPD90+,0,0,0
2024-01-13,44,Current,0,0,0
2024-01-13,44,DPD15-29,31,31,0
2024-01-13,44,DPD3-14,38,38,0
2024-01-13,44,DPD30-59,26,26,0
2024-01-13,44,DPD60-89,0,0,0
2024-01-13,44,DPD90+,0,0,0
2024-01-13,46,Current,0,0,0
2024-01-13,46,DPD3-14,0,0,0
2024-01-13,46,DPD30-59,1,1,0
2024-01-13,48,Current,92,92,0
2024-01-13,48,DPD15-29,15,15,0
2024-01-13,48,DPD3-14,27,27,0
2024-01-13,48,DPD30-59,16,16,0
2024-01-13,48,DPD60-89,0,0,0
2024-01-13,48,DPD90+,0,0,0
2024-01-13,6,Current,0,0,0
2024-01-12,100,Current,0,0,0
2024-01-12,100,DPD15-29,0,0,0
2024-01-12,100,DPD3-14,0,0,0
2024-01-12,102,Current,0,0,0
2024-01-12,102,DPD15-29,1,1,0
2024-01-12,102,DPD3-14,0,0,0
2024-01-12,104,Current,0,0,0
2024-01-12,104,DPD30-59,0,0,0
2024-01-12,104,DPD90+,0,0,0
2024-01-12,20,Current,556,556,0
2024-01-12,20,DPD15-29,314,314,0
2024-01-12,20,DPD3-14,191,191,0
2024-01-12,20,DPD30-59,41,41,0
2024-01-12,20,DPD60-89,9,9,0
2024-01-12,20,DPD90+,1,1,0
2024-01-12,22,Current,0,0,0
2024-01-12,22,DPD15-29,2,2,0
2024-01-12,22,DPD3-14,1,1,0
2024-01-12,22,DPD30-59,0,0,0
2024-01-12,22,DPD90+,0,0,0
2024-01-12,24,Current,436,436,0
2024-01-12,24,DPD15-29,140,140,0
2024-01-12,24,DPD3-14,104,104,0
2024-01-12,24,DPD30-59,16,16,0
2024-01-12,24,DPD60-89,0,0,0
2024-01-12,24,DPD90+,0,0,0
2024-01-12,26,Current,33,33,0
2024-01-12,26,DPD15-29,29,29,0
2024-01-12,26,DPD3-14,21,21,0
2024-01-12,26,DPD30-59,2,2,0
2024-01-12,26,DPD60-89,0,0,0
2024-01-12,26,DPD90+,0,0,0
2024-01-12,32,Current,114,114,0
2024-01-12,32,DPD15-29,169,169,0
2024-01-12,32,DPD3-14,86,86,0
2024-01-12,32,DPD30-59,11,11,0
2024-01-12,32,DPD60-89,0,0,0
2024-01-12,32,DPD90+,0,0,0
2024-01-12,34,Current,58,58,0
2024-01-12,34,DPD15-29,58,58,0
2024-01-12,34,DPD3-14,40,40,0
2024-01-12,34,DPD30-59,7,7,0
2024-01-12,34,DPD60-89,0,0,0
2024-01-12,34,DPD90+,0,0,0
2024-01-12,36,Current,71,71,0
2024-01-12,36,DPD15-29,49,49,0
2024-01-12,36,DPD3-14,20,20,0
2024-01-12,36,DPD30-59,2,2,0
2024-01-12,36,DPD60-89,0,0,0
2024-01-12,36,DPD90+,0,0,0
2024-01-12,38,Current,63,63,0
2024-01-12,38,DPD15-29,32,32,0
2024-01-12,38,DPD3-14,32,32,0
2024-01-12,38,DPD30-59,2,2,0
2024-01-12,38,DPD60-89,0,0,0
2024-01-12,38,DPD90+,0,0,0
2024-01-12,40,Current,54,54,0
2024-01-12,40,DPD15-29,20,20,0
2024-01-12,40,DPD3-14,19,19,0
2024-01-12,40,DPD30-59,2,2,0
2024-01-12,40,DPD60-89,0,0,0
2024-01-12,40,DPD90+,0,0,0
2024-01-12,42,Current,16,16,0
2024-01-12,42,DPD15-29,13,13,0
2024-01-12,42,DPD3-14,12,12,0
2024-01-12,42,DPD30-59,2,2,0
2024-01-12,42,DPD60-89,0,0,0
2024-01-12,42,DPD90+,0,0,0
2024-01-12,44,Current,65,65,0
2024-01-12,44,DPD15-29,37,37,0
2024-01-12,44,DPD3-14,33,33,0
2024-01-12,44,DPD30-59,7,7,0
2024-01-12,44,DPD60-89,0,0,0
2024-01-12,44,DPD90+,0,0,0
2024-01-12,46,Current,1,1,0
2024-01-12,46,DPD3-14,1,1,0
2024-01-12,46,DPD30-59,0,0,0
2024-01-12,48,Current,196,196,0
2024-01-12,48,DPD15-29,12,12,0
2024-01-12,48,DPD3-14,19,19,0
2024-01-12,48,DPD30-59,4,4,0
2024-01-12,48,DPD60-89,0,0,0
2024-01-12,48,DPD90+,0,0,0
2024-01-12,6,Current,0,0,0
2024-01-11,100,Current,0,0,0
2024-01-11,100,DPD15-29,1,1,0
2024-01-11,100,DPD3-14,0,0,0
2024-01-11,102,Current,0,0,0
2024-01-11,102,DPD15-29,0,0,0
2024-01-11,102,DPD3-14,1,1,0
2024-01-11,104,Current,0,0,0
2024-01-11,104,DPD30-59,0,0,0
2024-01-11,104,DPD90+,0,0,0
2024-01-11,20,Current,47,47,0
2024-01-11,20,DPD15-29,274,274,0
2024-01-11,20,DPD3-14,445,445,0
2024-01-11,20,DPD30-59,226,226,0
2024-01-11,20,DPD60-89,63,63,0
2024-01-11,20,DPD90+,85,85,0
2024-01-11,22,Current,0,0,0
2024-01-11,22,DPD15-29,1,1,0
2024-01-11,22,DPD3-14,2,2,0
2024-01-11,22,DPD30-59,0,0,0
2024-01-11,22,DPD90+,0,0,0
2024-01-11,24,Current,42,42,0
2024-01-11,24,DPD15-29,125,125,0
2024-01-11,24,DPD3-14,219,219,0
2024-01-11,24,DPD30-59,124,124,0
2024-01-11,24,DPD60-89,0,0,0
2024-01-11,24,DPD90+,0,0,0
2024-01-11,26,Current,0,0,0
2024-01-11,26,DPD15-29,16,16,0
2024-01-11,26,DPD3-14,30,30,0
2024-01-11,26,DPD30-59,18,18,0
2024-01-11,26,DPD60-89,0,0,0
2024-01-11,26,DPD90+,0,0,0
2024-01-11,32,Current,0,0,0
2024-01-11,32,DPD15-29,137,137,0
2024-01-11,32,DPD3-14,171,171,0
2024-01-11,32,DPD30-59,134,134,0
2024-01-11,32,DPD60-89,0,0,0
2024-01-11,32,DPD90+,0,0,0
2024-01-11,34,Current,0,0,0
2024-01-11,34,DPD15-29,57,57,0
2024-01-11,34,DPD3-14,86,86,0
2024-01-11,34,DPD30-59,46,46,0
2024-01-11,34,DPD60-89,0,0,0
2024-01-11,34,DPD90+,0,0,0
2024-01-11,36,Current,0,0,0
2024-01-11,36,DPD15-29,42,42,0
2024-01-11,36,DPD3-14,67,67,0
2024-01-11,36,DPD30-59,39,39,0
2024-01-11,36,DPD60-89,0,0,0
2024-01-11,36,DPD90+,0,0,0
2024-01-11,38,Current,0,0,0
2024-01-11,38,DPD15-29,38,38,0
2024-01-11,38,DPD3-14,47,47,0
2024-01-11,38,DPD30-59,17,17,0
2024-01-11,38,DPD60-89,0,0,0
2024-01-11,38,DPD90+,0,0,0
2024-01-11,40,Current,0,0,0
2024-01-11,40,DPD15-29,18,18,0
2024-01-11,40,DPD3-14,32,32,0
2024-01-11,40,DPD30-59,18,18,0
2024-01-11,40,DPD60-89,0,0,0
2024-01-11,40,DPD90+,0,0,0
2024-01-11,42,Current,0,0,0
2024-01-11,42,DPD15-29,18,18,0
2024-01-11,42,DPD3-14,17,17,0
2024-01-11,42,DPD30-59,8,8,0
2024-01-11,42,DPD60-89,0,0,0
2024-01-11,42,DPD90+,0,0,0
2024-01-11,44,Current,0,0,0
2024-01-11,44,DPD15-29,25,25,0
2024-01-11,44,DPD3-14,49,49,0
2024-01-11,44,DPD30-59,23,23,0
2024-01-11,44,DPD60-89,0,0,0
2024-01-11,44,DPD90+,0,0,0
2024-01-11,46,Current,0,0,0
2024-01-11,46,DPD3-14,0,0,0
2024-01-11,46,DPD30-59,0,0,0
2024-01-11,48,Current,30,30,0
2024-01-11,48,DPD15-29,15,15,0
2024-01-11,48,DPD3-14,31,31,0
2024-01-11,48,DPD30-59,16,16,0
2024-01-11,48,DPD60-89,0,0,0
2024-01-11,48,DPD90+,0,0,0
2024-01-11,6,Current,0,0,0
2024-01-10,100,Current,0,0,0
2024-01-10,100,DPD15-29,0,0,0
2024-01-10,100,DPD3-14,0,0,0
2024-01-10,102,Current,0,0,0
2024-01-10,102,DPD15-29,1,1,0
2024-01-10,102,DPD3-14,0,0,0
2024-01-10,104,Current,0,0,0
2024-01-10,104,DPD30-59,0,0,0
2024-01-10,104,DPD90+,0,0,0
2024-01-10,20,Current,39,39,0
2024-01-10,20,DPD15-29,319,319,0
2024-01-10,20,DPD3-14,203,203,0
2024-01-10,20,DPD30-59,34,34,0
2024-01-10,20,DPD60-89,43,43,0
2024-01-10,20,DPD90+,196,196,0
2024-01-10,22,Current,0,0,0
2024-01-10,22,DPD15-29,3,3,0
2024-01-10,22,DPD3-14,1,1,0
2024-01-10,22,DPD30-59,0,0,0
2024-01-10,22,DPD90+,0,0,0
2024-01-10,24,Current,20,20,0
2024-01-10,24,DPD15-29,143,143,0
2024-01-10,24,DPD3-14,105,105,0
2024-01-10,24,DPD30-59,12,12,0
2024-01-10,24,DPD60-89,0,0,0
2024-01-10,24,DPD90+,0,0,0
2024-01-10,26,Current,0,0,0
2024-01-10,26,DPD15-29,27,27,0
2024-01-10,26,DPD3-14,15,15,0
2024-01-10,26,DPD30-59,1,1,0
2024-01-10,26,DPD60-89,0,0,0
2024-01-10,26,DPD90+,0,0,0
2024-01-10,32,Current,0,0,0
2024-01-10,32,DPD15-29,163,163,0
2024-01-10,32,DPD3-14,67,67,0
2024-01-10,32,DPD30-59,24,24,0
2024-01-10,32,DPD60-89,0,0,0
2024-01-10,32,DPD90+,0,0,0
2024-01-10,34,Current,0,0,0
2024-01-10,34,DPD15-29,57,57,0
2024-01-10,34,DPD3-14,42,42,0
2024-01-10,34,DPD30-59,4,4,0
2024-01-10,34,DPD60-89,0,0,0
2024-01-10,34,DPD90+,0,0,0
2024-01-10,36,Current,0,0,0
2024-01-10,36,DPD15-29,46,46,0
2024-01-10,36,DPD3-14,35,35,0
2024-01-10,36,DPD30-59,4,4,0
2024-01-10,36,DPD60-89,0,0,0
2024-01-10,36,DPD90+,0,0,0
2024-01-10,38,Current,0,0,0
2024-01-10,38,DPD15-29,30,30,0
2024-01-10,38,DPD3-14,22,22,0
2024-01-10,38,DPD30-59,2,2,0
2024-01-10,38,DPD60-89,0,0,0
2024-01-10,38,DPD90+,0,0,0
2024-01-10,40,Current,0,0,0
2024-01-10,40,DPD15-29,18,18,0
2024-01-10,40,DPD3-14,19,19,0
2024-01-10,40,DPD30-59,5,5,0
2024-01-10,40,DPD60-89,0,0,0
2024-01-10,40,DPD90+,0,0,0
2024-01-10,42,Current,0,0,0
2024-01-10,42,DPD15-29,16,16,0
2024-01-10,42,DPD3-14,10,10,0
2024-01-10,42,DPD30-59,1,1,0
2024-01-10,42,DPD60-89,0,0,0
2024-01-10,42,DPD90+,0,0,0
2024-01-10,44,Current,0,0,0
2024-01-10,44,DPD15-29,41,41,0
2024-01-10,44,DPD3-14,29,29,0
2024-01-10,44,DPD30-59,5,5,0
2024-01-10,44,DPD60-89,0,0,0
2024-01-10,44,DPD90+,0,0,0
2024-01-10,46,Current,0,0,0
2024-01-10,46,DPD30-59,0,0,0
2024-01-10,48,Current,33,33,0
2024-01-10,48,DPD15-29,13,13,0
2024-01-10,48,DPD3-14,17,17,0
2024-01-10,48,DPD30-59,3,3,0
2024-01-10,48,DPD60-89,0,0,0
2024-01-10,48,DPD90+,0,0,0
2024-01-10,6,Current,0,0,0
2024-01-09,100,Current,0,0,0
2024-01-09,100,DPD3-14,1,1,0
2024-01-09,102,Current,0,0,0
2024-01-09,102,DPD15-29,0,0,0
2024-01-09,102,DPD3-14,1,1,0
2024-01-09,104,Current,0,0,0
2024-01-09,104,DPD30-59,1,1,0
2024-01-09,104,DPD90+,0,0,0
2024-01-09,20,Current,65,65,0
2024-01-09,20,DPD15-29,245,245,0
2024-01-09,20,DPD3-14,477,477,0
2024-01-09,20,DPD30-59,258,258,0
2024-01-09,20,DPD60-89,17,17,0
2024-01-09,20,DPD90+,2,2,0
2024-01-09,22,Current,0,0,0
2024-01-09,22,DPD15-29,0,0,0
2024-01-09,22,DPD3-14,3,3,0
2024-01-09,22,DPD30-59,0,0,0
2024-01-09,22,DPD90+,0,0,0
2024-01-09,24,Current,36,36,0
2024-01-09,24,DPD15-29,127,127,0
2024-01-09,24,DPD3-14,238,238,0
2024-01-09,24,DPD30-59,125,125,0
2024-01-09,24,DPD60-89,0,0,0
2024-01-09,24,DPD90+,0,0,0
2024-01-09,26,Current,0,0,0
2024-01-09,26,DPD15-29,15,15,0
2024-01-09,26,DPD3-14,32,32,0
2024-01-09,26,DPD30-59,17,17,0
2024-01-09,26,DPD60-89,0,0,0
2024-01-09,26,DPD90+,0,0,0
2024-01-09,32,Current,0,0,0
2024-01-09,32,DPD15-29,123,123,0
2024-01-09,32,DPD3-14,198,198,0
2024-01-09,32,DPD30-59,129,129,0
2024-01-09,32,DPD60-89,0,0,0
2024-01-09,32,DPD90+,0,0,0
2024-01-09,34,Current,0,0,0
2024-01-09,34,DPD15-29,49,49,0
2024-01-09,34,DPD3-14,94,94,0
2024-01-09,34,DPD30-59,62,62,0
2024-01-09,34,DPD60-89,0,0,0
2024-01-09,34,DPD90+,0,0,0
2024-01-09,36,Current,0,0,0
2024-01-09,36,DPD15-29,39,39,0
2024-01-09,36,DPD3-14,69,69,0
2024-01-09,36,DPD30-59,40,40,0
2024-01-09,36,DPD60-89,0,0,0
2024-01-09,36,DPD90+,0,0,0
2024-01-09,38,Current,0,0,0
2024-01-09,38,DPD15-29,39,39,0
2024-01-09,38,DPD3-14,53,53,0
2024-01-09,38,DPD30-59,33,33,0
2024-01-09,38,DPD60-89,0,0,0
2024-01-09,38,DPD90+,0,0,0
2024-01-09,40,Current,0,0,0
2024-01-09,40,DPD15-29,20,20,0
2024-01-09,40,DPD3-14,35,35,0
2024-01-09,40,DPD30-59,13,13,0
2024-01-09,40,DPD60-89,0,0,0
2024-01-09,40,DPD90+,0,0,0
2024-01-09,42,Current,0,0,0
2024-01-09,42,DPD15-29,14,14,0
2024-01-09,42,DPD3-14,19,19,0
2024-01-09,42,DPD30-59,17,17,0
2024-01-09,42,DPD60-89,0,0,0
2024-01-09,42,DPD90+,0,0,0
2024-01-09,44,Current,0,0,0
2024-01-09,44,DPD15-29,24,24,0
2024-01-09,44,DPD3-14,44,44,0
2024-01-09,44,DPD30-59,24,24,0
2024-01-09,44,DPD60-89,0,0,0
2024-01-09,44,DPD90+,0,0,0
2024-01-09,46,Current,0,0,0
2024-01-09,46,DPD30-59,1,1,0
2024-01-09,48,Current,51,51,0
2024-01-09,48,DPD15-29,14,14,0
2024-01-09,48,DPD3-14,41,41,0
2024-01-09,48,DPD30-59,17,17,0
2024-01-09,48,DPD60-89,0,0,0
2024-01-09,48,DPD90+,0,0,0
2024-01-09,6,Current,0,0,0
2024-01-08,100,Current,0,0,0
2024-01-08,100,DPD3-14,0,0,0
2024-01-08,102,Current,0,0,0
2024-01-08,102,DPD15-29,1,1,0
2024-01-08,102,DPD3-14,0,0,0
2024-01-08,104,Current,0,0,0
2024-01-08,104,DPD30-59,0,0,0
2024-01-08,104,DPD90+,0,0,0
2024-01-08,20,Current,88,88,0
2024-01-08,20,DPD15-29,356,356,0
2024-01-08,20,DPD3-14,239,239,0
2024-01-08,20,DPD30-59,46,46,0
2024-01-08,20,DPD60-89,108,108,0
2024-01-08,20,DPD90+,50,50,0
2024-01-08,22,Current,0,0,0
2024-01-08,22,DPD15-29,3,3,0
2024-01-08,22,DPD3-14,1,1,0
2024-01-08,22,DPD30-59,0,0,0
2024-01-08,22,DPD90+,0,0,0
2024-01-08,24,Current,52,52,0
2024-01-08,24,DPD15-29,162,162,0
2024-01-08,24,DPD3-14,123,123,0
2024-01-08,24,DPD30-59,16,16,0
2024-01-08,24,DPD60-89,0,0,0
2024-01-08,24,DPD90+,0,0,0
2024-01-08,26,Current,0,0,0
2024-01-08,26,DPD15-29,32,32,0
2024-01-08,26,DPD3-14,18,18,0
2024-01-08,26,DPD30-59,2,2,0
2024-01-08,26,DPD60-89,0,0,0
2024-01-08,26,DPD90+,0,0,0
2024-01-08,32,Current,0,0,0
2024-01-08,32,DPD15-29,161,161,0
2024-01-08,32,DPD3-14,128,128,0
2024-01-08,32,DPD30-59,21,21,0
2024-01-08,32,DPD60-89,0,0,0
2024-01-08,32,DPD90+,0,0,0
2024-01-08,34,Current,0,0,0
2024-01-08,34,DPD15-29,54,54,0
2024-01-08,34,DPD3-14,53,53,0
2024-01-08,34,DPD30-59,11,11,0
2024-01-08,34,DPD60-89,0,0,0
2024-01-08,34,DPD90+,0,0,0
2024-01-08,36,Current,0,0,0
2024-01-08,36,DPD15-29,40,40,0
2024-01-08,36,DPD3-14,49,49,0
2024-01-08,36,DPD30-59,5,5,0
2024-01-08,36,DPD60-89,0,0,0
2024-01-08,36,DPD90+,0,0,0
2024-01-08,38,Current,0,0,0
2024-01-08,38,DPD15-29,34,34,0
2024-01-08,38,DPD3-14,29,29,0
2024-01-08,38,DPD30-59,4,4,0
2024-01-08,38,DPD60-89,0,0,0
2024-01-08,38,DPD90+,0,0,0
2024-01-08,40,Current,0,0,0
2024-01-08,40,DPD15-29,25,25,0
2024-01-08,40,DPD3-14,20,20,0
2024-01-08,40,DPD30-59,6,6,0
2024-01-08,40,DPD60-89,0,0,0
2024-01-08,40,DPD90+,0,0,0
2024-01-08,42,Current,0,0,0
2024-01-08,42,DPD15-29,16,16,0
2024-01-08,42,DPD3-14,13,13,0
2024-01-08,42,DPD30-59,1,1,0
2024-01-08,42,DPD60-89,0,0,0
2024-01-08,42,DPD90+,0,0,0
2024-01-08,44,Current,0,0,0
2024-01-08,44,DPD15-29,42,42,0
2024-01-08,44,DPD3-14,36,36,0
2024-01-08,44,DPD30-59,7,7,0
2024-01-08,44,DPD60-89,0,0,0
2024-01-08,44,DPD90+,0,0,0
2024-01-08,46,Current,0,0,0
2024-01-08,46,DPD3-14,0,0,0
2024-01-08,46,DPD30-59,0,0,0
2024-01-08,48,Current,60,60,0
2024-01-08,48,DPD15-29,16,16,0
2024-01-08,48,DPD3-14,15,15,0
2024-01-08,48,DPD30-59,1,1,0
2024-01-08,48,DPD60-89,0,0,0
2024-01-08,48,DPD90+,0,0,0
2024-01-08,6,Current,0,0,0
2024-01-07,100,Current,0,0,0
2024-01-07,100,DPD3-14,1,1,0
2024-01-07,102,Current,0,0,0
2024-01-07,102,DPD15-29,0,0,0
2024-01-07,102,DPD3-14,1,1,0
2024-01-07,104,Current,0,0,0
2024-01-07,104,DPD30-59,0,0,0
2024-01-07,104,DPD90+,0,0,0
2024-01-07,20,Current,104,104,0
2024-01-07,20,DPD15-29,217,217,0
2024-01-07,20,DPD3-14,515,515,0
2024-01-07,20,DPD30-59,225,225,0
2024-01-07,20,DPD60-89,49,49,0
2024-01-07,20,DPD90+,3,3,0
2024-01-07,22,Current,0,0,0
2024-01-07,22,DPD15-29,1,1,0
2024-01-07,22,DPD3-14,3,3,0
2024-01-07,22,DPD30-59,0,0,0
2024-01-07,22,DPD90+,0,0,0
2024-01-07,24,Current,55,55,0
2024-01-07,24,DPD15-29,131,131,0
2024-01-07,24,DPD3-14,256,256,0
2024-01-07,24,DPD30-59,122,122,0
2024-01-07,24,DPD60-89,0,0,0
2024-01-07,24,DPD90+,0,0,0
2024-01-07,26,Current,0,0,0
2024-01-07,26,DPD15-29,14,14,0
2024-01-07,26,DPD3-14,40,40,0
2024-01-07,26,DPD30-59,19,19,0
2024-01-07,26,DPD60-89,0,0,0
2024-01-07,26,DPD90+,0,0,0
2024-01-07,32,Current,0,0,0
2024-01-07,32,DPD15-29,122,122,0
2024-01-07,32,DPD3-14,212,212,0
2024-01-07,32,DPD30-59,130,130,0
2024-01-07,32,DPD60-89,0,0,0
2024-01-07,32,DPD90+,0,0,0
2024-01-07,34,Current,0,0,0
2024-01-07,34,DPD15-29,48,48,0
2024-01-07,34,DPD3-14,93,93,0
2024-01-07,34,DPD30-59,43,43,0
2024-01-07,34,DPD60-89,0,0,0
2024-01-07,34,DPD90+,0,0,0
2024-01-07,36,Current,0,0,0
2024-01-07,36,DPD15-29,44,44,0
2024-01-07,36,DPD3-14,73,73,0
2024-01-07,36,DPD30-59,38,38,0
2024-01-07,36,DPD60-89,0,0,0
2024-01-07,36,DPD90+,0,0,0
2024-01-07,38,Current,0,0,0
2024-01-07,38,DPD15-29,36,36,0
2024-01-07,38,DPD3-14,66,66,0
2024-01-07,38,DPD30-59,19,19,0
2024-01-07,38,DPD60-89,0,0,0
2024-01-07,38,DPD90+,0,0,0
2024-01-07,40,Current,0,0,0
2024-01-07,40,DPD15-29,17,17,0
2024-01-07,40,DPD3-14,42,42,0
2024-01-07,40,DPD30-59,9,9,0
2024-01-07,40,DPD60-89,0,0,0
2024-01-07,40,DPD90+,0,0,0
2024-01-07,42,Current,0,0,0
2024-01-07,42,DPD15-29,12,12,0
2024-01-07,42,DPD3-14,29,29,0
2024-01-07,42,DPD30-59,5,5,0
2024-01-07,42,DPD60-89,0,0,0
2024-01-07,42,DPD90+,0,0,0
2024-01-07,44,Current,0,0,0
2024-01-07,44,DPD15-29,26,26,0
2024-01-07,44,DPD3-14,54,54,0
2024-01-07,44,DPD30-59,28,28,0
2024-01-07,44,DPD60-89,0,0,0
2024-01-07,44,DPD90+,0,0,0
2024-01-07,46,Current,0,0,0
2024-01-07,46,DPD3-14,1,1,0
2024-01-07,46,DPD30-59,1,1,0
2024-01-07,48,Current,75,75,0
2024-01-07,48,DPD15-29,13,13,0
2024-01-07,48,DPD3-14,39,39,0
2024-01-07,48,DPD30-59,14,14,0
2024-01-07,48,DPD60-89,0,0,0
2024-01-07,48,DPD90+,0,0,0
2024-01-07,6,Current,0,0,0
2024-01-06,100,Current,0,0,0
2024-01-06,100,DPD3-14,0,0,0
2024-01-06,102,Current,0,0,0
2024-01-06,102,DPD15-29,1,1,0
2024-01-06,102,DPD3-14,0,0,0
2024-01-06,104,Current,0,0,0
2024-01-06,104,DPD30-59,1,1,0
2024-01-06,104,DPD90+,0,0,0
2024-01-06,20,Current,110,110,0
2024-01-06,20,DPD15-29,349,349,0
2024-01-06,20,DPD3-14,232,232,0
2024-01-06,20,DPD30-59,242,242,0
2024-01-06,20,DPD60-89,44,44,0
2024-01-06,20,DPD90+,5,5,0
2024-01-06,22,Current,0,0,0
2024-01-06,22,DPD15-29,3,3,0
2024-01-06,22,DPD3-14,0,0,0
2024-01-06,22,DPD30-59,0,0,0
2024-01-06,22,DPD90+,0,0,0
2024-01-06,24,Current,71,71,0
2024-01-06,24,DPD15-29,154,154,0
2024-01-06,24,DPD3-14,115,115,0
2024-01-06,24,DPD30-59,107,107,0
2024-01-06,24,DPD60-89,0,0,0
2024-01-06,24,DPD90+,0,0,0
2024-01-06,26,Current,0,0,0
2024-01-06,26,DPD15-29,30,30,0
2024-01-06,26,DPD3-14,21,21,0
2024-01-06,26,DPD30-59,16,16,0
2024-01-06,26,DPD60-89,0,0,0
2024-01-06,26,DPD90+,0,0,0
2024-01-06,32,Current,0,0,0
2024-01-06,32,DPD15-29,152,152,0
2024-01-06,32,DPD3-14,144,144,0
2024-01-06,32,DPD30-59,126,126,0
2024-01-06,32,DPD60-89,0,0,0
2024-01-06,32,DPD90+,0,0,0
2024-01-06,34,Current,0,0,0
2024-01-06,34,DPD15-29,57,57,0
2024-01-06,34,DPD3-14,54,54,0
2024-01-06,34,DPD30-59,57,57,0
2024-01-06,34,DPD60-89,0,0,0
2024-01-06,34,DPD90+,0,0,0
2024-01-06,36,Current,0,0,0
2024-01-06,36,DPD15-29,40,40,0
2024-01-06,36,DPD3-14,47,47,0
2024-01-06,36,DPD30-59,33,33,0
2024-01-06,36,DPD60-89,0,0,0
2024-01-06,36,DPD90+,0,0,0
2024-01-06,38,Current,0,0,0
2024-01-06,38,DPD15-29,32,32,0
2024-01-06,38,DPD3-14,32,32,0
2024-01-06,38,DPD30-59,26,26,0
2024-01-06,38,DPD60-89,0,0,0
2024-01-06,38,DPD90+,0,0,0
2024-01-06,40,Current,0,0,0
2024-01-06,40,DPD15-29,32,32,0
2024-01-06,40,DPD3-14,17,17,0
2024-01-06,40,DPD30-59,16,16,0
2024-01-06,40,DPD60-89,0,0,0
2024-01-06,40,DPD90+,0,0,0
2024-01-06,42,Current,0,0,0
2024-01-06,42,DPD15-29,13,13,0
2024-01-06,42,DPD3-14,14,14,0
2024-01-06,42,DPD30-59,12,12,0
2024-01-06,42,DPD60-89,0,0,0
2024-01-06,42,DPD90+,0,0,0
2024-01-06,44,Current,0,0,0
2024-01-06,44,DPD15-29,41,41,0
2024-01-06,44,DPD3-14,38,38,0
2024-01-06,44,DPD30-59,23,23,0
2024-01-06,44,DPD60-89,0,0,0
2024-01-06,44,DPD90+,0,0,0
2024-01-06,46,Current,0,0,0
2024-01-06,46,DPD3-14,0,0,0
2024-01-06,46,DPD30-59,0,0,0
2024-01-06,48,Current,72,72,0
2024-01-06,48,DPD15-29,15,15,0
2024-01-06,48,DPD3-14,9,9,0
2024-01-06,48,DPD30-59,16,16,0
2024-01-06,48,DPD60-89,0,0,0
2024-01-06,48,DPD90+,0,0,0
2024-01-06,6,Current,0,0,0
2024-01-05,100,Current,0,0,0
2024-01-05,100,DPD3-14,1,1,0
2024-01-05,102,Current,0,0,0
2024-01-05,102,DPD15-29,0,0,0
2024-01-05,102,DPD3-14,1,1,0
2024-01-05,104,Current,1,1,0
2024-01-05,104,DPD30-59,0,0,0
2024-01-05,104,DPD90+,0,0,0
2024-01-05,20,Current,562,562,0
2024-01-05,20,DPD15-29,202,202,0
2024-01-05,20,DPD3-14,527,527,0
2024-01-05,20,DPD30-59,33,33,0
2024-01-05,20,DPD60-89,112,112,0
2024-01-05,20,DPD90+,5,5,0
2024-01-05,22,Current,0,0,0
2024-01-05,22,DPD15-29,0,0,0
2024-01-05,22,DPD3-14,4,4,0
2024-01-05,22,DPD30-59,0,0,0
2024-01-05,22,DPD90+,0,0,0
2024-01-05,24,Current,350,350,0
2024-01-05,24,DPD15-29,134,134,0
2024-01-05,24,DPD3-14,262,262,0
2024-01-05,24,DPD30-59,15,15,0
2024-01-05,24,DPD60-89,0,0,0
2024-01-05,24,DPD90+,0,0,0
2024-01-05,26,Current,22,22,0
2024-01-05,26,DPD15-29,14,14,0
2024-01-05,26,DPD3-14,44,44,0
2024-01-05,26,DPD30-59,0,0,0
2024-01-05,26,DPD60-89,0,0,0
2024-01-05,26,DPD90+,0,0,0
2024-01-05,32,Current,110,110,0
2024-01-05,32,DPD15-29,125,125,0
2024-01-05,32,DPD3-14,223,223,0
2024-01-05,32,DPD30-59,15,15,0
2024-01-05,32,DPD60-89,0,0,0
2024-01-05,32,DPD90+,0,0,0
2024-01-05,34,Current,35,35,0
2024-01-05,34,DPD15-29,49,49,0
2024-01-05,34,DPD3-14,89,89,0
2024-01-05,34,DPD30-59,7,7,0
2024-01-05,34,DPD60-89,0,0,0
2024-01-05,34,DPD90+,0,0,0
2024-01-05,36,Current,42,42,0
2024-01-05,36,DPD15-29,48,48,0
2024-01-05,36,DPD3-14,79,79,0
2024-01-05,36,DPD30-59,7,7,0
2024-01-05,36,DPD60-89,0,0,0
2024-01-05,36,DPD90+,0,0,0
2024-01-05,38,Current,56,56,0
2024-01-05,38,DPD15-29,40,40,0
2024-01-05,38,DPD3-14,84,84,0
2024-01-05,38,DPD30-59,6,6,0
2024-01-05,38,DPD60-89,0,0,0
2024-01-05,38,DPD90+,1,1,0
2024-01-05,40,Current,36,36,0
2024-01-05,40,DPD15-29,18,18,0
2024-01-05,40,DPD3-14,44,44,0
2024-01-05,40,DPD30-59,0,0,0
2024-01-05,40,DPD60-89,0,0,0
2024-01-05,40,DPD90+,0,0,0
2024-01-05,42,Current,18,18,0
2024-01-05,42,DPD15-29,12,12,0
2024-01-05,42,DPD3-14,32,32,0
2024-01-05,42,DPD30-59,4,4,0
2024-01-05,42,DPD60-89,0,0,0
2024-01-05,42,DPD90+,0,0,0
2024-01-05,44,Current,50,50,0
2024-01-05,44,DPD15-29,28,28,0
2024-01-05,44,DPD3-14,64,64,0
2024-01-05,44,DPD30-59,5,5,0
2024-01-05,44,DPD60-89,0,0,0
2024-01-05,44,DPD90+,0,0,0
2024-01-05,46,Current,0,0,0
2024-01-05,46,DPD15-29,1,1,0
2024-01-05,46,DPD3-14,1,1,0
2024-01-05,46,DPD30-59,1,1,0
2024-01-05,48,Current,221,221,0
2024-01-05,48,DPD15-29,14,14,0
2024-01-05,48,DPD3-14,36,36,0
2024-01-05,48,DPD30-59,3,3,0
2024-01-05,48,DPD60-89,0,0,0
2024-01-05,48,DPD90+,0,0,0
2024-01-05,6,Current,0,0,0
2024-01-04,100,Current,0,0,0
2024-01-04,100,DPD3-14,0,0,0
2024-01-04,102,Current,0,0,0
2024-01-04,102,DPD15-29,1,1,0
2024-01-04,102,DPD3-14,0,0,0
2024-01-04,104,Current,0,0,0
2024-01-04,104,DPD30-59,0,0,0
2024-01-04,104,DPD90+,0,0,0
2024-01-04,20,Current,17,17,0
2024-01-04,20,DPD15-29,372,372,0
2024-01-04,20,DPD3-14,302,302,0
2024-01-04,20,DPD30-59,191,191,0
2024-01-04,20,DPD60-89,72,72,0
2024-01-04,20,DPD90+,63,63,0
2024-01-04,22,Current,0,0,0
2024-01-04,22,DPD15-29,2,2,0
2024-01-04,22,DPD3-14,1,1,0
2024-01-04,22,DPD30-59,0,0,0
2024-01-04,22,DPD90+,0,0,0
2024-01-04,24,Current,14,14,0
2024-01-04,24,DPD15-29,169,169,0
2024-01-04,24,DPD3-14,125,125,0
2024-01-04,24,DPD30-59,77,77,0
2024-01-04,24,DPD60-89,0,0,0
2024-01-04,24,DPD90+,0,0,0
2024-01-04,26,Current,0,0,0
2024-01-04,26,DPD15-29,30,30,0
2024-01-04,26,DPD3-14,30,30,0
2024-01-04,26,DPD30-59,8,8,0
2024-01-04,26,DPD60-89,0,0,0
2024-01-04,26,DPD90+,0,0,0
2024-01-04,32,Current,0,0,0
2024-01-04,32,DPD15-29,155,155,0
2024-01-04,32,DPD3-14,161,161,0
2024-01-04,32,DPD30-59,95,95,0
2024-01-04,32,DPD60-89,0,0,0
2024-01-04,32,DPD90+,0,0,0
2024-01-04,34,Current,0,0,0
2024-01-04,34,DPD15-29,59,59,0
2024-01-04,34,DPD3-14,60,60,0
2024-01-04,34,DPD30-59,38,38,0
2024-01-04,34,DPD60-89,0,0,0
2024-01-04,34,DPD90+,0,0,0
2024-01-04,36,Current,0,0,0
2024-01-04,36,DPD15-29,46,46,0
2024-01-04,36,DPD3-14,52,52,0
2024-01-04,36,DPD30-59,27,27,0
2024-01-04,36,DPD60-89,0,0,0
2024-01-04,36,DPD90+,0,0,0
2024-01-04,38,Current,0,0,0
2024-01-04,38,DPD15-29,41,41,0
2024-01-04,38,DPD3-14,39,39,0
2024-01-04,38,DPD30-59,14,14,0
2024-01-04,38,DPD60-89,0,0,0
2024-01-04,38,DPD90+,0,0,0
2024-01-04,40,Current,0,0,0
2024-01-04,40,DPD15-29,34,34,0
2024-01-04,40,DPD3-14,23,23,0
2024-01-04,40,DPD30-59,5,5,0
2024-01-04,40,DPD60-89,0,0,0
2024-01-04,40,DPD90+,0,0,0
2024-01-04,42,Current,0,0,0
2024-01-04,42,DPD15-29,15,15,0
2024-01-04,42,DPD3-14,10,10,0
2024-01-04,42,DPD30-59,3,3,0
2024-01-04,42,DPD60-89,0,0,0
2024-01-04,42,DPD90+,0,0,0
2024-01-04,44,Current,0,0,0
2024-01-04,44,DPD15-29,48,48,0
2024-01-04,44,DPD3-14,42,42,0
2024-01-04,44,DPD30-59,19,19,0
2024-01-04,44,DPD60-89,0,0,0
2024-01-04,44,DPD90+,0,0,0
2024-01-04,46,Current,0,0,0
2024-01-04,46,DPD15-29,0,0,0
2024-01-04,46,DPD3-14,0,0,0
2024-01-04,46,DPD30-59,0,0,0
2024-01-04,48,Current,8,8,0
2024-01-04,48,DPD15-29,15,15,0
2024-01-04,48,DPD3-14,9,9,0
2024-01-04,48,DPD30-59,10,10,0
2024-01-04,48,DPD60-89,0,0,0
2024-01-04,48,DPD90+,0,0,0
2024-01-04,6,Current,0,0,0
2024-01-03,100,Current,0,0,0
2024-01-03,100,DPD3-14,1,1,0
2024-01-03,102,Current,0,0,0
2024-01-03,102,DPD15-29,0,0,0
2024-01-03,102,DPD3-14,1,1,0
2024-01-03,102,DPD90+,0,0,0
2024-01-03,104,Current,0,0,0
2024-01-03,104,DPD30-59,0,0,0
2024-01-03,104,DPD90+,0,0,0
2024-01-03,20,Current,67,67,0
2024-01-03,20,DPD15-29,168,168,0
2024-01-03,20,DPD3-14,494,494,0
2024-01-03,20,DPD30-59,93,93,0
2024-01-03,20,DPD60-89,6,6,0
2024-01-03,20,DPD90+,23,23,0
2024-01-03,22,Current,0,0,0
2024-01-03,22,DPD15-29,0,0,0
2024-01-03,22,DPD3-14,4,4,0
2024-01-03,22,DPD30-59,0,0,0
2024-01-03,22,DPD90+,0,0,0
2024-01-03,24,Current,45,45,0
2024-01-03,24,DPD15-29,108,108,0
2024-01-03,24,DPD3-14,269,269,0
2024-01-03,24,DPD30-59,71,71,0
2024-01-03,24,DPD60-89,0,0,0
2024-01-03,24,DPD90+,0,0,0
2024-01-03,26,Current,0,0,0
2024-01-03,26,DPD15-29,10,10,0
2024-01-03,26,DPD3-14,44,44,0
2024-01-03,26,DPD30-59,13,13,0
2024-01-03,26,DPD60-89,0,0,0
2024-01-03,26,DPD90+,0,0,0
2024-01-03,32,Current,0,0,0
2024-01-03,32,DPD15-29,108,108,0
2024-01-03,32,DPD3-14,222,222,0
2024-01-03,32,DPD30-59,61,61,0
2024-01-03,32,DPD60-89,0,0,0
2024-01-03,32,DPD90+,0,0,0
2024-01-03,34,Current,0,0,0
2024-01-03,34,DPD15-29,40,40,0
2024-01-03,34,DPD3-14,97,97,0
2024-01-03,34,DPD30-59,21,21,0
2024-01-03,34,DPD60-89,0,0,0
2024-01-03,34,DPD90+,0,0,0
2024-01-03,36,Current,0,0,0
2024-01-03,36,DPD15-29,43,43,0
2024-01-03,36,DPD3-14,77,77,0
2024-01-03,36,DPD30-59,23,23,0
2024-01-03,36,DPD60-89,0,0,0
2024-01-03,36,DPD90+,0,0,0
2024-01-03,38,Current,0,0,0
2024-01-03,38,DPD15-29,30,30,0
2024-01-03,38,DPD3-14,80,80,0
2024-01-03,38,DPD30-59,11,11,0
2024-01-03,38,DPD60-89,0,0,0
2024-01-03,38,DPD90+,0,0,0
2024-01-03,40,Current,0,0,0
2024-01-03,40,DPD15-29,16,16,0
2024-01-03,40,DPD3-14,35,35,0
2024-01-03,40,DPD30-59,8,8,0
2024-01-03,40,DPD60-89,0,0,0
2024-01-03,40,DPD90+,0,0,0
2024-01-03,42,Current,0,0,0
2024-01-03,42,DPD15-29,9,9,0
2024-01-03,42,DPD3-14,28,28,0
2024-01-03,42,DPD30-59,3,3,0
2024-01-03,42,DPD60-89,0,0,0
2024-01-03,42,DPD90+,0,0,0
2024-01-03,44,Current,0,0,0
2024-01-03,44,DPD15-29,30,30,0
2024-01-03,44,DPD3-14,42,42,0
2024-01-03,44,DPD30-59,15,15,0
2024-01-03,44,DPD60-89,0,0,0
2024-01-03,44,DPD90+,0,0,0
2024-01-03,46,Current,0,0,0
2024-01-03,46,DPD15-29,1,1,0
2024-01-03,48,Current,49,49,0
2024-01-03,48,DPD15-29,14,14,0
2024-01-03,48,DPD3-14,26,26,0
2024-01-03,48,DPD30-59,11,11,0
2024-01-03,48,DPD60-89,0,0,0
2024-01-03,48,DPD90+,0,0,0
2024-01-03,6,Current,0,0,0
2024-01-02,100,Current,0,0,0
2024-01-02,100,DPD3-14,0,0,0
2024-01-02,102,Current,0,0,0
2024-01-02,102,DPD15-29,1,1,0
2024-01-02,102,DPD3-14,1,1,0
2024-01-02,102,DPD90+,0,0,0
2024-01-02,104,Current,0,0,0
2024-01-02,104,DPD30-59,1,1,0
2024-01-02,104,DPD90+,0,0,0
2024-01-02,20,Current,4909,4909,0
2024-01-02,20,DPD15-29,458,458,0
2024-01-02,20,DPD3-14,591,591,0
2024-01-02,20,DPD30-59,323,323,0
2024-01-02,20,DPD60-89,90,90,0
2024-01-02,20,DPD90+,280,280,0
2024-01-02,22,Current,0,0,0
2024-01-02,22,DPD15-29,1,1,0
2024-01-02,22,DPD3-14,3,3,0
2024-01-02,22,DPD30-59,0,0,0
2024-01-02,22,DPD60-89,0,0,0
2024-01-02,22,DPD90+,0,0,0
2024-01-02,24,Current,3018,3018,0
2024-01-02,24,DPD15-29,219,219,0
2024-01-02,24,DPD3-14,252,252,0
2024-01-02,24,DPD30-59,137,137,0
2024-01-02,24,DPD60-89,13,13,0
2024-01-02,24,DPD90+,6,6,0
2024-01-02,26,Current,0,0,0
2024-01-02,26,DPD15-29,35,35,0
2024-01-02,26,DPD3-14,41,41,0
2024-01-02,26,DPD30-59,16,16,0
2024-01-02,26,DPD60-89,0,0,0
2024-01-02,26,DPD90+,0,0,0
2024-01-02,32,Current,285,285,0
2024-01-02,32,DPD15-29,175,175,0
2024-01-02,32,DPD3-14,236,236,0
2024-01-02,32,DPD30-59,155,155,0
2024-01-02,32,DPD60-89,4,4,0
2024-01-02,32,DPD90+,1,1,0
2024-01-02,34,Current,0,0,0
2024-01-02,34,DPD15-29,64,64,0
2024-01-02,34,DPD3-14,82,82,0
2024-01-02,34,DPD30-59,67,67,0
2024-01-02,34,DPD60-89,0,0,0
2024-01-02,34,DPD90+,0,0,0
2024-01-02,36,Current,315,315,0
2024-01-02,36,DPD15-29,50,50,0
2024-01-02,36,DPD3-14,73,73,0
2024-01-02,36,DPD30-59,32,32,0
2024-01-02,36,DPD60-89,2,2,0
2024-01-02,36,DPD90+,1,1,0
2024-01-02,38,Current,0,0,0
2024-01-02,38,DPD15-29,50,50,0
2024-01-02,38,DPD3-14,78,78,0
2024-01-02,38,DPD30-59,30,30,0
2024-01-02,38,DPD60-89,0,0,0
2024-01-02,38,DPD90+,0,0,0
2024-01-02,40,Current,344,344,0
2024-01-02,40,DPD15-29,47,47,0
2024-01-02,40,DPD3-14,51,51,0
2024-01-02,40,DPD30-59,16,16,0
2024-01-02,40,DPD60-89,1,1,0
2024-01-02,40,DPD90+,1,1,0
2024-01-02,42,Current,0,0,0
2024-01-02,42,DPD15-29,20,20,0
2024-01-02,42,DPD3-14,22,22,0
2024-01-02,42,DPD30-59,12,12,0
2024-01-02,42,DPD60-89,0,0,0
2024-01-02,42,DPD90+,0,0,0
2024-01-02,44,Current,214,214,0
2024-01-02,44,DPD15-29,53,53,0
2024-01-02,44,DPD3-14,65,65,0
2024-01-02,44,DPD30-59,22,22,0
2024-01-02,44,DPD60-89,1,1,0
2024-01-02,44,DPD90+,0,0,0
2024-01-02,46,Current,6,6,0
2024-01-02,46,DPD15-29,0,0,0
2024-01-02,48,Current,3337,3337,0
2024-01-02,48,DPD15-29,31,31,0
2024-01-02,48,DPD3-14,59,59,0
2024-01-02,48,DPD30-59,35,35,0
2024-01-02,48,DPD60-89,13,13,0
2024-01-02,48,DPD90+,3,3,0
2024-01-02,6,Current,0,0,0
2024-01-01,100,Current,0,0,0
2024-01-01,100,DPD3-14,1,1,0
2024-01-01,102,Current,0,0,0
2024-01-01,102,DPD15-29,0,0,0
2024-01-01,102,DPD3-14,1,1,0
2024-01-01,102,DPD90+,0,0,0
2024-01-01,104,Current,0,0,0
2024-01-01,104,DPD3-14,0,0,0
2024-01-01,104,DPD30-59,0,0,0
2024-01-01,104,DPD90+,0,0,0
2024-01-01,20,Current,110,110,0
2024-01-01,20,DPD15-29,146,146,0
2024-01-01,20,DPD3-14,554,554,0
2024-01-01,20,DPD30-59,5,5,0
2024-01-01,20,DPD60-89,1,1,0
2024-01-01,20,DPD90+,0,0,0
2024-01-01,22,Current,0,0,0
2024-01-01,22,DPD15-29,0,0,0
2024-01-01,22,DPD3-14,4,4,0
2024-01-01,22,DPD30-59,0,0,0
2024-01-01,22,DPD60-89,0,0,0
2024-01-01,22,DPD90+,0,0,0
2024-01-01,24,Current,70,70,0
2024-01-01,24,DPD15-29,94,94,0
2024-01-01,24,DPD3-14,301,301,0
2024-01-01,24,DPD30-59,0,0,0
2024-01-01,24,DPD60-89,0,0,0
2024-01-01,24,DPD90+,0,0,0
2024-01-01,26,Current,0,0,0
2024-01-01,26,DPD15-29,9,9,0
2024-01-01,26,DPD3-14,46,46,0
2024-01-01,26,DPD30-59,0,0,0
2024-01-01,26,DPD60-89,0,0,0
2024-01-01,26,DPD90+,0,0,0
2024-01-01,32,Current,0,0,0
2024-01-01,32,DPD15-29,94,94,0
2024-01-01,32,DPD3-14,244,244,0
2024-01-01,32,DPD30-59,4,4,0
2024-01-01,32,DPD60-89,0,0,0
2024-01-01,32,DPD90+,0,0,0
2024-01-01,34,Current,0,0,0
2024-01-01,34,DPD15-29,26,26,0
2024-01-01,34,DPD3-14,123,123,0
2024-01-01,34,DPD30-59,1,1,0
2024-01-01,34,DPD60-89,0,0,0
2024-01-01,34,DPD90+,0,0,0
2024-01-01,36,Current,0,0,0
2024-01-01,36,DPD15-29,31,31,0
2024-01-01,36,DPD3-14,98,98,0
2024-01-01,36,DPD30-59,2,2,0
2024-01-01,36,DPD60-89,0,0,0
2024-01-01,36,DPD90+,0,0,0
2024-01-01,38,Current,0,0,0
2024-01-01,38,DPD15-29,21,21,0
2024-01-01,38,DPD3-14,94,94,0
2024-01-01,38,DPD30-59,3,3,0
2024-01-01,38,DPD60-89,0,0,0
2024-01-01,38,DPD90+,0,0,0
2024-01-01,40,Current,0,0,0
2024-01-01,40,DPD15-29,14,14,0
2024-01-01,40,DPD3-14,44,44,0
2024-01-01,40,DPD30-59,1,1,0
2024-01-01,40,DPD60-89,0,0,0
2024-01-01,40,DPD90+,0,0,0
2024-01-01,42,Current,0,0,0
2024-01-01,42,DPD15-29,8,8,0
2024-01-01,42,DPD3-14,31,31,0
2024-01-01,42,DPD30-59,0,0,0
2024-01-01,42,DPD60-89,0,0,0
2024-01-01,42,DPD90+,0,0,0
2024-01-01,44,Current,0,0,0
2024-01-01,44,DPD15-29,24,24,0
2024-01-01,44,DPD3-14,52,52,0
2024-01-01,44,DPD30-59,0,0,0
2024-01-01,44,DPD60-89,0,0,0
2024-01-01,44,DPD90+,0,0,0
2024-01-01,46,Current,0,0,0
2024-01-01,46,DPD15-29,1,1,0
2024-01-01,48,Current,64,64,0
2024-01-01,48,DPD15-29,11,11,0
2024-01-01,48,DPD3-14,32,32,0
2024-01-01,48,DPD30-59,0,0,0
2024-01-01,48,DPD60-89,0,0,0
2024-01-01,48,DPD90+,0,0,0
2024-01-01,6,Current,0,0,0
2024-01-01,6,DPD3-14,0,0,0
2023-12-31,100,Current,0,0,0
2023-12-31,100,DPD3-14,0,0,0
2023-12-31,102,Current,0,0,0
2023-12-31,102,DPD15-29,0,0,0
2023-12-31,102,DPD3-14,2,2,0
2023-12-31,102,DPD90+,0,0,0
2023-12-31,104,Current,0,0,0
2023-12-31,104,DPD3-14,1,1,0
2023-12-31,104,DPD30-59,0,0,0
2023-12-31,104,DPD90+,0,0,0
2023-12-31,20,Current,184,184,0
2023-12-31,20,DPD15-29,395,395,0
2023-12-31,20,DPD3-14,527,527,0
2023-12-31,20,DPD30-59,237,237,0
2023-12-31,20,DPD60-89,152,152,0
2023-12-31,20,DPD90+,20,20,0
2023-12-31,22,Current,0,0,0
2023-12-31,22,DPD15-29,1,1,0
2023-12-31,22,DPD3-14,3,3,0
2023-12-31,22,DPD30-59,0,0,0
2023-12-31,22,DPD60-89,0,0,0
2023-12-31,22,DPD90+,0,0,0
2023-12-31,24,Current,85,85,0
2023-12-31,24,DPD15-29,187,187,0
2023-12-31,24,DPD3-14,255,255,0
2023-12-31,24,DPD30-59,81,81,0
2023-12-31,24,DPD60-89,0,0,0
2023-12-31,24,DPD90+,0,0,0
2023-12-31,26,Current,0,0,0
2023-12-31,26,DPD15-29,33,33,0
2023-12-31,26,DPD3-14,45,45,0
2023-12-31,26,DPD30-59,6,6,0
2023-12-31,26,DPD60-89,0,0,0
2023-12-31,26,DPD90+,0,0,0
2023-12-31,32,Current,0,0,0
2023-12-31,32,DPD15-29,155,155,0
2023-12-31,32,DPD3-14,260,260,0
2023-12-31,32,DPD30-59,98,98,0
2023-12-31,32,DPD60-89,0,0,0
2023-12-31,32,DPD90+,0,0,0
2023-12-31,34,Current,0,0,0
2023-12-31,34,DPD15-29,68,68,0
2023-12-31,34,DPD3-14,88,88,0
2023-12-31,34,DPD30-59,48,48,0
2023-12-31,34,DPD60-89,0,0,0
2023-12-31,34,DPD90+,0,0,0
2023-12-31,36,Current,0,0,0
2023-12-31,36,DPD15-29,44,44,0
2023-12-31,36,DPD3-14,76,76,0
2023-12-31,36,DPD30-59,33,33,0
2023-12-31,36,DPD60-89,0,0,0
2023-12-31,36,DPD90+,0,0,0
2023-12-31,38,Current,0,0,0
2023-12-31,38,DPD15-29,48,48,0
2023-12-31,38,DPD3-14,85,85,0
2023-12-31,38,DPD30-59,19,19,0
2023-12-31,38,DPD60-89,0,0,0
2023-12-31,38,DPD90+,0,0,0
2023-12-31,40,Current,0,0,0
2023-12-31,40,DPD15-29,34,34,0
2023-12-31,40,DPD3-14,53,53,0
2023-12-31,40,DPD30-59,5,5,0
2023-12-31,40,DPD60-89,0,0,0
2023-12-31,40,DPD90+,0,0,0
2023-12-31,42,Current,0,0,0
2023-12-31,42,DPD15-29,22,22,0
2023-12-31,42,DPD3-14,23,23,0
2023-12-31,42,DPD30-59,3,3,0
2023-12-31,42,DPD60-89,0,0,0
2023-12-31,42,DPD90+,0,0,0
2023-12-31,44,Current,0,0,0
2023-12-31,44,DPD15-29,55,55,0
2023-12-31,44,DPD3-14,69,69,0
2023-12-31,44,DPD30-59,20,20,0
2023-12-31,44,DPD60-89,0,0,0
2023-12-31,44,DPD90+,0,0,0
2023-12-31,46,Current,0,0,0
2023-12-31,46,DPD15-29,1,1,0
2023-12-31,46,DPD30-59,0,0,0
2023-12-31,48,Current,106,106,0
2023-12-31,48,DPD15-29,19,19,0
2023-12-31,48,DPD3-14,23,23,0
2023-12-31,48,DPD30-59,12,12,0
2023-12-31,48,DPD60-89,0,0,0
2023-12-31,48,DPD90+,0,0,0
2023-12-31,6,Current,0,0,0
2023-12-31,6,DPD3-14,1,1,0
2023-12-30,100,Current,0,0,0
2023-12-30,100,DPD3-14,1,1,0
2023-12-30,102,Current,0,0,0
2023-12-30,102,DPD15-29,0,0,0
2023-12-30,102,DPD3-14,0,0,0
2023-12-30,102,DPD90+,0,0,0
2023-12-30,104,Current,0,0,0
2023-12-30,104,DPD3-14,0,0,0
2023-12-30,104,DPD30-59,0,0,0
2023-12-30,104,DPD90+,0,0,0
2023-12-30,20,Current,108,108,0
2023-12-30,20,DPD15-29,79,79,0
2023-12-30,20,DPD3-14,389,389,0
2023-12-30,20,DPD30-59,80,80,0
2023-12-30,20,DPD60-89,21,21,0
2023-12-30,20,DPD90+,1,1,0
2023-12-30,22,Current,0,0,0
2023-12-30,22,DPD15-29,0,0,0
2023-12-30,22,DPD3-14,2,2,0
2023-12-30,22,DPD30-59,0,0,0
2023-12-30,22,DPD60-89,0,0,0
2023-12-30,22,DPD90+,0,0,0
2023-12-30,24,Current,50,50,0
2023-12-30,24,DPD15-29,51,51,0
2023-12-30,24,DPD3-14,225,225,0
2023-12-30,24,DPD30-59,53,53,0
2023-12-30,24,DPD60-89,0,0,0
2023-12-30,24,DPD90+,0,0,0
2023-12-30,26,Current,0,0,0
2023-12-30,26,DPD15-29,4,4,0
2023-12-30,26,DPD3-14,26,26,0
2023-12-30,26,DPD30-59,8,8,0
2023-12-30,26,DPD60-89,0,0,0
2023-12-30,26,DPD90+,0,0,0
2023-12-30,32,Current,0,0,0
2023-12-30,32,DPD15-29,60,60,0
2023-12-30,32,DPD3-14,181,181,0
2023-12-30,32,DPD30-59,47,47,0
2023-12-30,32,DPD60-89,0,0,0
2023-12-30,32,DPD90+,0,0,0
2023-12-30,34,Current,0,0,0
2023-12-30,34,DPD15-29,20,20,0
2023-12-30,34,DPD3-14,72,72,0
2023-12-30,34,DPD30-59,15,15,0
2023-12-30,34,DPD60-89,0,0,0
2023-12-30,34,DPD90+,0,0,0
2023-12-30,36,Current,0,0,0
2023-12-30,36,DPD15-29,20,20,0
2023-12-30,36,DPD3-14,68,68,0
2023-12-30,36,DPD30-59,20,20,0
2023-12-30,36,DPD60-89,0,0,0
2023-12-30,36,DPD90+,0,0,0
2023-12-30,38,Current,0,0,0
2023-12-30,38,DPD15-29,12,12,0
2023-12-30,38,DPD3-14,75,75,0
2023-12-30,38,DPD30-59,9,9,0
2023-12-30,38,DPD60-89,0,0,0
2023-12-30,38,DPD90+,0,0,0
2023-12-30,40,Current,0,0,0
2023-12-30,40,DPD15-29,9,9,0
2023-12-30,40,DPD3-14,27,27,0
2023-12-30,40,DPD30-59,8,8,0
2023-12-30,40,DPD60-89,0,0,0
2023-12-30,40,DPD90+,0,0,0
2023-12-30,42,Current,0,0,0
2023-12-30,42,DPD15-29,5,5,0
2023-12-30,42,DPD3-14,23,23,0
2023-12-30,42,DPD30-59,2,2,0
2023-12-30,42,DPD60-89,0,0,0
2023-12-30,42,DPD90+,0,0,0
2023-12-30,44,Current,0,0,0
2023-12-30,44,DPD15-29,14,14,0
2023-12-30,44,DPD3-14,39,39,0
2023-12-30,44,DPD30-59,14,14,0
2023-12-30,44,DPD60-89,0,0,0
2023-12-30,44,DPD90+,0,0,0
2023-12-30,46,Current,0,0,0
2023-12-30,46,DPD15-29,1,1,0
2023-12-30,48,Current,45,45,0
2023-12-30,48,DPD15-29,9,9,0
2023-12-30,48,DPD3-14,21,21,0
2023-12-30,48,DPD30-59,9,9,0
2023-12-30,48,DPD60-89,0,0,0
2023-12-30,48,DPD90+,0,0,0
2023-12-30,6,Current,0,0,0
2023-12-30,6,DPD3-14,0,0,0
2023-12-29,100,Current,0,0,0
2023-12-29,100,DPD3-14,0,0,0
2023-12-29,102,Current,0,0,0
2023-12-29,102,DPD15-29,0,0,0
2023-12-29,102,DPD3-14,2,2,0
2023-12-29,102,DPD90+,0,0,0
2023-12-29,104,Current,0,0,0
2023-12-29,104,DPD3-14,1,1,0
2023-12-29,104,DPD30-59,1,1,0
2023-12-29,104,DPD90+,0,0,0
2023-12-29,20,Current,436,436,0
2023-12-29,20,DPD15-29,332,332,0
2023-12-29,20,DPD3-14,581,581,0
2023-12-29,20,DPD30-59,225,225,0
2023-12-29,20,DPD60-89,37,37,0
2023-12-29,20,DPD90+,7,7,0
2023-12-29,22,Current,0,0,0
2023-12-29,22,DPD15-29,1,1,0
2023-12-29,22,DPD3-14,2,2,0
2023-12-29,22,DPD30-59,0,0,0
2023-12-29,22,DPD60-89,0,0,0
2023-12-29,22,DPD90+,0,0,0
2023-12-29,24,Current,236,236,0
2023-12-29,24,DPD15-29,154,154,0
2023-12-29,24,DPD3-14,273,273,0
2023-12-29,24,DPD30-59,102,102,0
2023-12-29,24,DPD60-89,0,0,0
2023-12-29,24,DPD90+,0,0,0
2023-12-29,26,Current,15,15,0
2023-12-29,26,DPD15-29,23,23,0
2023-12-29,26,DPD3-14,54,54,0
2023-12-29,26,DPD30-59,15,15,0
2023-12-29,26,DPD60-89,0,0,0
2023-12-29,26,DPD90+,0,0,0
2023-12-29,32,Current,69,69,0
2023-12-29,32,DPD15-29,124,124,0
2023-12-29,32,DPD3-14,265,265,0
2023-12-29,32,DPD30-59,129,129,0
2023-12-29,32,DPD60-89,0,0,0
2023-12-29,32,DPD90+,0,0,0
2023-12-29,34,Current,32,32,0
2023-12-29,34,DPD15-29,50,50,0
2023-12-29,34,DPD3-14,98,98,0
2023-12-29,34,DPD30-59,57,57,0
2023-12-29,34,DPD60-89,0,0,0
2023-12-29,34,DPD90+,0,0,0
2023-12-29,36,Current,28,28,0
2023-12-29,36,DPD15-29,33,33,0
2023-12-29,36,DPD3-14,81,81,0
2023-12-29,36,DPD30-59,27,27,0
2023-12-29,36,DPD60-89,0,0,0
2023-12-29,36,DPD90+,0,0,0
2023-12-29,38,Current,31,31,0
2023-12-29,38,DPD15-29,32,32,0
2023-12-29,38,DPD3-14,87,87,0
2023-12-29,38,DPD30-59,29,29,0
2023-12-29,38,DPD60-89,0,0,0
2023-12-29,38,DPD90+,0,0,0
2023-12-29,40,Current,21,21,0
2023-12-29,40,DPD15-29,24,24,0
2023-12-29,40,DPD3-14,53,53,0
2023-12-29,40,DPD30-59,17,17,0
2023-12-29,40,DPD60-89,0,0,0
2023-12-29,40,DPD90+,0,0,0
2023-12-29,42,Current,12,12,0
2023-12-29,42,DPD15-29,17,17,0
2023-12-29,42,DPD3-14,28,28,0
2023-12-29,42,DPD30-59,12,12,0
2023-12-29,42,DPD60-89,0,0,0
2023-12-29,42,DPD90+,0,0,0
2023-12-29,44,Current,25,25,0
2023-12-29,44,DPD15-29,42,42,0
2023-12-29,44,DPD3-14,77,77,0
2023-12-29,44,DPD30-59,18,18,0
2023-12-29,44,DPD60-89,0,0,0
2023-12-29,44,DPD90+,0,0,0
2023-12-29,46,Current,0,0,0
2023-12-29,46,DPD15-29,1,1,0
2023-12-29,48,Current,132,132,0
2023-12-29,48,DPD15-29,19,19,0
2023-12-29,48,DPD3-14,27,27,0
2023-12-29,48,DPD30-59,14,14,0
2023-12-29,48,DPD60-89,0,0,0
2023-12-29,48,DPD90+,0,0,0
2023-12-29,6,Current,0,0,0
2023-12-28,100,Current,0,0,0
2023-12-28,102,Current,0,0,0
2023-12-28,102,DPD15-29,0,0,0
2023-12-28,102,DPD3-14,0,0,0
2023-12-28,102,DPD90+,0,0,0
2023-12-28,104,Current,0,0,0
2023-12-28,104,DPD3-14,0,0,0
2023-12-28,104,DPD30-59,0,0,0
2023-12-28,104,DPD90+,0,0,0
2023-12-28,20,Current,26,26,0
2023-12-28,20,DPD15-29,28,28,0
2023-12-28,20,DPD3-14,467,467,0
2023-12-28,20,DPD30-59,224,224,0
2023-12-28,20,DPD60-89,120,120,0
2023-12-28,20,DPD90+,4,4,0
2023-12-28,22,Current,0,0,0
2023-12-28,22,DPD15-29,0,0,0
2023-12-28,22,DPD3-14,1,1,0
2023-12-28,22,DPD30-59,0,0,0
2023-12-28,22,DPD60-89,0,0,0
2023-12-28,24,Current,10,10,0
2023-12-28,24,DPD15-29,40,40,0
2023-12-28,24,DPD3-14,248,248,0
2023-12-28,24,DPD30-59,79,79,0
2023-12-28,24,DPD60-89,0,0,0
2023-12-28,24,DPD90+,0,0,0
2023-12-28,26,Current,0,0,0
2023-12-28,26,DPD15-29,3,3,0
2023-12-28,26,DPD3-14,35,35,0
2023-12-28,26,DPD30-59,8,8,0
2023-12-28,26,DPD60-89,0,0,0
2023-12-28,26,DPD90+,0,0,0
2023-12-28,32,Current,0,0,0
2023-12-28,32,DPD15-29,31,31,0
2023-12-28,32,DPD3-14,210,210,0
2023-12-28,32,DPD30-59,92,92,0
2023-12-28,32,DPD60-89,0,0,0
2023-12-28,32,DPD90+,0,0,0
2023-12-28,34,Current,0,0,0
2023-12-28,34,DPD15-29,16,16,0
2023-12-28,34,DPD3-14,80,80,0
2023-12-28,34,DPD30-59,46,46,0
2023-12-28,34,DPD60-89,0,0,0
2023-12-28,34,DPD90+,0,0,0
2023-12-28,36,Current,0,0,0
2023-12-28,36,DPD15-29,11,11,0
2023-12-28,36,DPD3-14,78,78,0
2023-12-28,36,DPD30-59,30,30,0
2023-12-28,36,DPD60-89,0,0,0
2023-12-28,36,DPD90+,0,0,0
2023-12-28,38,Current,0,0,0
2023-12-28,38,DPD15-29,10,10,0
2023-12-28,38,DPD3-14,76,76,0
2023-12-28,38,DPD30-59,18,18,0
2023-12-28,38,DPD60-89,0,0,0
2023-12-28,38,DPD90+,0,0,0
2023-12-28,40,Current,0,0,0
2023-12-28,40,DPD15-29,8,8,0
2023-12-28,40,DPD3-14,32,32,0
2023-12-28,40,DPD30-59,5,5,0
2023-12-28,40,DPD60-89,0,0,0
2023-12-28,40,DPD90+,0,0,0
2023-12-28,42,Current,0,0,0
2023-12-28,42,DPD15-29,2,2,0
2023-12-28,42,DPD3-14,22,22,0
2023-12-28,42,DPD30-59,3,3,0
2023-12-28,42,DPD60-89,0,0,0
2023-12-28,42,DPD90+,0,0,0
2023-12-28,44,Current,0,0,0
2023-12-28,44,DPD15-29,8,8,0
2023-12-28,44,DPD3-14,50,50,0
2023-12-28,44,DPD30-59,19,19,0
2023-12-28,44,DPD60-89,0,0,0
2023-12-28,44,DPD90+,0,0,0
2023-12-28,46,Current,0,0,0
2023-12-28,46,DPD15-29,1,1,0
2023-12-28,46,DPD3-14,1,1,0
2023-12-28,48,Current,18,18,0
2023-12-28,48,DPD15-29,5,5,0
2023-12-28,48,DPD3-14,25,25,0
2023-12-28,48,DPD30-59,13,13,0
2023-12-28,48,DPD60-89,0,0,0
2023-12-28,48,DPD90+,0,0,0
2023-12-28,6,Current,0,0,0
2023-12-27,100,Current,0,0,0
2023-12-27,100,DPD15-29,0,0,0
2023-12-27,100,DPD3-14,1,1,0
2023-12-27,102,Current,0,0,0
2023-12-27,102,DPD15-29,0,0,0
2023-12-27,102,DPD3-14,1,1,0
2023-12-27,102,DPD90+,0,0,0
2023-12-27,104,Current,0,0,0
2023-12-27,104,DPD3-14,1,1,0
2023-12-27,104,DPD30-59,0,0,0
2023-12-27,104,DPD90+,0,0,0
2023-12-27,20,Current,101,101,0
2023-12-27,20,DPD15-29,425,425,0
2023-12-27,20,DPD3-14,540,540,0
2023-12-27,20,DPD30-59,86,86,0
2023-12-27,20,DPD60-89,95,95,0
2023-12-27,20,DPD90+,6,6,0
2023-12-27,22,Current,0,0,0
2023-12-27,22,DPD15-29,1,1,0
2023-12-27,22,DPD3-14,2,2,0
2023-12-27,22,DPD30-59,0,0,0
2023-12-27,22,DPD60-89,0,0,0
2023-12-27,22,DPD90+,0,0,0
2023-12-27,24,Current,55,55,0
2023-12-27,24,DPD15-29,179,179,0
2023-12-27,24,DPD3-14,272,272,0
2023-12-27,24,DPD30-59,53,53,0
2023-12-27,24,DPD60-89,0,0,0
2023-12-27,24,DPD90+,0,0,0
2023-12-27,26,Current,0,0,0
2023-12-27,26,DPD15-29,33,33,0
2023-12-27,26,DPD3-14,52,52,0
2023-12-27,26,DPD30-59,10,10,0
2023-12-27,26,DPD60-89,0,0,0
2023-12-27,26,DPD90+,0,0,0
2023-12-27,32,Current,0,0,0
2023-12-27,32,DPD15-29,167,167,0
2023-12-27,32,DPD3-14,230,230,0
2023-12-27,32,DPD30-59,48,48,0
2023-12-27,32,DPD60-89,0,0,0
2023-12-27,32,DPD90+,0,0,0
2023-12-27,34,Current,0,0,0
2023-12-27,34,DPD15-29,70,70,0
2023-12-27,34,DPD3-14,78,78,0
2023-12-27,34,DPD30-59,22,22,0
2023-12-27,34,DPD60-89,0,0,0
2023-12-27,34,DPD90+,0,0,0
2023-12-27,36,Current,0,0,0
2023-12-27,36,DPD15-29,52,52,0
2023-12-27,36,DPD3-14,73,73,0
2023-12-27,36,DPD30-59,18,18,0
2023-12-27,36,DPD60-89,0,0,0
2023-12-27,36,DPD90+,0,0,0
2023-12-27,38,Current,0,0,0
2023-12-27,38,DPD15-29,35,35,0
2023-12-27,38,DPD3-14,87,87,0
2023-12-27,38,DPD30-59,6,6,0
2023-12-27,38,DPD60-89,0,0,0
2023-12-27,38,DPD90+,0,0,0
2023-12-27,40,Current,0,0,0
2023-12-27,40,DPD15-29,27,27,0
2023-12-27,40,DPD3-14,43,43,0
2023-12-27,40,DPD30-59,4,4,0
2023-12-27,40,DPD60-89,0,0,0
2023-12-27,40,DPD90+,0,0,0
2023-12-27,42,Current,0,0,0
2023-12-27,42,DPD15-29,18,18,0
2023-12-27,42,DPD3-14,25,25,0
2023-12-27,42,DPD30-59,3,3,0
2023-12-27,42,DPD60-89,0,0,0
2023-12-27,42,DPD90+,0,0,0
2023-12-27,44,Current,0,0,0
2023-12-27,44,DPD15-29,46,46,0
2023-12-27,44,DPD3-14,73,73,0
2023-12-27,44,DPD30-59,14,14,0
2023-12-27,44,DPD60-89,0,0,0
2023-12-27,44,DPD90+,0,0,0
2023-12-27,46,Current,0,0,0
2023-12-27,46,DPD15-29,1,1,0
2023-12-27,46,DPD3-14,0,0,0
2023-12-27,48,Current,63,63,0
2023-12-27,48,DPD15-29,19,19,0
2023-12-27,48,DPD3-14,27,27,0
2023-12-27,48,DPD30-59,7,7,0
2023-12-27,48,DPD60-89,0,0,0
2023-12-27,48,DPD90+,0,0,0
2023-12-27,6,Current,0,0,0
2023-12-26,100,Current,0,0,0
2023-12-26,100,DPD15-29,0,0,0
2023-12-26,100,DPD3-14,0,0,0
2023-12-26,102,Current,0,0,0
2023-12-26,102,DPD15-29,0,0,0
2023-12-26,102,DPD3-14,0,0,0
2023-12-26,102,DPD90+,0,0,0
2023-12-26,104,Current,0,0,0
2023-12-26,104,DPD3-14,0,0,0
2023-12-26,104,DPD30-59,0,0,0
2023-12-26,104,DPD90+,0,0,0
2023-12-26,20,Current,89,89,0
2023-12-26,20,DPD15-29,37,37,0
2023-12-26,20,DPD3-14,542,542,0
2023-12-26,20,DPD30-59,129,129,0
2023-12-26,20,DPD60-89,91,91,0
2023-12-26,20,DPD90+,295,295,0
2023-12-26,22,Current,0,0,0
2023-12-26,22,DPD15-29,1,1,0
2023-12-26,22,DPD3-14,2,2,0
2023-12-26,22,DPD30-59,0,0,0
2023-12-26,22,DPD60-89,0,0,0
2023-12-26,22,DPD90+,0,0,0
2023-12-26,24,Current,44,44,0
2023-12-26,24,DPD15-29,34,34,0
2023-12-26,24,DPD3-14,295,295,0
2023-12-26,24,DPD30-59,70,70,0
2023-12-26,24,DPD60-89,0,0,0
2023-12-26,24,DPD90+,0,0,0
2023-12-26,26,Current,0,0,0
2023-12-26,26,DPD15-29,4,4,0
2023-12-26,26,DPD3-14,37,37,0
2023-12-26,26,DPD30-59,13,13,0
2023-12-26,26,DPD60-89,0,0,0
2023-12-26,26,DPD90+,0,0,0
2023-12-26,32,Current,0,0,0
2023-12-26,32,DPD15-29,34,34,0
2023-12-26,32,DPD3-14,223,223,0
2023-12-26,32,DPD30-59,89,89,0
2023-12-26,32,DPD60-89,0,0,0
2023-12-26,32,DPD90+,0,0,0
2023-12-26,34,Current,0,0,0
2023-12-26,34,DPD15-29,24,24,0
2023-12-26,34,DPD3-14,89,89,0
2023-12-26,34,DPD30-59,38,38,0
2023-12-26,34,DPD60-89,0,0,0
2023-12-26,34,DPD90+,0,0,0
2023-12-26,36,Current,0,0,0
2023-12-26,36,DPD15-29,16,16,0
2023-12-26,36,DPD3-14,84,84,0
2023-12-26,36,DPD30-59,25,25,0
2023-12-26,36,DPD60-89,0,0,0
2023-12-26,36,DPD90+,0,0,0
2023-12-26,38,Current,0,0,0
2023-12-26,38,DPD15-29,13,13,0
2023-12-26,38,DPD3-14,88,88,0
2023-12-26,38,DPD30-59,15,15,0
2023-12-26,38,DPD60-89,0,0,0
2023-12-26,38,DPD90+,0,0,0
2023-12-26,40,Current,0,0,0
2023-12-26,40,DPD15-29,8,8,0
2023-12-26,40,DPD3-14,43,43,0
2023-12-26,40,DPD30-59,13,13,0
2023-12-26,40,DPD60-89,0,0,0
2023-12-26,40,DPD90+,0,0,0
2023-12-26,42,Current,0,0,0
2023-12-26,42,DPD15-29,3,3,0
2023-12-26,42,DPD3-14,24,24,0
2023-12-26,42,DPD30-59,5,5,0
2023-12-26,42,DPD60-89,0,0,0
2023-12-26,42,DPD90+,0,0,0
2023-12-26,44,Current,0,0,0
2023-12-26,44,DPD15-29,11,11,0
2023-12-26,44,DPD3-14,62,62,0
2023-12-26,44,DPD30-59,17,17,0
2023-12-26,44,DPD60-89,0,0,0
2023-12-26,44,DPD90+,0,0,0
2023-12-26,46,Current,0,0,0
2023-12-26,46,DPD15-29,1,1,0
2023-12-26,46,DPD3-14,1,1,0
2023-12-26,48,Current,61,61,0
2023-12-26,48,DPD15-29,3,3,0
2023-12-26,48,DPD3-14,31,31,0
2023-12-26,48,DPD30-59,6,6,0
2023-12-26,48,DPD60-89,0,0,0
2023-12-26,48,DPD90+,0,0,0
2023-12-26,6,Current,0,0,0
2023-12-25,100,Current,0,0,0
2023-12-25,100,DPD15-29,0,0,0
2023-12-25,100,DPD3-14,1,1,0
2023-12-25,102,Current,0,0,0
2023-12-25,102,DPD15-29,0,0,0
2023-12-25,102,DPD3-14,1,1,0
2023-12-25,102,DPD90+,0,0,0
2023-12-25,104,Current,0,0,0
2023-12-25,104,DPD3-14,1,1,0
2023-12-25,104,DPD30-59,1,1,0
2023-12-25,104,DPD90+,0,0,0
2023-12-25,20,Current,98,98,0
2023-12-25,20,DPD15-29,429,429,0
2023-12-25,20,DPD3-14,542,542,0
2023-12-25,20,DPD30-59,101,101,0
2023-12-25,20,DPD60-89,3,3,0
2023-12-25,20,DPD90+,1,1,0
2023-12-25,22,Current,0,0,0
2023-12-25,22,DPD15-29,0,0,0
2023-12-25,22,DPD3-14,3,3,0
2023-12-25,22,DPD30-59,0,0,0
2023-12-25,22,DPD60-89,0,0,0
2023-12-25,24,Current,57,57,0
2023-12-25,24,DPD15-29,165,165,0
2023-12-25,24,DPD3-14,265,265,0
2023-12-25,24,DPD30-59,44,44,0
2023-12-25,24,DPD60-89,0,0,0
2023-12-25,24,DPD90+,0,0,0
2023-12-25,26,Current,0,0,0
2023-12-25,26,DPD15-29,31,31,0
2023-12-25,26,DPD3-14,47,47,0
2023-12-25,26,DPD30-59,6,6,0
2023-12-25,26,DPD60-89,0,0,0
2023-12-25,26,DPD90+,0,0,0
2023-12-25,32,Current,0,0,0
2023-12-25,32,DPD15-29,161,161,0
2023-12-25,32,DPD3-14,216,216,0
2023-12-25,32,DPD30-59,49,49,0
2023-12-25,32,DPD60-89,0,0,0
2023-12-25,32,DPD90+,0,0,0
2023-12-25,34,Current,0,0,0
2023-12-25,34,DPD15-29,76,76,0
2023-12-25,34,DPD3-14,80,80,0
2023-12-25,34,DPD30-59,19,19,0
2023-12-25,34,DPD60-89,0,0,0
2023-12-25,34,DPD90+,0,0,0
2023-12-25,36,Current,0,0,0
2023-12-25,36,DPD15-29,53,53,0
2023-12-25,36,DPD3-14,68,68,0
2023-12-25,36,DPD30-59,9,9,0
2023-12-25,36,DPD60-89,0,0,0
2023-12-25,36,DPD90+,0,0,0
2023-12-25,38,Current,0,0,0
2023-12-25,38,DPD15-29,38,38,0
2023-12-25,38,DPD3-14,71,71,0
2023-12-25,38,DPD30-59,15,15,0
2023-12-25,38,DPD60-89,0,0,0
2023-12-25,38,DPD90+,0,0,0
2023-12-25,40,Current,0,0,0
2023-12-25,40,DPD15-29,25,25,0
2023-12-25,40,DPD3-14,46,46,0
2023-12-25,40,DPD30-59,5,5,0
2023-12-25,40,DPD60-89,0,0,0
2023-12-25,40,DPD90+,0,0,0
2023-12-25,42,Current,0,0,0
2023-12-25,42,DPD15-29,19,19,0
2023-12-25,42,DPD3-14,26,26,0
2023-12-25,42,DPD30-59,6,6,0
2023-12-25,42,DPD60-89,0,0,0
2023-12-25,42,DPD90+,0,0,0
2023-12-25,44,Current,0,0,0
2023-12-25,44,DPD15-29,48,48,0
2023-12-25,44,DPD3-14,70,70,0
2023-12-25,44,DPD30-59,7,7,0
2023-12-25,44,DPD60-89,0,0,0
2023-12-25,44,DPD90+,0,0,0
2023-12-25,46,Current,0,0,0
2023-12-25,46,DPD15-29,1,1,0
2023-12-25,46,DPD3-14,0,0,0
2023-12-25,48,Current,65,65,0
2023-12-25,48,DPD15-29,18,18,0
2023-12-25,48,DPD3-14,26,26,0
2023-12-25,48,DPD30-59,9,9,0
2023-12-25,48,DPD60-89,0,0,0
2023-12-25,48,DPD90+,0,0,0
2023-12-25,6,Current,0,0,0
2023-12-24,100,Current,0,0,0
2023-12-24,100,DPD15-29,0,0,0
2023-12-24,100,DPD3-14,0,0,0
2023-12-24,102,Current,0,0,0
2023-12-24,102,DPD15-29,0,0,0
2023-12-24,102,DPD3-14,0,0,0
2023-12-24,102,DPD90+,0,0,0
2023-12-24,104,Current,0,0,0
2023-12-24,104,DPD3-14,0,0,0
2023-12-24,104,DPD30-59,0,0,0
2023-12-24,104,DPD60-89,0,0,0
2023-12-24,20,Current,157,157,0
2023-12-24,20,DPD15-29,27,27,0
2023-12-24,20,DPD3-14,433,433,0
2023-12-24,20,DPD30-59,279,279,0
2023-12-24,20,DPD60-89,160,160,0
2023-12-24,20,DPD90+,2,2,0
2023-12-24,22,Current,0,0,0
2023-12-24,22,DPD15-29,1,1,0
2023-12-24,22,DPD3-14,1,1,0
2023-12-24,22,DPD30-59,0,0,0
2023-12-24,22,DPD60-89,0,0,0
2023-12-24,24,Current,75,75,0
2023-12-24,24,DPD15-29,33,33,0
2023-12-24,24,DPD3-14,254,254,0
2023-12-24,24,DPD30-59,83,83,0
2023-12-24,24,DPD60-89,0,0,0
2023-12-24,24,DPD90+,0,0,0
2023-12-24,26,Current,0,0,0
2023-12-24,26,DPD15-29,4,4,0
2023-12-24,26,DPD3-14,31,31,0
2023-12-24,26,DPD30-59,10,10,0
2023-12-24,26,DPD60-89,0,0,0
2023-12-24,26,DPD90+,0,0,0
2023-12-24,32,Current,0,0,0
2023-12-24,32,DPD15-29,40,40,0
2023-12-24,32,DPD3-14,193,193,0
2023-12-24,32,DPD30-59,97,97,0
2023-12-24,32,DPD60-89,0,0,0
2023-12-24,32,DPD90+,0,0,0
2023-12-24,34,Current,0,0,0
2023-12-24,34,DPD15-29,23,23,0
2023-12-24,34,DPD3-14,74,74,0
2023-12-24,34,DPD30-59,49,49,0
2023-12-24,34,DPD60-89,0,0,0
2023-12-24,34,DPD90+,0,0,0
2023-12-24,36,Current,0,0,0
2023-12-24,36,DPD15-29,19,19,0
2023-12-24,36,DPD3-14,75,75,0
2023-12-24,36,DPD30-59,30,30,0
2023-12-24,36,DPD60-89,0,0,0
2023-12-24,36,DPD90+,0,0,0
2023-12-24,38,Current,0,0,0
2023-12-24,38,DPD15-29,14,14,0
2023-12-24,38,DPD3-14,65,65,0
2023-12-24,38,DPD30-59,15,15,0
2023-12-24,38,DPD60-89,0,0,0
2023-12-24,38,DPD90+,0,0,0
2023-12-24,40,Current,0,0,0
2023-12-24,40,DPD15-29,7,7,0
2023-12-24,40,DPD3-14,41,41,0
2023-12-24,40,DPD30-59,6,6,0
2023-12-24,40,DPD60-89,0,0,0
2023-12-24,40,DPD90+,0,0,0
2023-12-24,42,Current,0,0,0
2023-12-24,42,DPD15-29,3,3,0
2023-12-24,42,DPD3-14,18,18,0
2023-12-24,42,DPD30-59,4,4,0
2023-12-24,42,DPD60-89,0,0,0
2023-12-24,42,DPD90+,0,0,0
2023-12-24,44,Current,0,0,0
2023-12-24,44,DPD15-29,8,8,0
2023-12-24,44,DPD3-14,56,56,0
2023-12-24,44,DPD30-59,19,19,0
2023-12-24,44,DPD60-89,0,0,0
2023-12-24,44,DPD90+,0,0,0
2023-12-24,46,Current,0,0,0
2023-12-24,46,DPD15-29,1,1,0
2023-12-24,46,DPD90+,0,0,0
2023-12-24,48,Current,112,112,0
2023-12-24,48,DPD15-29,2,2,0
2023-12-24,48,DPD3-14,25,25,0
2023-12-24,48,DPD30-59,14,14,0
2023-12-24,48,DPD60-89,0,0,0
2023-12-24,48,DPD90+,0,0,0
2023-12-24,6,Current,0,0,0
2023-12-24,6,DPD90+,0,0,0
2023-12-23,100,Current,0,0,0
2023-12-23,100,DPD15-29,0,0,0
2023-12-23,100,DPD3-14,1,1,0
2023-12-23,102,Current,0,0,0
2023-12-23,102,DPD15-29,0,0,0
2023-12-23,102,DPD3-14,1,1,0
2023-12-23,102,DPD90+,0,0,0
2023-12-23,104,Current,0,0,0
2023-12-23,104,DPD3-14,1,1,0
2023-12-23,104,DPD30-59,0,0,0
2023-12-23,104,DPD60-89,0,0,0
2023-12-23,20,Current,106,106,0
2023-12-23,20,DPD15-29,420,420,0
2023-12-23,20,DPD3-14,484,484,0
2023-12-23,20,DPD30-59,59,59,0
2023-12-23,20,DPD60-89,2,2,0
2023-12-23,20,DPD90+,0,0,0
2023-12-23,22,Current,0,0,0
2023-12-23,22,DPD15-29,0,0,0
2023-12-23,22,DPD3-14,3,3,0
2023-12-23,22,DPD30-59,0,0,0
2023-12-23,22,DPD60-89,0,0,0
2023-12-23,24,Current,62,62,0
2023-12-23,24,DPD15-29,154,154,0
2023-12-23,24,DPD3-14,246,246,0
2023-12-23,24,DPD30-59,36,36,0
2023-12-23,24,DPD60-89,0,0,0
2023-12-23,24,DPD90+,0,0,0
2023-12-23,26,Current,0,0,0
2023-12-23,26,DPD15-29,25,25,0
2023-12-23,26,DPD3-14,41,41,0
2023-12-23,26,DPD30-59,5,5,0
2023-12-23,26,DPD60-89,0,0,0
2023-12-23,26,DPD90+,0,0,0
2023-12-23,32,Current,0,0,0
2023-12-23,32,DPD15-29,157,157,0
2023-12-23,32,DPD3-14,213,213,0
2023-12-23,32,DPD30-59,35,35,0
2023-12-23,32,DPD60-89,0,0,0
2023-12-23,32,DPD90+,0,0,0
2023-12-23,34,Current,0,0,0
2023-12-23,34,DPD15-29,73,73,0
2023-12-23,34,DPD3-14,76,76,0
2023-12-23,34,DPD30-59,9,9,0
2023-12-23,34,DPD60-89,0,0,0
2023-12-23,34,DPD90+,0,0,0
2023-12-23,36,Current,0,0,0
2023-12-23,36,DPD15-29,51,51,0
2023-12-23,36,DPD3-14,58,58,0
2023-12-23,36,DPD30-59,11,11,0
2023-12-23,36,DPD60-89,0,0,0
2023-12-23,36,DPD90+,0,0,0
2023-12-23,38,Current,0,0,0
2023-12-23,38,DPD15-29,39,39,0
2023-12-23,38,DPD3-14,59,59,0
2023-12-23,38,DPD30-59,4,4,0
2023-12-23,38,DPD60-89,0,0,0
2023-12-23,38,DPD90+,0,0,0
2023-12-23,40,Current,0,0,0
2023-12-23,40,DPD15-29,19,19,0
2023-12-23,40,DPD3-14,45,45,0
2023-12-23,40,DPD30-59,1,1,0
2023-12-23,40,DPD60-89,0,0,0
2023-12-23,40,DPD90+,0,0,0
2023-12-23,42,Current,0,0,0
2023-12-23,42,DPD15-29,18,18,0
2023-12-23,42,DPD3-14,30,30,0
2023-12-23,42,DPD30-59,3,3,0
2023-12-23,42,DPD60-89,0,0,0
2023-12-23,42,DPD90+,0,0,0
2023-12-23,44,Current,0,0,0
2023-12-23,44,DPD15-29,42,42,0
2023-12-23,44,DPD3-14,70,70,0
2023-12-23,44,DPD30-59,9,9,0
2023-12-23,44,DPD60-89,0,0,0
2023-12-23,44,DPD90+,0,0,0
2023-12-23,46,Current,0,0,0
2023-12-23,46,DPD15-29,1,1,0
2023-12-23,46,DPD90+,0,0,0
2023-12-23,48,Current,60,60,0
2023-12-23,48,DPD15-29,18,18,0
2023-12-23,48,DPD3-14,26,26,0
2023-12-23,48,DPD30-59,8,8,0
2023-12-23,48,DPD60-89,0,0,0
2023-12-23,48,DPD90+,0,0,0
2023-12-23,6,Current,0,0,0
2023-12-23,6,DPD90+,0,0,0
2023-12-22,100,Current,0,0,0
2023-12-22,100,DPD15-29,0,0,0
2023-12-22,100,DPD3-14,0,0,0
2023-12-22,102,Current,2,2,0
2023-12-22,102,DPD15-29,0,0,0
2023-12-22,102,DPD3-14,0,0,0
2023-12-22,102,DPD90+,0,0,0
2023-12-22,104,Current,1,1,0
2023-12-22,104,DPD15-29,0,0,0
2023-12-22,104,DPD3-14,0,0,0
2023-12-22,104,DPD30-59,0,0,0
2023-12-22,104,DPD60-89,0,0,0
2023-12-22,20,Current,519,519,0
2023-12-22,20,DPD15-29,29,29,0
2023-12-22,20,DPD3-14,330,330,0
2023-12-22,20,DPD30-59,130,130,0
2023-12-22,20,DPD60-89,20,20,0
2023-12-22,20,DPD90+,0,0,0
2023-12-22,22,Current,0,0,0
2023-12-22,22,DPD15-29,1,1,0
2023-12-22,22,DPD3-14,1,1,0
2023-12-22,22,DPD30-59,0,0,0
2023-12-22,22,DPD60-89,0,0,0
2023-12-22,24,Current,309,309,0
2023-12-22,24,DPD15-29,41,41,0
2023-12-22,24,DPD3-14,192,192,0
2023-12-22,24,DPD30-59,82,82,0
2023-12-22,24,DPD60-89,1,1,0
2023-12-22,24,DPD90+,0,0,0
2023-12-22,26,Current,33,33,0
2023-12-22,26,DPD15-29,4,4,0
2023-12-22,26,DPD3-14,17,17,0
2023-12-22,26,DPD30-59,16,16,0
2023-12-22,26,DPD60-89,0,0,0
2023-12-22,26,DPD90+,0,0,0
2023-12-22,32,Current,126,126,0
2023-12-22,32,DPD15-29,46,46,0
2023-12-22,32,DPD3-14,149,149,0
2023-12-22,32,DPD30-59,108,108,0
2023-12-22,32,DPD60-89,0,0,0
2023-12-22,32,DPD90+,0,0,0
2023-12-22,34,Current,64,64,0
2023-12-22,34,DPD15-29,24,24,0
2023-12-22,34,DPD3-14,59,59,0
2023-12-22,34,DPD30-59,47,47,0
2023-12-22,34,DPD60-89,0,0,0
2023-12-22,34,DPD90+,0,0,0
2023-12-22,36,Current,52,52,0
2023-12-22,36,DPD15-29,21,21,0
2023-12-22,36,DPD3-14,57,57,0
2023-12-22,36,DPD30-59,29,29,0
2023-12-22,36,DPD60-89,0,0,0
2023-12-22,36,DPD90+,0,0,0
2023-12-22,38,Current,45,45,0
2023-12-22,38,DPD15-29,14,14,0
2023-12-22,38,DPD3-14,48,48,0
2023-12-22,38,DPD30-59,16,16,0
2023-12-22,38,DPD60-89,1,1,0
2023-12-22,38,DPD90+,0,0,0
2023-12-22,40,Current,31,31,0
2023-12-22,40,DPD15-29,5,5,0
2023-12-22,40,DPD3-14,32,32,0
2023-12-22,40,DPD30-59,12,12,0
2023-12-22,40,DPD60-89,0,0,0
2023-12-22,40,DPD90+,0,0,0
2023-12-22,42,Current,21,21,0
2023-12-22,42,DPD15-29,7,7,0
2023-12-22,42,DPD3-14,12,12,0
2023-12-22,42,DPD30-59,7,7,0
2023-12-22,42,DPD60-89,0,0,0
2023-12-22,42,DPD90+,0,0,0
2023-12-22,44,Current,69,69,0
2023-12-22,44,DPD15-29,7,7,0
2023-12-22,44,DPD3-14,49,49,0
2023-12-22,44,DPD30-59,21,21,0
2023-12-22,44,DPD60-89,0,0,0
2023-12-22,44,DPD90+,0,0,0
2023-12-22,46,Current,0,0,0
2023-12-22,46,DPD15-29,0,0,0
2023-12-22,46,DPD90+,0,0,0
2023-12-22,48,Current,188,188,0
2023-12-22,48,DPD15-29,3,3,0
2023-12-22,48,DPD3-14,20,20,0
2023-12-22,48,DPD30-59,6,6,0
2023-12-22,48,DPD60-89,0,0,0
2023-12-22,48,DPD90+,0,0,0
2023-12-22,6,Current,0,0,0
2023-12-22,6,DPD90+,0,0,0
2023-12-21,100,Current,0,0,0
2023-12-21,100,DPD15-29,0,0,0
2023-12-21,100,DPD3-14,1,1,0
2023-12-21,102,Current,0,0,0
2023-12-21,102,DPD15-29,1,1,0
2023-12-21,102,DPD3-14,1,1,0
2023-12-21,102,DPD90+,0,0,0
2023-12-21,104,Current,0,0,0
2023-12-21,104,DPD15-29,1,1,0
2023-12-21,104,DPD60-89,0,0,0
2023-12-21,20,Current,118,118,0
2023-12-21,20,DPD15-29,442,442,0
2023-12-21,20,DPD3-14,581,581,0
2023-12-21,20,DPD30-59,61,61,0
2023-12-21,20,DPD60-89,22,22,0
2023-12-21,20,DPD90+,4,4,0
2023-12-21,22,Current,0,0,0
2023-12-21,22,DPD15-29,0,0,0
2023-12-21,22,DPD3-14,1,1,0
2023-12-21,22,DPD30-59,0,0,0
2023-12-21,22,DPD60-89,0,0,0
2023-12-21,22,DPD90+,0,0,0
2023-12-21,24,Current,75,75,0
2023-12-21,24,DPD15-29,162,162,0
2023-12-21,24,DPD3-14,302,302,0
2023-12-21,24,DPD30-59,35,35,0
2023-12-21,24,DPD60-89,0,0,0
2023-12-21,24,DPD90+,0,0,0
2023-12-21,26,Current,4,4,0
2023-12-21,26,DPD15-29,29,29,0
2023-12-21,26,DPD3-14,53,53,0
2023-12-21,26,DPD30-59,4,4,0
2023-12-21,26,DPD60-89,0,0,0
2023-12-21,26,DPD90+,0,0,0
2023-12-21,32,Current,2,2,0
2023-12-21,32,DPD15-29,171,171,0
2023-12-21,32,DPD3-14,235,235,0
2023-12-21,32,DPD30-59,31,31,0
2023-12-21,32,DPD60-89,0,0,0
2023-12-21,32,DPD90+,0,0,0
2023-12-21,34,Current,0,0,0
2023-12-21,34,DPD15-29,78,78,0
2023-12-21,34,DPD3-14,98,98,0
2023-12-21,34,DPD30-59,12,12,0
2023-12-21,34,DPD60-89,0,0,0
2023-12-21,34,DPD90+,0,0,0
2023-12-21,36,Current,3,3,0
2023-12-21,36,DPD15-29,52,52,0
2023-12-21,36,DPD3-14,79,79,0
2023-12-21,36,DPD30-59,9,9,0
2023-12-21,36,DPD60-89,0,0,0
2023-12-21,36,DPD90+,0,0,0
2023-12-21,38,Current,2,2,0
2023-12-21,38,DPD15-29,39,39,0
2023-12-21,38,DPD3-14,74,74,0
2023-12-21,38,DPD30-59,9,9,0
2023-12-21,38,DPD60-89,0,0,0
2023-12-21,38,DPD90+,0,0,0
2023-12-21,40,Current,10,10,0
2023-12-21,40,DPD15-29,15,15,0
2023-12-21,40,DPD3-14,51,51,0
2023-12-21,40,DPD30-59,5,5,0
2023-12-21,40,DPD60-89,0,0,0
2023-12-21,40,DPD90+,0,0,0
2023-12-21,42,Current,1,1,0
2023-12-21,42,DPD15-29,18,18,0
2023-12-21,42,DPD3-14,43,43,0
2023-12-21,42,DPD30-59,3,3,0
2023-12-21,42,DPD60-89,0,0,0
2023-12-21,42,DPD90+,0,0,0
2023-12-21,44,Current,5,5,0
2023-12-21,44,DPD15-29,35,35,0
2023-12-21,44,DPD3-14,81,81,0
2023-12-21,44,DPD30-59,4,4,0
2023-12-21,44,DPD60-89,0,0,0
2023-12-21,44,DPD90+,0,0,0
2023-12-21,46,Current,0,0,0
2023-12-21,46,DPD15-29,1,1,0
2023-12-21,46,DPD3-14,0,0,0
2023-12-21,46,DPD60-89,0,0,0
2023-12-21,46,DPD90+,0,0,0
2023-12-21,48,Current,62,62,0
2023-12-21,48,DPD15-29,20,20,0
2023-12-21,48,DPD3-14,30,30,0
2023-12-21,48,DPD30-59,8,8,0
2023-12-21,48,DPD60-89,0,0,0
2023-12-21,48,DPD90+,0,0,0
2023-12-21,6,Current,0,0,0
2023-12-21,6,DPD90+,0,0,0
2023-12-20,100,Current,0,0,0
2023-12-20,100,DPD15-29,0,0,0
2023-12-20,100,DPD3-14,0,0,0
2023-12-20,102,Current,0,0,0
2023-12-20,102,DPD15-29,0,0,0
2023-12-20,102,DPD3-14,0,0,0
2023-12-20,102,DPD90+,0,0,0
2023-12-20,104,Current,0,0,0
2023-12-20,104,DPD15-29,0,0,0
2023-12-20,104,DPD30-59,0,0,0
2023-12-20,104,DPD60-89,0,0,0
2023-12-20,20,Current,123,123,0
2023-12-20,20,DPD15-29,29,29,0
2023-12-20,20,DPD3-14,284,284,0
2023-12-20,20,DPD30-59,326,326,0
2023-12-20,20,DPD60-89,66,66,0
2023-12-20,20,DPD90+,0,0,0
2023-12-20,22,Current,0,0,0
2023-12-20,22,DPD15-29,2,2,0
2023-12-20,22,DPD3-14,1,1,0
2023-12-20,22,DPD30-59,0,0,0
2023-12-20,22,DPD60-89,0,0,0
2023-12-20,22,DPD90+,0,0,0
2023-12-20,24,Current,62,62,0
2023-12-20,24,DPD15-29,52,52,0
2023-12-20,24,DPD3-14,159,159,0
2023-12-20,24,DPD30-59,88,88,0
2023-12-20,24,DPD60-89,0,0,0
2023-12-20,24,DPD90+,0,0,0
2023-12-20,26,Current,0,0,0
2023-12-20,26,DPD15-29,6,6,0
2023-12-20,26,DPD3-14,15,15,0
2023-12-20,26,DPD30-59,15,15,0
2023-12-20,26,DPD60-89,0,0,0
2023-12-20,26,DPD90+,0,0,0
2023-12-20,32,Current,0,0,0
2023-12-20,32,DPD15-29,57,57,0
2023-12-20,32,DPD3-14,134,134,0
2023-12-20,32,DPD30-59,101,101,0
2023-12-20,32,DPD60-89,0,0,0
2023-12-20,32,DPD90+,0,0,0
2023-12-20,34,Current,3,3,0
2023-12-20,34,DPD15-29,31,31,0
2023-12-20,34,DPD3-14,43,43,0
2023-12-20,34,DPD30-59,51,51,0
2023-12-20,34,DPD60-89,0,0,0
2023-12-20,34,DPD90+,0,0,0
2023-12-20,36,Current,0,0,0
2023-12-20,36,DPD15-29,19,19,0
2023-12-20,36,DPD3-14,55,55,0
2023-12-20,36,DPD30-59,29,29,0
2023-12-20,36,DPD60-89,0,0,0
2023-12-20,36,DPD90+,0,0,0
2023-12-20,38,Current,1,1,0
2023-12-20,38,DPD15-29,19,19,0
2023-12-20,38,DPD3-14,43,43,0
2023-12-20,38,DPD30-59,19,19,0
2023-12-20,38,DPD60-89,0,0,0
2023-12-20,38,DPD90+,0,0,0
2023-12-20,40,Current,0,0,0
2023-12-20,40,DPD15-29,6,6,0
2023-12-20,40,DPD3-14,24,24,0
2023-12-20,40,DPD30-59,10,10,0
2023-12-20,40,DPD60-89,0,0,0
2023-12-20,40,DPD90+,0,0,0
2023-12-20,42,Current,0,0,0
2023-12-20,42,DPD15-29,7,7,0
2023-12-20,42,DPD3-14,10,10,0
2023-12-20,42,DPD30-59,6,6,0
2023-12-20,42,DPD60-89,0,0,0
2023-12-20,42,DPD90+,0,0,0
2023-12-20,44,Current,0,0,0
2023-12-20,44,DPD15-29,7,7,0
2023-12-20,44,DPD3-14,38,38,0
2023-12-20,44,DPD30-59,21,21,0
2023-12-20,44,DPD60-89,0,0,0
2023-12-20,44,DPD90+,0,0,0
2023-12-20,46,Current,0,0,0
2023-12-20,46,DPD15-29,0,0,0
2023-12-20,46,DPD3-14,1,1,0
2023-12-20,46,DPD60-89,0,0,0
2023-12-20,46,DPD90+,0,0,0
2023-12-20,48,Current,74,74,0
2023-12-20,48,DPD15-29,2,2,0
2023-12-20,48,DPD3-14,16,16,0
2023-12-20,48,DPD30-59,16,16,0
2023-12-20,48,DPD60-89,0,0,0
2023-12-20,48,DPD90+,0,0,0
2023-12-20,6,Current,0,0,0
2023-12-20,6,DPD90+,0,0,0
2023-12-19,100,Current,0,0,0
2023-12-19,100,DPD15-29,0,0,0
2023-12-19,100,DPD3-14,1,1,0
2023-12-19,102,Current,0,0,0
2023-12-19,102,DPD15-29,1,1,0
2023-12-19,102,DPD3-14,0,0,0
2023-12-19,102,DPD90+,0,0,0
2023-12-19,104,Current,0,0,0
2023-12-19,104,DPD15-29,1,1,0
2023-12-19,104,DPD30-59,1,1,0
2023-12-19,104,DPD60-89,0,0,0
2023-12-19,20,Current,150,150,0
2023-12-19,20,DPD15-29,459,459,0
2023-12-19,20,DPD3-14,566,566,0
2023-12-19,20,DPD30-59,47,47,0
2023-12-19,20,DPD60-89,102,102,0
2023-12-19,20,DPD90+,3,3,0
2023-12-19,22,Current,0,0,0
2023-12-19,22,DPD15-29,0,0,0
2023-12-19,22,DPD3-14,1,1,0
2023-12-19,22,DPD30-59,0,0,0
2023-12-19,22,DPD60-89,0,0,0
2023-12-19,22,DPD90+,0,0,0
2023-12-19,24,Current,80,80,0
2023-12-19,24,DPD15-29,162,162,0
2023-12-19,24,DPD3-14,256,256,0
2023-12-19,24,DPD30-59,30,30,0
2023-12-19,24,DPD60-89,0,0,0
2023-12-19,24,DPD90+,0,0,0
2023-12-19,26,Current,2,2,0
2023-12-19,26,DPD15-29,28,28,0
2023-12-19,26,DPD3-14,53,53,0
2023-12-19,26,DPD30-59,7,7,0
2023-12-19,26,DPD60-89,0,0,0
2023-12-19,26,DPD90+,0,0,0
2023-12-19,32,Current,1,1,0
2023-12-19,32,DPD15-29,177,177,0
2023-12-19,32,DPD3-14,210,210,0
2023-12-19,32,DPD30-59,25,25,0
2023-12-19,32,DPD60-89,0,0,0
2023-12-19,32,DPD90+,0,0,0
2023-12-19,34,Current,0,0,0
2023-12-19,34,DPD15-29,80,80,0
2023-12-19,34,DPD3-14,101,101,0
2023-12-19,34,DPD30-59,8,8,0
2023-12-19,34,DPD60-89,0,0,0
2023-12-19,34,DPD90+,0,0,0
2023-12-19,36,Current,1,1,0
2023-12-19,36,DPD15-29,59,59,0
2023-12-19,36,DPD3-14,76,76,0
2023-12-19,36,DPD30-59,10,10,0
2023-12-19,36,DPD60-89,0,0,0
2023-12-19,36,DPD90+,0,0,0
2023-12-19,38,Current,0,0,0
2023-12-19,38,DPD15-29,44,44,0
2023-12-19,38,DPD3-14,75,75,0
2023-12-19,38,DPD30-59,6,6,0
2023-12-19,38,DPD60-89,0,0,0
2023-12-19,38,DPD90+,0,0,0
2023-12-19,40,Current,7,7,0
2023-12-19,40,DPD15-29,17,17,0
2023-12-19,40,DPD3-14,48,48,0
2023-12-19,40,DPD30-59,2,2,0
2023-12-19,40,DPD60-89,0,0,0
2023-12-19,40,DPD90+,0,0,0
2023-12-19,42,Current,1,1,0
2023-12-19,42,DPD15-29,14,14,0
2023-12-19,42,DPD3-14,39,39,0
2023-12-19,42,DPD30-59,2,2,0
2023-12-19,42,DPD60-89,0,0,0
2023-12-19,42,DPD90+,0,0,0
2023-12-19,44,Current,2,2,0
2023-12-19,44,DPD15-29,34,34,0
2023-12-19,44,DPD3-14,77,77,0
2023-12-19,44,DPD30-59,6,6,0
2023-12-19,44,DPD60-89,0,0,0
2023-12-19,44,DPD90+,0,0,0
2023-12-19,46,Current,0,0,0
2023-12-19,46,DPD15-29,1,1,0
2023-12-19,46,DPD3-14,0,0,0
2023-12-19,46,DPD60-89,0,0,0
2023-12-19,46,DPD90+,0,0,0
2023-12-19,48,Current,69,69,0
2023-12-19,48,DPD15-29,21,21,0
2023-12-19,48,DPD3-14,31,31,0
2023-12-19,48,DPD30-59,6,6,0
2023-12-19,48,DPD60-89,0,0,0
2023-12-19,48,DPD90+,0,0,0
2023-12-19,6,Current,0,0,0
2023-12-19,6,DPD90+,0,0,0
2023-12-18,100,Current,0,0,0
2023-12-18,100,DPD15-29,0,0,0
2023-12-18,100,DPD3-14,0,0,0
2023-12-18,102,Current,0,0,0
2023-12-18,102,DPD15-29,0,0,0
2023-12-18,102,DPD3-14,0,0,0
2023-12-18,102,DPD90+,0,0,0
2023-12-18,104,Current,0,0,0
2023-12-18,104,DPD15-29,0,0,0
2023-12-18,104,DPD30-59,0,0,0
2023-12-18,104,DPD60-89,0,0,0
2023-12-18,20,Current,109,109,0
2023-12-18,20,DPD15-29,18,18,0
2023-12-18,20,DPD3-14,193,193,0
2023-12-18,20,DPD30-59,137,137,0
2023-12-18,20,DPD60-89,187,187,0
2023-12-18,20,DPD90+,289,289,0
2023-12-18,22,Current,0,0,0
2023-12-18,22,DPD15-29,3,3,0
2023-12-18,22,DPD3-14,1,1,0
2023-12-18,22,DPD30-59,0,0,0
2023-12-18,22,DPD60-89,0,0,0
2023-12-18,22,DPD90+,0,0,0
2023-12-18,24,Current,53,53,0
2023-12-18,24,DPD15-29,69,69,0
2023-12-18,24,DPD3-14,109,109,0
2023-12-18,24,DPD30-59,103,103,0
2023-12-18,24,DPD60-89,0,0,0
2023-12-18,24,DPD90+,0,0,0
2023-12-18,26,Current,0,0,0
2023-12-18,26,DPD15-29,10,10,0
2023-12-18,26,DPD3-14,12,12,0
2023-12-18,26,DPD30-59,19,19,0
2023-12-18,26,DPD60-89,0,0,0
2023-12-18,26,DPD90+,0,0,0
2023-12-18,32,Current,0,0,0
2023-12-18,32,DPD15-29,78,78,0
2023-12-18,32,DPD3-14,92,92,0
2023-12-18,32,DPD30-59,129,129,0
2023-12-18,32,DPD60-89,0,0,0
2023-12-18,32,DPD90+,0,0,0
2023-12-18,34,Current,0,0,0
2023-12-18,34,DPD15-29,43,43,0
2023-12-18,34,DPD3-14,38,38,0
2023-12-18,34,DPD30-59,53,53,0
2023-12-18,34,DPD60-89,0,0,0
2023-12-18,34,DPD90+,0,0,0
2023-12-18,36,Current,0,0,0
2023-12-18,36,DPD15-29,21,21,0
2023-12-18,36,DPD3-14,33,33,0
2023-12-18,36,DPD30-59,34,34,0
2023-12-18,36,DPD60-89,0,0,0
2023-12-18,36,DPD90+,0,0,0
2023-12-18,38,Current,0,0,0
2023-12-18,38,DPD15-29,22,22,0
2023-12-18,38,DPD3-14,28,28,0
2023-12-18,38,DPD30-59,20,20,0
2023-12-18,38,DPD60-89,0,0,0
2023-12-18,38,DPD90+,0,0,0
2023-12-18,40,Current,0,0,0
2023-12-18,40,DPD15-29,12,12,0
2023-12-18,40,DPD3-14,20,20,0
2023-12-18,40,DPD30-59,14,14,0
2023-12-18,40,DPD60-89,0,0,0
2023-12-18,40,DPD90+,0,0,0
2023-12-18,42,Current,0,0,0
2023-12-18,42,DPD15-29,7,7,0
2023-12-18,42,DPD3-14,9,9,0
2023-12-18,42,DPD30-59,9,9,0
2023-12-18,42,DPD60-89,0,0,0
2023-12-18,42,DPD90+,0,0,0
2023-12-18,44,Current,0,0,0
2023-12-18,44,DPD15-29,7,7,0
2023-12-18,44,DPD3-14,25,25,0
2023-12-18,44,DPD30-59,25,25,0
2023-12-18,44,DPD60-89,0,0,0
2023-12-18,44,DPD90+,0,0,0
2023-12-18,46,Current,0,0,0
2023-12-18,46,DPD15-29,0,0,0
2023-12-18,46,DPD3-14,1,1,0
2023-12-18,46,DPD60-89,0,0,0
2023-12-18,46,DPD90+,0,0,0
2023-12-18,48,Current,58,58,0
2023-12-18,48,DPD15-29,3,3,0
2023-12-18,48,DPD3-14,15,15,0
2023-12-18,48,DPD30-59,7,7,0
2023-12-18,48,DPD60-89,0,0,0
2023-12-18,48,DPD90+,0,0,0
2023-12-18,6,Current,0,0,0
2023-12-18,6,DPD90+,0,0,0
2023-12-17,100,Current,0,0,0
2023-12-17,100,DPD3-14,0,0,0
2023-12-17,102,Current,0,0,0
2023-12-17,102,DPD15-29,1,1,0
2023-12-17,102,DPD3-14,0,0,0
2023-12-17,102,DPD90+,0,0,0
2023-12-17,104,Current,0,0,0
2023-12-17,104,DPD15-29,1,1,0
2023-12-17,104,DPD60-89,0,0,0
2023-12-17,104,DPD90+,0,0,0
2023-12-17,20,Current,217,217,0
2023-12-17,20,DPD15-29,462,462,0
2023-12-17,20,DPD3-14,619,619,0
2023-12-17,20,DPD30-59,399,399,0
2023-12-17,20,DPD60-89,137,137,0
2023-12-17,20,DPD90+,1,1,0
2023-12-17,22,Current,0,0,0
2023-12-17,22,DPD15-29,0,0,0
2023-12-17,22,DPD3-14,2,2,0
2023-12-17,22,DPD30-59,0,0,0
2023-12-17,22,DPD60-89,0,0,0
2023-12-17,22,DPD90+,0,0,0
2023-12-17,24,Current,101,101,0
2023-12-17,24,DPD15-29,146,146,0
2023-12-17,24,DPD3-14,298,298,0
2023-12-17,24,DPD30-59,91,91,0
2023-12-17,24,DPD60-89,0,0,0
2023-12-17,24,DPD90+,0,0,0
2023-12-17,26,Current,0,0,0
2023-12-17,26,DPD15-29,29,29,0
2023-12-17,26,DPD3-14,41,41,0
2023-12-17,26,DPD30-59,14,14,0
2023-12-17,26,DPD60-89,0,0,0
2023-12-17,26,DPD90+,0,0,0
2023-12-17,32,Current,0,0,0
2023-12-17,32,DPD15-29,163,163,0
2023-12-17,32,DPD3-14,234,234,0
2023-12-17,32,DPD30-59,98,98,0
2023-12-17,32,DPD60-89,0,0,0
2023-12-17,32,DPD90+,0,0,0
2023-12-17,34,Current,0,0,0
2023-12-17,34,DPD15-29,77,77,0
2023-12-17,34,DPD3-14,108,108,0
2023-12-17,34,DPD30-59,55,55,0
2023-12-17,34,DPD60-89,0,0,0
2023-12-17,34,DPD90+,0,0,0
2023-12-17,36,Current,0,0,0
2023-12-17,36,DPD15-29,55,55,0
2023-12-17,36,DPD3-14,72,72,0
2023-12-17,36,DPD30-59,29,29,0
2023-12-17,36,DPD60-89,0,0,0
2023-12-17,36,DPD90+,0,0,0
2023-12-17,38,Current,0,0,0
2023-12-17,38,DPD15-29,43,43,0
2023-12-17,38,DPD3-14,79,79,0
2023-12-17,38,DPD30-59,24,24,0
2023-12-17,38,DPD60-89,0,0,0
2023-12-17,38,DPD90+,0,0,0
2023-12-17,40,Current,0,0,0
2023-12-17,40,DPD15-29,19,19,0
2023-12-17,40,DPD3-14,48,48,0
2023-12-17,40,DPD30-59,10,10,0
2023-12-17,40,DPD60-89,0,0,0
2023-12-17,40,DPD90+,0,0,0
2023-12-17,42,Current,0,0,0
2023-12-17,42,DPD15-29,14,14,0
2023-12-17,42,DPD3-14,33,33,0
2023-12-17,42,DPD30-59,5,5,0
2023-12-17,42,DPD60-89,0,0,0
2023-12-17,42,DPD90+,0,0,0
2023-12-17,44,Current,1,1,0
2023-12-17,44,DPD15-29,27,27,0
2023-12-17,44,DPD3-14,80,80,0
2023-12-17,44,DPD30-59,23,23,0
2023-12-17,44,DPD60-89,0,0,0
2023-12-17,44,DPD90+,0,0,0
2023-12-17,46,Current,0,0,0
2023-12-17,46,DPD15-29,0,0,0
2023-12-17,46,DPD3-14,1,1,0
2023-12-17,46,DPD60-89,0,0,0
2023-12-17,46,DPD90+,0,0,0
2023-12-17,48,Current,152,152,0
2023-12-17,48,DPD15-29,23,23,0
2023-12-17,48,DPD3-14,41,41,0
2023-12-17,48,DPD30-59,16,16,0
2023-12-17,48,DPD60-89,0,0,0
2023-12-17,48,DPD90+,0,0,0
2023-12-17,6,Current,0,0,0
2023-12-17,6,DPD90+,0,0,0
2023-12-16,100,Current,1,1,0
2023-12-16,100,DPD3-14,0,0,0
2023-12-16,102,Current,0,0,0
2023-12-16,102,DPD15-29,0,0,0
2023-12-16,102,DPD3-14,0,0,0
2023-12-16,102,DPD90+,0,0,0
2023-12-16,104,Current,0,0,0
2023-12-16,104,DPD15-29,1,1,0
2023-12-16,104,DPD60-89,0,0,0
2023-12-16,104,DPD90+,0,0,0
2023-12-16,20,Current,142,142,0
2023-12-16,20,DPD15-29,0,0,0
2023-12-16,20,DPD3-14,0,0,0
2023-12-16,20,DPD30-59,0,0,0
2023-12-16,20,DPD60-89,0,0,0
2023-12-16,20,DPD90+,0,0,0
2023-12-16,22,Current,3,3,0
2023-12-16,22,DPD15-29,3,3,0
2023-12-16,22,DPD3-14,1,1,0
2023-12-16,22,DPD30-59,0,0,0
2023-12-16,22,DPD60-89,0,0,0
2023-12-16,22,DPD90+,1,1,0
2023-12-16,24,Current,364,364,0
2023-12-16,24,DPD15-29,101,101,0
2023-12-16,24,DPD3-14,156,156,0
2023-12-16,24,DPD30-59,35,35,0
2023-12-16,24,DPD60-89,3,3,0
2023-12-16,24,DPD90+,60,60,0
2023-12-16,26,Current,59,59,0
2023-12-16,26,DPD15-29,18,18,0
2023-12-16,26,DPD3-14,24,24,0
2023-12-16,26,DPD30-59,6,6,0
2023-12-16,26,DPD60-89,0,0,0
2023-12-16,26,DPD90+,10,10,0
2023-12-16,32,Current,296,296,0
2023-12-16,32,DPD15-29,98,98,0
2023-12-16,32,DPD3-14,145,145,0
2023-12-16,32,DPD30-59,58,58,0
2023-12-16,32,DPD60-89,3,3,0
2023-12-16,32,DPD90+,80,80,0
2023-12-16,34,Current,130,130,0
2023-12-16,34,DPD15-29,56,56,0
2023-12-16,34,DPD3-14,72,72,0
2023-12-16,34,DPD30-59,33,33,0
2023-12-16,34,DPD60-89,2,2,0
2023-12-16,34,DPD90+,30,30,0
2023-12-16,36,Current,105,105,0
2023-12-16,36,DPD15-29,30,30,0
2023-12-16,36,DPD3-14,46,46,0
2023-12-16,36,DPD30-59,13,13,0
2023-12-16,36,DPD60-89,2,2,0
2023-12-16,36,DPD90+,27,27,0
2023-12-16,38,Current,94,94,0
2023-12-16,38,DPD15-29,28,28,0
2023-12-16,38,DPD3-14,31,31,0
2023-12-16,38,DPD30-59,6,6,0
2023-12-16,38,DPD60-89,1,1,0
2023-12-16,38,DPD90+,19,19,0
2023-12-16,40,Current,61,61,0
2023-12-16,40,DPD15-29,20,20,0
2023-12-16,40,DPD3-14,21,21,0
2023-12-16,40,DPD30-59,5,5,0
2023-12-16,40,DPD60-89,0,0,0
2023-12-16,40,DPD90+,12,12,0
2023-12-16,42,Current,27,27,0
2023-12-16,42,DPD15-29,8,8,0
2023-12-16,42,DPD3-14,10,10,0
2023-12-16,42,DPD30-59,8,8,0
2023-12-16,42,DPD60-89,0,0,0
2023-12-16,42,DPD90+,7,7,0
2023-12-16,44,Current,68,68,0
2023-12-16,44,DPD15-29,26,26,0
2023-12-16,44,DPD3-14,22,22,0
2023-12-16,44,DPD30-59,9,9,0
2023-12-16,44,DPD60-89,1,1,0
2023-12-16,44,DPD90+,17,17,0
2023-12-16,46,Current,1,1,0
2023-12-16,46,DPD15-29,0,0,0
2023-12-16,46,DPD3-14,1,1,0
2023-12-16,46,DPD60-89,0,0,0
2023-12-16,46,DPD90+,0,0,0
2023-12-16,48,Current,116,116,0
2023-12-16,48,DPD15-29,11,11,0
2023-12-16,48,DPD3-14,10,10,0
2023-12-16,48,DPD30-59,0,0,0
2023-12-16,48,DPD60-89,0,0,0
2023-12-16,48,DPD90+,5,5,0
2023-12-16,6,Current,0,0,0
2023-12-16,6,DPD90+,1,1,0
2023-12-15,100,Current,0,0,0
2023-12-15,100,DPD3-14,0,0,0
2023-12-15,102,Current,0,0,0
2023-12-15,102,DPD15-29,0,0,0
2023-12-15,102,DPD3-14,0,0,0
2023-12-15,102,DPD90+,0,0,0
2023-12-15,104,Current,0,0,0
2023-12-15,104,DPD15-29,0,0,0
2023-12-15,104,DPD60-89,0,0,0
2023-12-15,104,DPD90+,0,0,0
2023-12-15,20,Current,531,531,0
2023-12-15,20,DPD15-29,0,0,0
2023-12-15,20,DPD3-14,2,2,0
2023-12-15,20,DPD30-59,0,0,0
2023-12-15,20,DPD60-89,2,2,0
2023-12-15,20,DPD90+,1,1,0
2023-12-15,22,Current,0,0,0
2023-12-15,22,DPD15-29,0,0,0
2023-12-15,22,DPD3-14,0,0,0
2023-12-15,22,DPD30-59,0,0,0
2023-12-15,22,DPD60-89,0,0,0
2023-12-15,22,DPD90+,0,0,0
2023-12-15,24,Current,320,320,0
2023-12-15,24,DPD15-29,0,0,0
2023-12-15,24,DPD3-14,1,1,0
2023-12-15,24,DPD30-59,0,0,0
2023-12-15,24,DPD60-89,0,0,0
2023-12-15,24,DPD90+,0,0,0
2023-12-15,26,Current,27,27,0
2023-12-15,26,DPD15-29,0,0,0
2023-12-15,26,DPD3-14,0,0,0
2023-12-15,26,DPD30-59,0,0,0
2023-12-15,26,DPD60-89,0,0,0
2023-12-15,26,DPD90+,0,0,0
2023-12-15,32,Current,130,130,0
2023-12-15,32,DPD15-29,0,0,0
2023-12-15,32,DPD3-14,0,0,0
2023-12-15,32,DPD30-59,0,0,0
2023-12-15,32,DPD60-89,0,0,0
2023-12-15,32,DPD90+,0,0,0
2023-12-15,34,Current,62,62,0
2023-12-15,34,DPD15-29,0,0,0
2023-12-15,34,DPD3-14,0,0,0
2023-12-15,34,DPD30-59,0,0,0
2023-12-15,34,DPD60-89,0,0,0
2023-12-15,34,DPD90+,0,0,0
2023-12-15,36,Current,64,64,0
2023-12-15,36,DPD15-29,0,0,0
2023-12-15,36,DPD3-14,0,0,0
2023-12-15,36,DPD30-59,0,0,0
2023-12-15,36,DPD60-89,0,0,0
2023-12-15,36,DPD90+,0,0,0
2023-12-15,38,Current,58,58,0
2023-12-15,38,DPD15-29,1,1,0
2023-12-15,38,DPD3-14,0,0,0
2023-12-15,38,DPD30-59,1,1,0
2023-12-15,38,DPD60-89,0,0,0
2023-12-15,38,DPD90+,0,0,0
2023-12-15,40,Current,35,35,0
2023-12-15,40,DPD15-29,0,0,0
2023-12-15,40,DPD3-14,0,0,0
2023-12-15,40,DPD30-59,0,0,0
2023-12-15,40,DPD60-89,0,0,0
2023-12-15,40,DPD90+,3,3,0
2023-12-15,42,Current,13,13,0
2023-12-15,42,DPD15-29,0,0,0
2023-12-15,42,DPD3-14,0,0,0
2023-12-15,42,DPD30-59,0,0,0
2023-12-15,42,DPD60-89,0,0,0
2023-12-15,42,DPD90+,0,0,0
2023-12-15,44,Current,69,69,0
2023-12-15,44,DPD15-29,0,0,0
2023-12-15,44,DPD3-14,0,0,0
2023-12-15,44,DPD30-59,0,0,0
2023-12-15,44,DPD60-89,0,0,0
2023-12-15,44,DPD90+,0,0,0
2023-12-15,46,Current,0,0,0
2023-12-15,46,DPD3-14,0,0,0
2023-12-15,46,DPD60-89,0,0,0
2023-12-15,46,DPD90+,0,0,0
2023-12-15,48,Current,181,181,0
2023-12-15,48,DPD15-29,0,0,0
2023-12-15,48,DPD3-14,0,0,0
2023-12-15,48,DPD30-59,0,0,0
2023-12-15,48,DPD60-89,0,0,0
2023-12-15,48,DPD90+,0,0,0
2023-12-15,6,Current,0,0,0
2023-12-15,6,DPD90+,0,0,0
2023-12-14,100,Current,0,0,0
2023-12-14,100,DPD3-14,0,0,0
2023-12-14,102,Current,0,0,0
2023-12-14,102,DPD15-29,0,0,0
2023-12-14,102,DPD3-14,0,0,0
2023-12-14,102,DPD90+,0,0,0
2023-12-14,104,Current,0,0,0
2023-12-14,104,DPD15-29,2,2,0
2023-12-14,104,DPD60-89,0,0,0
2023-12-14,104,DPD90+,0,0,0
2023-12-14,20,Current,95,95,0
2023-12-14,20,DPD15-29,425,425,0
2023-12-14,20,DPD3-14,353,353,0
2023-12-14,20,DPD30-59,138,138,0
2023-12-14,20,DPD60-89,26,26,0
2023-12-14,20,DPD90+,4,4,0
2023-12-14,22,Current,0,0,0
2023-12-14,22,DPD15-29,2,2,0
2023-12-14,22,DPD3-14,1,1,0
2023-12-14,22,DPD30-59,0,0,0
2023-12-14,22,DPD60-89,0,0,0
2023-12-14,22,DPD90+,0,0,0
2023-12-14,24,Current,42,42,0
2023-12-14,24,DPD15-29,195,195,0
2023-12-14,24,DPD3-14,170,170,0
2023-12-14,24,DPD30-59,39,39,0
2023-12-14,24,DPD60-89,0,0,0
2023-12-14,24,DPD90+,0,0,0
2023-12-14,26,Current,0,0,0
2023-12-14,26,DPD15-29,33,33,0
2023-12-14,26,DPD3-14,17,17,0
2023-12-14,26,DPD30-59,9,9,0
2023-12-14,26,DPD60-89,0,0,0
2023-12-14,26,DPD90+,0,0,0
2023-12-14,32,Current,0,0,0
2023-12-14,32,DPD15-29,238,238,0
2023-12-14,32,DPD3-14,129,129,0
2023-12-14,32,DPD30-59,66,66,0
2023-12-14,32,DPD60-89,0,0,0
2023-12-14,32,DPD90+,0,0,0
2023-12-14,34,Current,0,0,0
2023-12-14,34,DPD15-29,122,122,0
2023-12-14,34,DPD3-14,60,60,0
2023-12-14,34,DPD30-59,24,24,0
2023-12-14,34,DPD60-89,0,0,0
2023-12-14,34,DPD90+,0,0,0
2023-12-14,36,Current,0,0,0
2023-12-14,36,DPD15-29,66,66,0
2023-12-14,36,DPD3-14,55,55,0
2023-12-14,36,DPD30-59,21,21,0
2023-12-14,36,DPD60-89,0,0,0
2023-12-14,36,DPD90+,0,0,0
2023-12-14,38,Current,0,0,0
2023-12-14,38,DPD15-29,59,59,0
2023-12-14,38,DPD3-14,39,39,0
2023-12-14,38,DPD30-59,10,10,0
2023-12-14,38,DPD60-89,0,0,0
2023-12-14,38,DPD90+,0,0,0
2023-12-14,40,Current,0,0,0
2023-12-14,40,DPD15-29,18,18,0
2023-12-14,40,DPD3-14,36,36,0
2023-12-14,40,DPD30-59,2,2,0
2023-12-14,40,DPD60-89,0,0,0
2023-12-14,40,DPD90+,0,0,0
2023-12-14,42,Current,0,0,0
2023-12-14,42,DPD15-29,20,20,0
2023-12-14,42,DPD3-14,16,16,0
2023-12-14,42,DPD30-59,3,3,0
2023-12-14,42,DPD60-89,0,0,0
2023-12-14,42,DPD90+,0,0,0
2023-12-14,44,Current,0,0,0
2023-12-14,44,DPD15-29,30,30,0
2023-12-14,44,DPD3-14,59,59,0
2023-12-14,44,DPD30-59,14,14,0
2023-12-14,44,DPD60-89,0,0,0
2023-12-14,44,DPD90+,0,0,0
2023-12-14,46,Current,0,0,0
2023-12-14,46,DPD3-14,0,0,0
2023-12-14,46,DPD60-89,0,0,0
2023-12-14,46,DPD90+,0,0,0
2023-12-14,48,Current,47,47,0
2023-12-14,48,DPD15-29,17,17,0
2023-12-14,48,DPD3-14,17,17,0
2023-12-14,48,DPD30-59,3,3,0
2023-12-14,48,DPD60-89,0,0,0
2023-12-14,48,DPD90+,0,0,0
2023-12-14,6,Current,0,0,0
2023-12-14,6,DPD90+,0,0,0
2023-12-13,100,Current,0,0,0
2023-12-13,100,DPD3-14,0,0,0
2023-12-13,102,Current,0,0,0
2023-12-13,102,DPD15-29,0,0,0
2023-12-13,102,DPD3-14,1,1,0
2023-12-13,102,DPD90+,0,0,0
2023-12-13,104,Current,0,0,0
2023-12-13,104,DPD15-29,0,0,0
2023-12-13,104,DPD60-89,0,0,0
2023-12-13,104,DPD90+,0,0,0
2023-12-13,20,Current,96,96,0
2023-12-13,20,DPD15-29,104,104,0
2023-12-13,20,DPD3-14,403,403,0
2023-12-13,20,DPD30-59,36,36,0
2023-12-13,20,DPD60-89,2,2,0
2023-12-13,20,DPD90+,0,0,0
2023-12-13,22,Current,0,0,0
2023-12-13,22,DPD15-29,0,0,0
2023-12-13,22,DPD3-14,2,2,0
2023-12-13,22,DPD30-59,0,0,0
2023-12-13,22,DPD60-89,0,0,0
2023-12-13,22,DPD90+,0,0,0
2023-12-13,24,Current,74,74,0
2023-12-13,24,DPD15-29,57,57,0
2023-12-13,24,DPD3-14,216,216,0
2023-12-13,24,DPD30-59,25,25,0
2023-12-13,24,DPD60-89,0,0,0
2023-12-13,24,DPD90+,0,0,0
2023-12-13,26,Current,2,2,0
2023-12-13,26,DPD15-29,8,8,0
2023-12-13,26,DPD3-14,30,30,0
2023-12-13,26,DPD30-59,6,6,0
2023-12-13,26,DPD60-89,0,0,0
2023-12-13,26,DPD90+,0,0,0
2023-12-13,32,Current,1,1,0
2023-12-13,32,DPD15-29,47,47,0
2023-12-13,32,DPD3-14,189,189,0
2023-12-13,32,DPD30-59,23,23,0
2023-12-13,32,DPD60-89,0,0,0
2023-12-13,32,DPD90+,0,0,0
2023-12-13,34,Current,0,0,0
2023-12-13,34,DPD15-29,16,16,0
2023-12-13,34,DPD3-14,85,85,0
2023-12-13,34,DPD30-59,10,10,0
2023-12-13,34,DPD60-89,0,0,0
2023-12-13,34,DPD90+,0,0,0
2023-12-13,36,Current,1,1,0
2023-12-13,36,DPD15-29,15,15,0
2023-12-13,36,DPD3-14,64,64,0
2023-12-13,36,DPD30-59,6,6,0
2023-12-13,36,DPD60-89,0,0,0
2023-12-13,36,DPD90+,0,0,0
2023-12-13,38,Current,0,0,0
2023-12-13,38,DPD15-29,17,17,0
2023-12-13,38,DPD3-14,59,59,0
2023-12-13,38,DPD30-59,6,6,0
2023-12-13,38,DPD60-89,0,0,0
2023-12-13,38,DPD90+,0,0,0
2023-12-13,40,Current,8,8,0
2023-12-13,40,DPD15-29,7,7,0
2023-12-13,40,DPD3-14,33,33,0
2023-12-13,40,DPD30-59,5,5,0
2023-12-13,40,DPD60-89,0,0,0
2023-12-13,40,DPD90+,0,0,0
2023-12-13,42,Current,1,1,0
2023-12-13,42,DPD15-29,6,6,0
2023-12-13,42,DPD3-14,18,18,0
2023-12-13,42,DPD30-59,3,3,0
2023-12-13,42,DPD60-89,0,0,0
2023-12-13,42,DPD90+,0,0,0
2023-12-13,44,Current,2,2,0
2023-12-13,44,DPD15-29,7,7,0
2023-12-13,44,DPD3-14,42,42,0
2023-12-13,44,DPD30-59,4,4,0
2023-12-13,44,DPD60-89,0,0,0
2023-12-13,44,DPD90+,0,0,0
2023-12-13,46,Current,0,0,0
2023-12-13,46,DPD3-14,2,2,0
2023-12-13,46,DPD30-59,0,0,0
2023-12-13,46,DPD90+,0,0,0
2023-12-13,48,Current,44,44,0
2023-12-13,48,DPD15-29,8,8,0
2023-12-13,48,DPD3-14,23,23,0
2023-12-13,48,DPD30-59,3,3,0
2023-12-13,48,DPD60-89,0,0,0
2023-12-13,48,DPD90+,0,0,0
2023-12-13,6,Current,0,0,0
2023-12-13,6,DPD90+,0,0,0
2023-12-12,100,Current,0,0,0
2023-12-12,100,DPD3-14,0,0,0
2023-12-12,102,Current,0,0,0
2023-12-12,102,DPD3-14,1,1,0
2023-12-12,102,DPD90+,0,0,0
2023-12-12,104,Current,0,0,0
2023-12-12,104,DPD15-29,2,2,0
2023-12-12,104,DPD60-89,0,0,0
2023-12-12,104,DPD90+,0,0,0
2023-12-12,20,Current,98,98,0
2023-12-12,20,DPD15-29,434,434,0
2023-12-12,20,DPD3-14,331,331,0
2023-12-12,20,DPD30-59,390,390,0
2023-12-12,20,DPD60-89,106,106,0
2023-12-12,20,DPD90+,1,1,0
2023-12-12,22,Current,0,0,0
2023-12-12,22,DPD15-29,3,3,0
2023-12-12,22,DPD3-14,1,1,0
2023-12-12,22,DPD30-59,0,0,0
2023-12-12,22,DPD60-89,0,0,0
2023-12-12,22,DPD90+,0,0,0
2023-12-12,24,Current,58,58,0
2023-12-12,24,DPD15-29,212,212,0
2023-12-12,24,DPD3-14,154,154,0
2023-12-12,24,DPD30-59,116,116,0
2023-12-12,24,DPD60-89,0,0,0
2023-12-12,24,DPD90+,0,0,0
2023-12-12,26,Current,0,0,0
2023-12-12,26,DPD15-29,37,37,0
2023-12-12,26,DPD3-14,25,25,0
2023-12-12,26,DPD30-59,15,15,0
2023-12-12,26,DPD60-89,0,0,0
2023-12-12,26,DPD90+,0,0,0
2023-12-12,32,Current,0,0,0
2023-12-12,32,DPD15-29,242,242,0
2023-12-12,32,DPD3-14,129,129,0
2023-12-12,32,DPD30-59,156,156,0
2023-12-12,32,DPD60-89,0,0,0
2023-12-12,32,DPD90+,0,0,0
2023-12-12,34,Current,0,0,0
2023-12-12,34,DPD15-29,111,111,0
2023-12-12,34,DPD3-14,70,70,0
2023-12-12,34,DPD30-59,68,68,0
2023-12-12,34,DPD60-89,0,0,0
2023-12-12,34,DPD90+,0,0,0
2023-12-12,36,Current,0,0,0
2023-12-12,36,DPD15-29,68,68,0
2023-12-12,36,DPD3-14,47,47,0
2023-12-12,36,DPD30-59,33,33,0
2023-12-12,36,DPD60-89,0,0,0
2023-12-12,36,DPD90+,0,0,0
2023-12-12,38,Current,0,0,0
2023-12-12,38,DPD15-29,64,64,0
2023-12-12,38,DPD3-14,43,43,0
2023-12-12,38,DPD30-59,24,24,0
2023-12-12,38,DPD60-89,0,0,0
2023-12-12,38,DPD90+,0,0,0
2023-12-12,40,Current,0,0,0
2023-12-12,40,DPD15-29,27,27,0
2023-12-12,40,DPD3-14,22,22,0
2023-12-12,40,DPD30-59,19,19,0
2023-12-12,40,DPD60-89,0,0,0
2023-12-12,40,DPD90+,0,0,0
2023-12-12,42,Current,0,0,0
2023-12-12,42,DPD15-29,21,21,0
2023-12-12,42,DPD3-14,21,21,0
2023-12-12,42,DPD30-59,11,11,0
2023-12-12,42,DPD60-89,0,0,0
2023-12-12,42,DPD90+,0,0,0
2023-12-12,44,Current,0,0,0
2023-12-12,44,DPD15-29,38,38,0
2023-12-12,44,DPD3-14,56,56,0
2023-12-12,44,DPD30-59,28,28,0
2023-12-12,44,DPD60-89,0,0,0
2023-12-12,44,DPD90+,0,0,0
2023-12-12,46,Current,0,0,0
2023-12-12,46,DPD3-14,0,0,0
2023-12-12,46,DPD30-59,0,0,0
2023-12-12,46,DPD90+,0,0,0
2023-12-12,48,Current,57,57,0
2023-12-12,48,DPD15-29,24,24,0
2023-12-12,48,DPD3-14,16,16,0
2023-12-12,48,DPD30-59,17,17,0
2023-12-12,48,DPD60-89,0,0,0
2023-12-12,48,DPD90+,0,0,0
2023-12-12,6,Current,0,0,0
2023-12-12,6,DPD90+,0,0,0
2023-12-11,100,Current,0,0,0
2023-12-11,100,DPD3-14,0,0,0
2023-12-11,102,Current,0,0,0
2023-12-11,102,DPD3-14,2,2,0
2023-12-11,102,DPD90+,0,0,0
2023-12-11,104,Current,0,0,0
2023-12-11,104,DPD15-29,0,0,0
2023-12-11,104,DPD60-89,0,0,0
2023-12-11,104,DPD90+,0,0,0
2023-12-11,20,Current,119,119,0
2023-12-11,20,DPD15-29,87,87,0
2023-12-11,20,DPD3-14,527,527,0
2023-12-11,20,DPD30-59,25,25,0
2023-12-11,20,DPD60-89,4,4,0
2023-12-11,20,DPD90+,0,0,0
2023-12-11,22,Current,0,0,0
2023-12-11,22,DPD15-29,1,1,0
2023-12-11,22,DPD3-14,2,2,0
2023-12-11,22,DPD30-59,0,0,0
2023-12-11,22,DPD60-89,0,0,0
2023-12-11,22,DPD90+,0,0,0
2023-12-11,24,Current,66,66,0
2023-12-11,24,DPD15-29,66,66,0
2023-12-11,24,DPD3-14,273,273,0
2023-12-11,24,DPD30-59,43,43,0
2023-12-11,24,DPD60-89,0,0,0
2023-12-11,24,DPD90+,0,0,0
2023-12-11,26,Current,0,0,0
2023-12-11,26,DPD15-29,10,10,0
2023-12-11,26,DPD3-14,42,42,0
2023-12-11,26,DPD30-59,7,7,0
2023-12-11,26,DPD60-89,0,0,0
2023-12-11,26,DPD90+,0,0,0
2023-12-11,32,Current,0,0,0
2023-12-11,32,DPD15-29,38,38,0
2023-12-11,32,DPD3-14,226,226,0
2023-12-11,32,DPD30-59,16,16,0
2023-12-11,32,DPD60-89,0,0,0
2023-12-11,32,DPD90+,0,0,0
2023-12-11,34,Current,0,0,0
2023-12-11,34,DPD15-29,7,7,0
2023-12-11,34,DPD3-14,106,106,0
2023-12-11,34,DPD30-59,7,7,0
2023-12-11,34,DPD60-89,0,0,0
2023-12-11,34,DPD90+,0,0,0
2023-12-11,36,Current,0,0,0
2023-12-11,36,DPD15-29,10,10,0
2023-12-11,36,DPD3-14,71,71,0
2023-12-11,36,DPD30-59,13,13,0
2023-12-11,36,DPD60-89,0,0,0
2023-12-11,36,DPD90+,0,0,0
2023-12-11,38,Current,0,0,0
2023-12-11,38,DPD15-29,14,14,0
2023-12-11,38,DPD3-14,69,69,0
2023-12-11,38,DPD30-59,7,7,0
2023-12-11,38,DPD60-89,0,0,0
2023-12-11,38,DPD90+,0,0,0
2023-12-11,40,Current,0,0,0
2023-12-11,40,DPD15-29,8,8,0
2023-12-11,40,DPD3-14,41,41,0
2023-12-11,40,DPD30-59,4,4,0
2023-12-11,40,DPD60-89,0,0,0
2023-12-11,40,DPD90+,0,0,0
2023-12-11,42,Current,0,0,0
2023-12-11,42,DPD15-29,5,5,0
2023-12-11,42,DPD3-14,24,24,0
2023-12-11,42,DPD30-59,2,2,0
2023-12-11,42,DPD60-89,0,0,0
2023-12-11,42,DPD90+,0,0,0
2023-12-11,44,Current,0,0,0
2023-12-11,44,DPD15-29,7,7,0
2023-12-11,44,DPD3-14,57,57,0
2023-12-11,44,DPD30-59,13,13,0
2023-12-11,44,DPD60-89,0,0,0
2023-12-11,44,DPD90+,0,0,0
2023-12-11,46,Current,0,0,0
2023-12-11,46,DPD3-14,2,2,0
2023-12-11,46,DPD30-59,0,0,0
2023-12-11,46,DPD90+,0,0,0
2023-12-11,48,Current,47,47,0
2023-12-11,48,DPD15-29,7,7,0
2023-12-11,48,DPD3-14,34,34,0
2023-12-11,48,DPD30-59,4,4,0
2023-12-11,48,DPD60-89,0,0,0
2023-12-11,48,DPD90+,0,0,0
2023-12-11,6,Current,0,0,0
2023-12-11,6,DPD90+,0,0,0
2023-12-10,100,Current,0,0,0
2023-12-10,100,DPD3-14,0,0,0
2023-12-10,102,Current,0,0,0
2023-12-10,102,DPD3-14,1,1,0
2023-12-10,102,DPD90+,0,0,0
2023-12-10,104,Current,0,0,0
2023-12-10,104,DPD15-29,2,2,0
2023-12-10,104,DPD60-89,0,0,0
2023-12-10,104,DPD90+,0,0,0
2023-12-10,20,Current,157,157,0
2023-12-10,20,DPD15-29,469,469,0
2023-12-10,20,DPD3-14,333,333,0
2023-12-10,20,DPD30-59,119,119,0
2023-12-10,20,DPD60-89,282,282,0
2023-12-10,20,DPD90+,284,284,0
2023-12-10,22,Current,0,0,0
2023-12-10,22,DPD15-29,3,3,0
2023-12-10,22,DPD3-14,1,1,0
2023-12-10,22,DPD30-59,0,0,0
2023-12-10,22,DPD60-89,0,0,0
2023-12-10,22,DPD90+,0,0,0
2023-12-10,24,Current,85,85,0
2023-12-10,24,DPD15-29,226,226,0
2023-12-10,24,DPD3-14,173,173,0
2023-12-10,24,DPD30-59,27,27,0
2023-12-10,24,DPD60-89,0,0,0
2023-12-10,24,DPD90+,0,0,0
2023-12-10,26,Current,0,0,0
2023-12-10,26,DPD15-29,42,42,0
2023-12-10,26,DPD3-14,22,22,0
2023-12-10,26,DPD30-59,6,6,0
2023-12-10,26,DPD60-89,0,0,0
2023-12-10,26,DPD90+,0,0,0
2023-12-10,32,Current,0,0,0
2023-12-10,32,DPD15-29,268,268,0
2023-12-10,32,DPD3-14,137,137,0
2023-12-10,32,DPD30-59,56,56,0
2023-12-10,32,DPD60-89,0,0,0
2023-12-10,32,DPD90+,0,0,0
2023-12-10,34,Current,0,0,0
2023-12-10,34,DPD15-29,124,124,0
2023-12-10,34,DPD3-14,67,67,0
2023-12-10,34,DPD30-59,25,25,0
2023-12-10,34,DPD60-89,0,0,0
2023-12-10,34,DPD90+,0,0,0
2023-12-10,36,Current,0,0,0
2023-12-10,36,DPD15-29,71,71,0
2023-12-10,36,DPD3-14,64,64,0
2023-12-10,36,DPD30-59,12,12,0
2023-12-10,36,DPD60-89,0,0,0
2023-12-10,36,DPD90+,0,0,0
2023-12-10,38,Current,0,0,0
2023-12-10,38,DPD15-29,77,77,0
2023-12-10,38,DPD3-14,41,41,0
2023-12-10,38,DPD30-59,11,11,0
2023-12-10,38,DPD60-89,0,0,0
2023-12-10,38,DPD90+,0,0,0
2023-12-10,40,Current,0,0,0
2023-12-10,40,DPD15-29,28,28,0
2023-12-10,40,DPD3-14,20,20,0
2023-12-10,40,DPD30-59,4,4,0
2023-12-10,40,DPD60-89,0,0,0
2023-12-10,40,DPD90+,0,0,0
2023-12-10,42,Current,0,0,0
2023-12-10,42,DPD15-29,23,23,0
2023-12-10,42,DPD3-14,21,21,0
2023-12-10,42,DPD30-59,1,1,0
2023-12-10,42,DPD60-89,0,0,0
2023-12-10,42,DPD90+,0,0,0
2023-12-10,44,Current,0,0,0
2023-12-10,44,DPD15-29,44,44,0
2023-12-10,44,DPD3-14,55,55,0
2023-12-10,44,DPD30-59,8,8,0
2023-12-10,44,DPD60-89,0,0,0
2023-12-10,44,DPD90+,0,0,0
2023-12-10,46,Current,0,0,0
2023-12-10,46,DPD3-14,0,0,0
2023-12-10,46,DPD30-59,0,0,0
2023-12-10,46,DPD90+,0,0,0
2023-12-10,48,Current,108,108,0
2023-12-10,48,DPD15-29,29,29,0
2023-12-10,48,DPD3-14,20,20,0
2023-12-10,48,DPD30-59,0,0,0
2023-12-10,48,DPD60-89,0,0,0
2023-12-10,48,DPD90+,0,0,0
2023-12-10,6,Current,0,0,0
2023-12-10,6,DPD90+,0,0,0
2023-12-09,100,Current,0,0,0
2023-12-09,100,DPD3-14,0,0,0
2023-12-09,102,Current,0,0,0
2023-12-09,102,DPD3-14,1,1,0
2023-12-09,102,DPD90+,0,0,0
2023-12-09,104,Current,0,0,0
2023-12-09,104,DPD15-29,0,0,0
2023-12-09,104,DPD60-89,0,0,0
2023-12-09,104,DPD90+,0,0,0
2023-12-09,20,Current,118,118,0
2023-12-09,20,DPD15-29,60,60,0
2023-12-09,20,DPD3-14,451,451,0
2023-12-09,20,DPD30-59,35,35,0
2023-12-09,20,DPD60-89,0,0,0
2023-12-09,20,DPD90+,0,0,0
2023-12-09,22,Current,0,0,0
2023-12-09,22,DPD15-29,1,1,0
2023-12-09,22,DPD3-14,2,2,0
2023-12-09,22,DPD30-59,0,0,0
2023-12-09,22,DPD60-89,0,0,0
2023-12-09,22,DPD90+,0,0,0
2023-12-09,24,Current,80,80,0
2023-12-09,24,DPD15-29,55,55,0
2023-12-09,24,DPD3-14,239,239,0
2023-12-09,24,DPD30-59,21,21,0
2023-12-09,24,DPD60-89,0,0,0
2023-12-09,24,DPD90+,0,0,0
2023-12-09,26,Current,0,0,0
2023-12-09,26,DPD15-29,8,8,0
2023-12-09,26,DPD3-14,36,36,0
2023-12-09,26,DPD30-59,5,5,0
2023-12-09,26,DPD60-89,0,0,0
2023-12-09,26,DPD90+,0,0,0
2023-12-09,32,Current,0,0,0
2023-12-09,32,DPD15-29,29,29,0
2023-12-09,32,DPD3-14,200,200,0
2023-12-09,32,DPD30-59,22,22,0
2023-12-09,32,DPD60-89,0,0,0
2023-12-09,32,DPD90+,0,0,0
2023-12-09,34,Current,0,0,0
2023-12-09,34,DPD15-29,6,6,0
2023-12-09,34,DPD3-14,89,89,0
2023-12-09,34,DPD30-59,12,12,0
2023-12-09,34,DPD60-89,0,0,0
2023-12-09,34,DPD90+,0,0,0
2023-12-09,36,Current,0,0,0
2023-12-09,36,DPD15-29,9,9,0
2023-12-09,36,DPD3-14,63,63,0
2023-12-09,36,DPD30-59,9,9,0
2023-12-09,36,DPD60-89,0,0,0
2023-12-09,36,DPD90+,0,0,0
2023-12-09,38,Current,0,0,0
2023-12-09,38,DPD15-29,10,10,0
2023-12-09,38,DPD3-14,62,62,0
2023-12-09,38,DPD30-59,3,3,0
2023-12-09,38,DPD60-89,0,0,0
2023-12-09,38,DPD90+,0,0,0
2023-12-09,40,Current,0,0,0
2023-12-09,40,DPD15-29,7,7,0
2023-12-09,40,DPD3-14,34,34,0
2023-12-09,40,DPD30-59,4,4,0
2023-12-09,40,DPD60-89,0,0,0
2023-12-09,40,DPD90+,0,0,0
2023-12-09,42,Current,0,0,0
2023-12-09,42,DPD15-29,4,4,0
2023-12-09,42,DPD3-14,19,19,0
2023-12-09,42,DPD30-59,2,2,0
2023-12-09,42,DPD60-89,0,0,0
2023-12-09,42,DPD90+,0,0,0
2023-12-09,44,Current,0,0,0
2023-12-09,44,DPD15-29,9,9,0
2023-12-09,44,DPD3-14,41,41,0
2023-12-09,44,DPD30-59,1,1,0
2023-12-09,44,DPD60-89,0,0,0
2023-12-09,44,DPD90+,0,0,0
2023-12-09,46,Current,0,0,0
2023-12-09,46,DPD3-14,1,1,0
2023-12-09,46,DPD30-59,0,0,0
2023-12-09,46,DPD90+,0,0,0
2023-12-09,48,Current,76,76,0
2023-12-09,48,DPD15-29,6,6,0
2023-12-09,48,DPD3-14,30,30,0
2023-12-09,48,DPD30-59,2,2,0
2023-12-09,48,DPD60-89,0,0,0
2023-12-09,48,DPD90+,0,0,0
2023-12-09,6,Current,0,0,0
2023-12-09,6,DPD90+,0,0,0
2023-12-08,100,Current,0,0,0
2023-12-08,100,DPD3-14,0,0,0
2023-12-08,102,Current,0,0,0
2023-12-08,102,DPD3-14,0,0,0
2023-12-08,102,DPD90+,0,0,0
2023-12-08,104,Current,1,1,0
2023-12-08,104,DPD15-29,1,1,0
2023-12-08,104,DPD60-89,0,0,0
2023-12-08,104,DPD90+,0,0,0
2023-12-08,20,Current,712,712,0
2023-12-08,20,DPD15-29,509,509,0
2023-12-08,20,DPD3-14,402,402,0
2023-12-08,20,DPD30-59,434,434,0
2023-12-08,20,DPD60-89,55,55,0
2023-12-08,20,DPD90+,2,2,0
2023-12-08,22,Current,1,1,0
2023-12-08,22,DPD15-29,3,3,0
2023-12-08,22,DPD3-14,1,1,0
2023-12-08,22,DPD30-59,0,0,0
2023-12-08,22,DPD60-89,0,0,0
2023-12-08,22,DPD90+,0,0,0
2023-12-08,24,Current,512,512,0
2023-12-08,24,DPD15-29,234,234,0
2023-12-08,24,DPD3-14,189,189,0
2023-12-08,24,DPD30-59,119,119,0
2023-12-08,24,DPD60-89,0,0,0
2023-12-08,24,DPD90+,0,0,0
2023-12-08,26,Current,53,53,0
2023-12-08,26,DPD15-29,44,44,0
2023-12-08,26,DPD3-14,29,29,0
2023-12-08,26,DPD30-59,21,21,0
2023-12-08,26,DPD60-89,0,0,0
2023-12-08,26,DPD90+,0,0,0
2023-12-08,32,Current,182,182,0
2023-12-08,32,DPD15-29,260,260,0
2023-12-08,32,DPD3-14,196,196,0
2023-12-08,32,DPD30-59,165,165,0
2023-12-08,32,DPD60-89,0,0,0
2023-12-08,32,DPD90+,1,1,0
2023-12-08,34,Current,92,92,0
2023-12-08,34,DPD15-29,126,126,0
2023-12-08,34,DPD3-14,84,84,0
2023-12-08,34,DPD30-59,79,79,0
2023-12-08,34,DPD60-89,0,0,0
2023-12-08,34,DPD90+,0,0,0
2023-12-08,36,Current,95,95,0
2023-12-08,36,DPD15-29,75,75,0
2023-12-08,36,DPD3-14,66,66,0
2023-12-08,36,DPD30-59,44,44,0
2023-12-08,36,DPD60-89,0,0,0
2023-12-08,36,DPD90+,0,0,0
2023-12-08,38,Current,97,97,0
2023-12-08,38,DPD15-29,80,80,0
2023-12-08,38,DPD3-14,59,59,0
2023-12-08,38,DPD30-59,26,26,0
2023-12-08,38,DPD60-89,0,0,0
2023-12-08,38,DPD90+,1,1,0
2023-12-08,40,Current,73,73,0
2023-12-08,40,DPD15-29,32,32,0
2023-12-08,40,DPD3-14,19,19,0
2023-12-08,40,DPD30-59,18,18,0
2023-12-08,40,DPD60-89,1,1,0
2023-12-08,40,DPD90+,1,1,0
2023-12-08,42,Current,37,37,0
2023-12-08,42,DPD15-29,20,20,0
2023-12-08,42,DPD3-14,30,30,0
2023-12-08,42,DPD30-59,11,11,0
2023-12-08,42,DPD60-89,1,1,0
2023-12-08,42,DPD90+,0,0,0
2023-12-08,44,Current,92,92,0
2023-12-08,44,DPD15-29,49,49,0
2023-12-08,44,DPD3-14,51,51,0
2023-12-08,44,DPD30-59,38,38,0
2023-12-08,44,DPD60-89,1,1,0
2023-12-08,44,DPD90+,0,0,0
2023-12-08,46,Current,1,1,0
2023-12-08,46,DPD3-14,0,0,0
2023-12-08,46,DPD30-59,0,0,0
2023-12-08,46,DPD90+,0,0,0
2023-12-08,48,Current,178,178,0
2023-12-08,48,DPD15-29,28,28,0
2023-12-08,48,DPD3-14,23,23,0
2023-12-08,48,DPD30-59,15,15,0
2023-12-08,48,DPD60-89,0,0,0
2023-12-08,48,DPD90+,0,0,0
2023-12-08,6,Current,0,0,0
2023-12-08,6,DPD90+,0,0,0
2023-12-07,100,Current,0,0,0
2023-12-07,100,DPD3-14,1,1,0
2023-12-07,102,Current,0,0,0
2023-12-07,102,DPD15-29,0,0,0
2023-12-07,102,DPD3-14,1,1,0
2023-12-07,102,DPD60-89,0,0,0
2023-12-07,102,DPD90+,0,0,0
2023-12-07,104,Current,0,0,0
2023-12-07,104,DPD15-29,0,0,0
2023-12-07,104,DPD3-14,0,0,0
2023-12-07,104,DPD60-89,0,0,0
2023-12-07,104,DPD90+,0,0,0
2023-12-07,20,Current,87,87,0
2023-12-07,20,DPD15-29,59,59,0
2023-12-07,20,DPD3-14,445,445,0
2023-12-07,20,DPD30-59,21,21,0
2023-12-07,20,DPD60-89,3,3,0
2023-12-07,20,DPD90+,1,1,0
2023-12-07,22,Current,0,0,0
2023-12-07,22,DPD15-29,0,0,0
2023-12-07,22,DPD3-14,3,3,0
2023-12-07,22,DPD30-59,0,0,0
2023-12-07,22,DPD60-89,0,0,0
2023-12-07,22,DPD90+,0,0,0
2023-12-07,24,Current,43,43,0
2023-12-07,24,DPD15-29,55,55,0
2023-12-07,24,DPD3-14,244,244,0
2023-12-07,24,DPD30-59,52,52,0
2023-12-07,24,DPD60-89,0,0,0
2023-12-07,24,DPD90+,0,0,0
2023-12-07,26,Current,0,0,0
2023-12-07,26,DPD15-29,9,9,0
2023-12-07,26,DPD3-14,41,41,0
2023-12-07,26,DPD30-59,6,6,0
2023-12-07,26,DPD60-89,0,0,0
2023-12-07,26,DPD90+,0,0,0
2023-12-07,32,Current,0,0,0
2023-12-07,32,DPD15-29,24,24,0
2023-12-07,32,DPD3-14,210,210,0
2023-12-07,32,DPD30-59,18,18,0
2023-12-07,32,DPD60-89,0,0,0
2023-12-07,32,DPD90+,0,0,0
2023-12-07,34,Current,0,0,0
2023-12-07,34,DPD15-29,5,5,0
2023-12-07,34,DPD3-14,88,88,0
2023-12-07,34,DPD30-59,6,6,0
2023-12-07,34,DPD60-89,0,0,0
2023-12-07,34,DPD90+,0,0,0
2023-12-07,36,Current,0,0,0
2023-12-07,36,DPD15-29,12,12,0
2023-12-07,36,DPD3-14,69,69,0
2023-12-07,36,DPD30-59,15,15,0
2023-12-07,36,DPD60-89,0,0,0
2023-12-07,36,DPD90+,0,0,0
2023-12-07,38,Current,0,0,0
2023-12-07,38,DPD15-29,11,11,0
2023-12-07,38,DPD3-14,70,70,0
2023-12-07,38,DPD30-59,8,8,0
2023-12-07,38,DPD60-89,0,0,0
2023-12-07,38,DPD90+,0,0,0
2023-12-07,40,Current,0,0,0
2023-12-07,40,DPD15-29,7,7,0
2023-12-07,40,DPD3-14,40,40,0
2023-12-07,40,DPD30-59,4,4,0
2023-12-07,40,DPD60-89,0,0,0
2023-12-07,40,DPD90+,0,0,0
2023-12-07,42,Current,0,0,0
2023-12-07,42,DPD15-29,5,5,0
2023-12-07,42,DPD3-14,17,17,0
2023-12-07,42,DPD30-59,3,3,0
2023-12-07,42,DPD60-89,0,0,0
2023-12-07,42,DPD90+,0,0,0
2023-12-07,44,Current,0,0,0
2023-12-07,44,DPD15-29,11,11,0
2023-12-07,44,DPD3-14,43,43,0
2023-12-07,44,DPD30-59,14,14,0
2023-12-07,44,DPD60-89,0,0,0
2023-12-07,44,DPD90+,0,0,0
2023-12-07,46,Current,0,0,0
2023-12-07,46,DPD3-14,1,1,0
2023-12-07,46,DPD30-59,0,0,0
2023-12-07,46,DPD90+,0,0,0
2023-12-07,48,Current,44,44,0
2023-12-07,48,DPD15-29,6,6,0
2023-12-07,48,DPD3-14,28,28,0
2023-12-07,48,DPD30-59,2,2,0
2023-12-07,48,DPD60-89,0,0,0
2023-12-07,48,DPD90+,0,0,0
2023-12-07,6,Current,0,0,0
2023-12-07,6,DPD90+,0,0,0
2023-12-06,100,Current,0,0,0
2023-12-06,100,DPD3-14,0,0,0
2023-12-06,102,Current,0,0,0
2023-12-06,102,DPD15-29,1,1,0
2023-12-06,102,DPD3-14,0,0,0
2023-12-06,102,DPD60-89,0,0,0
2023-12-06,102,DPD90+,0,0,0
2023-12-06,104,Current,0,0,0
2023-12-06,104,DPD15-29,1,1,0
2023-12-06,104,DPD3-14,1,1,0
2023-12-06,104,DPD60-89,0,0,0
2023-12-06,104,DPD90+,0,0,0
2023-12-06,20,Current,103,103,0
2023-12-06,20,DPD15-29,461,461,0
2023-12-06,20,DPD3-14,414,414,0
2023-12-06,20,DPD30-59,82,82,0
2023-12-06,20,DPD60-89,1,1,0
2023-12-06,20,DPD90+,1,1,0
2023-12-06,22,Current,0,0,0
2023-12-06,22,DPD15-29,2,2,0
2023-12-06,22,DPD3-14,1,1,0
2023-12-06,22,DPD30-59,0,0,0
2023-12-06,22,DPD60-89,0,0,0
2023-12-06,22,DPD90+,0,0,0
2023-12-06,24,Current,51,51,0
2023-12-06,24,DPD15-29,211,211,0
2023-12-06,24,DPD3-14,176,176,0
2023-12-06,24,DPD30-59,24,24,0
2023-12-06,24,DPD60-89,0,0,0
2023-12-06,24,DPD90+,0,0,0
2023-12-06,26,Current,0,0,0
2023-12-06,26,DPD15-29,44,44,0
2023-12-06,26,DPD3-14,22,22,0
2023-12-06,26,DPD30-59,4,4,0
2023-12-06,26,DPD60-89,0,0,0
2023-12-06,26,DPD90+,0,0,0
2023-12-06,32,Current,0,0,0
2023-12-06,32,DPD15-29,256,256,0
2023-12-06,32,DPD3-14,192,192,0
2023-12-06,32,DPD30-59,41,41,0
2023-12-06,32,DPD60-89,0,0,0
2023-12-06,32,DPD90+,0,0,0
2023-12-06,34,Current,0,0,0
2023-12-06,34,DPD15-29,126,126,0
2023-12-06,34,DPD3-14,87,87,0
2023-12-06,34,DPD30-59,17,17,0
2023-12-06,34,DPD60-89,0,0,0
2023-12-06,34,DPD90+,0,0,0
2023-12-06,36,Current,0,0,0
2023-12-06,36,DPD15-29,70,70,0
2023-12-06,36,DPD3-14,61,61,0
2023-12-06,36,DPD30-59,7,7,0
2023-12-06,36,DPD60-89,0,0,0
2023-12-06,36,DPD90+,0,0,0
2023-12-06,38,Current,0,0,0
2023-12-06,38,DPD15-29,79,79,0
2023-12-06,38,DPD3-14,62,62,0
2023-12-06,38,DPD30-59,8,8,0
2023-12-06,38,DPD60-89,0,0,0
2023-12-06,38,DPD90+,0,0,0
2023-12-06,40,Current,0,0,0
2023-12-06,40,DPD15-29,29,29,0
2023-12-06,40,DPD3-14,25,25,0
2023-12-06,40,DPD30-59,4,4,0
2023-12-06,40,DPD60-89,0,0,0
2023-12-06,40,DPD90+,0,0,0
2023-12-06,42,Current,0,0,0
2023-12-06,42,DPD15-29,19,19,0
2023-12-06,42,DPD3-14,24,24,0
2023-12-06,42,DPD30-59,1,1,0
2023-12-06,42,DPD60-89,0,0,0
2023-12-06,42,DPD90+,0,0,0
2023-12-06,44,Current,0,0,0
2023-12-06,44,DPD15-29,49,49,0
2023-12-06,44,DPD3-14,46,46,0
2023-12-06,44,DPD30-59,4,4,0
2023-12-06,44,DPD60-89,0,0,0
2023-12-06,44,DPD90+,0,0,0
2023-12-06,46,Current,0,0,0
2023-12-06,46,DPD3-14,0,0,0
2023-12-06,46,DPD30-59,0,0,0
2023-12-06,46,DPD90+,0,0,0
2023-12-06,48,Current,64,64,0
2023-12-06,48,DPD15-29,28,28,0
2023-12-06,48,DPD3-14,14,14,0
2023-12-06,48,DPD30-59,0,0,0
2023-12-06,48,DPD60-89,0,0,0
2023-12-06,48,DPD90+,0,0,0
2023-12-06,6,Current,0,0,0
2023-12-06,6,DPD90+,0,0,0
2023-12-05,100,Current,0,0,0
2023-12-05,102,Current,0,0,0
2023-12-05,102,DPD15-29,0,0,0
2023-12-05,102,DPD3-14,1,1,0
2023-12-05,102,DPD90+,0,0,0
2023-12-05,104,Current,0,0,0
2023-12-05,104,DPD15-29,0,0,0
2023-12-05,104,DPD3-14,0,0,0
2023-12-05,104,DPD60-89,0,0,0
2023-12-05,104,DPD90+,0,0,0
2023-12-05,20,Current,59,59,0
2023-12-05,20,DPD15-29,38,38,0
2023-12-05,20,DPD3-14,506,506,0
2023-12-05,20,DPD30-59,34,34,0
2023-12-05,20,DPD60-89,0,0,0
2023-12-05,20,DPD90+,0,0,0
2023-12-05,22,Current,0,0,0
2023-12-05,22,DPD15-29,0,0,0
2023-12-05,22,DPD3-14,3,3,0
2023-12-05,22,DPD30-59,0,0,0
2023-12-05,22,DPD60-89,0,0,0
2023-12-05,22,DPD90+,0,0,0
2023-12-05,24,Current,32,32,0
2023-12-05,24,DPD15-29,41,41,0
2023-12-05,24,DPD3-14,269,269,0
2023-12-05,24,DPD30-59,17,17,0
2023-12-05,24,DPD60-89,0,0,0
2023-12-05,24,DPD90+,0,0,0
2023-12-05,26,Current,0,0,0
2023-12-05,26,DPD15-29,7,7,0
2023-12-05,26,DPD3-14,50,50,0
2023-12-05,26,DPD30-59,4,4,0
2023-12-05,26,DPD60-89,0,0,0
2023-12-05,26,DPD90+,0,0,0
2023-12-05,32,Current,0,0,0
2023-12-05,32,DPD15-29,18,18,0
2023-12-05,32,DPD3-14,220,220,0
2023-12-05,32,DPD30-59,17,17,0
2023-12-05,32,DPD60-89,0,0,0
2023-12-05,32,DPD90+,0,0,0
2023-12-05,34,Current,0,0,0
2023-12-05,34,DPD15-29,4,4,0
2023-12-05,34,DPD3-14,89,89,0
2023-12-05,34,DPD30-59,12,12,0
2023-12-05,34,DPD60-89,0,0,0
2023-12-05,34,DPD90+,0,0,0
2023-12-05,36,Current,0,0,0
2023-12-05,36,DPD15-29,13,13,0
2023-12-05,36,DPD3-14,81,81,0
2023-12-05,36,DPD30-59,5,5,0
2023-12-05,36,DPD60-89,0,0,0
2023-12-05,36,DPD90+,0,0,0
2023-12-05,38,Current,0,0,0
2023-12-05,38,DPD15-29,12,12,0
2023-12-05,38,DPD3-14,85,85,0
2023-12-05,38,DPD30-59,6,6,0
2023-12-05,38,DPD60-89,0,0,0
2023-12-05,38,DPD90+,0,0,0
2023-12-05,40,Current,0,0,0
2023-12-05,40,DPD15-29,4,4,0
2023-12-05,40,DPD3-14,46,46,0
2023-12-05,40,DPD30-59,3,3,0
2023-12-05,40,DPD60-89,0,0,0
2023-12-05,40,DPD90+,0,0,0
2023-12-05,42,Current,0,0,0
2023-12-05,42,DPD15-29,4,4,0
2023-12-05,42,DPD3-14,19,19,0
2023-12-05,42,DPD30-59,2,2,0
2023-12-05,42,DPD60-89,0,0,0
2023-12-05,42,DPD90+,0,0,0
2023-12-05,44,Current,0,0,0
2023-12-05,44,DPD15-29,14,14,0
2023-12-05,44,DPD3-14,54,54,0
2023-12-05,44,DPD30-59,3,3,0
2023-12-05,44,DPD60-89,0,0,0
2023-12-05,44,DPD90+,0,0,0
2023-12-05,46,Current,0,0,0
2023-12-05,46,DPD3-14,2,2,0
2023-12-05,46,DPD30-59,0,0,0
2023-12-05,46,DPD90+,0,0,0
2023-12-05,48,Current,44,44,0
2023-12-05,48,DPD15-29,5,5,0
2023-12-05,48,DPD3-14,20,20,0
2023-12-05,48,DPD30-59,2,2,0
2023-12-05,48,DPD60-89,0,0,0
2023-12-05,48,DPD90+,0,0,0
2023-12-05,6,Current,0,0,0
2023-12-05,6,DPD90+,0,0,0
2023-12-04,100,Current,0,0,0
2023-12-04,102,Current,0,0,0
2023-12-04,102,DPD15-29,1,1,0
2023-12-04,102,DPD3-14,0,0,0
2023-12-04,102,DPD60-89,0,0,0
2023-12-04,102,DPD90+,0,0,0
2023-12-04,104,Current,0,0,0
2023-12-04,104,DPD15-29,1,1,0
2023-12-04,104,DPD3-14,1,1,0
2023-12-04,104,DPD60-89,0,0,0
2023-12-04,104,DPD90+,0,0,0
2023-12-04,20,Current,124,124,0
2023-12-04,20,DPD15-29,484,484,0
2023-12-04,20,DPD3-14,478,478,0
2023-12-04,20,DPD30-59,543,543,0
2023-12-04,20,DPD60-89,85,85,0
2023-12-04,20,DPD90+,1,1,0
2023-12-04,22,Current,0,0,0
2023-12-04,22,DPD15-29,1,1,0
2023-12-04,22,DPD3-14,3,3,0
2023-12-04,22,DPD30-59,1,1,0
2023-12-04,22,DPD60-89,0,0,0
2023-12-04,22,DPD90+,0,0,0
2023-12-04,24,Current,71,71,0
2023-12-04,24,DPD15-29,219,219,0
2023-12-04,24,DPD3-14,221,221,0
2023-12-04,24,DPD30-59,150,150,0
2023-12-04,24,DPD60-89,0,0,0
2023-12-04,24,DPD90+,0,0,0
2023-12-04,26,Current,3,3,0
2023-12-04,26,DPD15-29,39,39,0
2023-12-04,26,DPD3-14,39,39,0
2023-12-04,26,DPD30-59,27,27,0
2023-12-04,26,DPD60-89,0,0,0
2023-12-04,26,DPD90+,0,0,0
2023-12-04,32,Current,1,1,0
2023-12-04,32,DPD15-29,251,251,0
2023-12-04,32,DPD3-14,249,249,0
2023-12-04,32,DPD30-59,220,220,0
2023-12-04,32,DPD60-89,0,0,0
2023-12-04,32,DPD90+,0,0,0
2023-12-04,34,Current,0,0,0
2023-12-04,34,DPD15-29,120,120,0
2023-12-04,34,DPD3-14,107,107,0
2023-12-04,34,DPD30-59,94,94,0
2023-12-04,34,DPD60-89,0,0,0
2023-12-04,34,DPD90+,0,0,0
2023-12-04,36,Current,1,1,0
2023-12-04,36,DPD15-29,71,71,0
2023-12-04,36,DPD3-14,76,76,0
2023-12-04,36,DPD30-59,55,55,0
2023-12-04,36,DPD60-89,0,0,0
2023-12-04,36,DPD90+,0,0,0
2023-12-04,38,Current,0,0,0
2023-12-04,38,DPD15-29,70,70,0
2023-12-04,38,DPD3-14,84,84,0
2023-12-04,38,DPD30-59,35,35,0
2023-12-04,38,DPD60-89,0,0,0
2023-12-04,38,DPD90+,0,0,0
2023-12-04,40,Current,8,8,0
2023-12-04,40,DPD15-29,27,27,0
2023-12-04,40,DPD3-14,31,31,0
2023-12-04,40,DPD30-59,20,20,0
2023-12-04,40,DPD60-89,0,0,0
2023-12-04,40,DPD90+,0,0,0
2023-12-04,42,Current,2,2,0
2023-12-04,42,DPD15-29,20,20,0
2023-12-04,42,DPD3-14,21,21,0
2023-12-04,42,DPD30-59,14,14,0
2023-12-04,42,DPD60-89,0,0,0
2023-12-04,42,DPD90+,0,0,0
2023-12-04,44,Current,2,2,0
2023-12-04,44,DPD15-29,55,55,0
2023-12-04,44,DPD3-14,46,46,0
2023-12-04,44,DPD30-59,47,47,0
2023-12-04,44,DPD60-89,0,0,0
2023-12-04,44,DPD90+,0,0,0
2023-12-04,46,Current,0,0,0
2023-12-04,46,DPD3-14,0,0,0
2023-12-04,46,DPD30-59,0,0,0
2023-12-04,46,DPD90+,0,0,0
2023-12-04,48,Current,71,71,0
2023-12-04,48,DPD15-29,25,25,0
2023-12-04,48,DPD3-14,22,22,0
2023-12-04,48,DPD30-59,22,22,0
2023-12-04,48,DPD60-89,0,0,0
2023-12-04,48,DPD90+,0,0,0
2023-12-04,6,Current,0,0,0
2023-12-04,6,DPD90+,0,0,0
2023-12-03,100,Current,0,0,0
2023-12-03,100,DPD30-59,0,0,0
2023-12-03,102,Current,0,0,0
2023-12-03,102,DPD15-29,0,0,0
2023-12-03,102,DPD3-14,1,1,0
2023-12-03,102,DPD60-89,0,0,0
2023-12-03,102,DPD90+,0,0,0
2023-12-03,104,Current,0,0,0
2023-12-03,104,DPD15-29,0,0,0
2023-12-03,104,DPD3-14,0,0,0
2023-12-03,104,DPD60-89,0,0,0
2023-12-03,104,DPD90+,0,0,0
2023-12-03,20,Current,121,121,0
2023-12-03,20,DPD15-29,27,27,0
2023-12-03,20,DPD3-14,370,370,0
2023-12-03,20,DPD30-59,3,3,0
2023-12-03,20,DPD60-89,1,1,0
2023-12-03,20,DPD90+,0,0,0
2023-12-03,22,Current,0,0,0
2023-12-03,22,DPD15-29,0,0,0
2023-12-03,22,DPD3-14,3,3,0
2023-12-03,22,DPD30-59,0,0,0
2023-12-03,22,DPD90+,0,0,0
2023-12-03,24,Current,82,82,0
2023-12-03,24,DPD15-29,40,40,0
2023-12-03,24,DPD3-14,208,208,0
2023-12-03,24,DPD30-59,47,47,0
2023-12-03,24,DPD60-89,0,0,0
2023-12-03,24,DPD90+,0,0,0
2023-12-03,26,Current,0,0,0
2023-12-03,26,DPD15-29,8,8,0
2023-12-03,26,DPD3-14,41,41,0
2023-12-03,26,DPD30-59,8,8,0
2023-12-03,26,DPD60-89,0,0,0
2023-12-03,26,DPD90+,0,0,0
2023-12-03,32,Current,0,0,0
2023-12-03,32,DPD15-29,15,15,0
2023-12-03,32,DPD3-14,167,167,0
2023-12-03,32,DPD30-59,3,3,0
2023-12-03,32,DPD60-89,0,0,0
2023-12-03,32,DPD90+,0,0,0
2023-12-03,34,Current,1,1,0
2023-12-03,34,DPD15-29,4,4,0
2023-12-03,34,DPD3-14,83,83,0
2023-12-03,34,DPD30-59,1,1,0
2023-12-03,34,DPD60-89,0,0,0
2023-12-03,34,DPD90+,0,0,0
2023-12-03,36,Current,0,0,0
2023-12-03,36,DPD15-29,10,10,0
2023-12-03,36,DPD3-14,63,63,0
2023-12-03,36,DPD30-59,12,12,0
2023-12-03,36,DPD60-89,0,0,0
2023-12-03,36,DPD90+,0,0,0
2023-12-03,38,Current,0,0,0
2023-12-03,38,DPD15-29,9,9,0
2023-12-03,38,DPD3-14,43,43,0
2023-12-03,38,DPD30-59,7,7,0
2023-12-03,38,DPD60-89,0,0,0
2023-12-03,38,DPD90+,0,0,0
2023-12-03,40,Current,0,0,0
2023-12-03,40,DPD15-29,6,6,0
2023-12-03,40,DPD3-14,33,33,0
2023-12-03,40,DPD30-59,4,4,0
2023-12-03,40,DPD60-89,0,0,0
2023-12-03,40,DPD90+,0,0,0
2023-12-03,42,Current,0,0,0
2023-12-03,42,DPD15-29,5,5,0
2023-12-03,42,DPD3-14,16,16,0
2023-12-03,42,DPD30-59,3,3,0
2023-12-03,42,DPD60-89,0,0,0
2023-12-03,42,DPD90+,0,0,0
2023-12-03,44,Current,0,0,0
2023-12-03,44,DPD15-29,15,15,0
2023-12-03,44,DPD3-14,33,33,0
2023-12-03,44,DPD30-59,12,12,0
2023-12-03,44,DPD60-89,0,0,0
2023-12-03,44,DPD90+,0,0,0
2023-12-03,46,Current,0,0,0
2023-12-03,46,DPD30-59,0,0,0
2023-12-03,46,DPD90+,0,0,0
2023-12-03,48,Current,94,94,0
2023-12-03,48,DPD15-29,3,3,0
2023-12-03,48,DPD3-14,18,18,0
2023-12-03,48,DPD30-59,1,1,0
2023-12-03,48,DPD60-89,0,0,0
2023-12-03,48,DPD90+,0,0,0
2023-12-03,6,Current,0,0,0
2023-12-03,6,DPD90+,0,0,0
2023-12-02,100,Current,0,0,0
2023-12-02,100,DPD15-29,1,1,0
2023-12-02,102,Current,0,0,0
2023-12-02,102,DPD15-29,0,0,0
2023-12-02,102,DPD3-14,1,1,0
2023-12-02,102,DPD60-89,0,0,0
2023-12-02,102,DPD90+,0,0,0
2023-12-02,104,Current,0,0,0
2023-12-02,104,DPD3-14,1,1,0
2023-12-02,104,DPD60-89,0,0,0
2023-12-02,104,DPD90+,0,0,0
2023-12-02,20,Current,248,248,0
2023-12-02,20,DPD15-29,439,439,0
2023-12-02,20,DPD3-14,587,587,0
2023-12-02,20,DPD30-59,49,49,0
2023-12-02,20,DPD60-89,377,377,0
2023-12-02,20,DPD90+,295,295,0
2023-12-02,22,Current,0,0,0
2023-12-02,22,DPD15-29,0,0,0
2023-12-02,22,DPD3-14,4,4,0
2023-12-02,22,DPD30-59,0,0,0
2023-12-02,22,DPD90+,0,0,0
2023-12-02,24,Current,117,117,0
2023-12-02,24,DPD15-29,161,161,0
2023-12-02,24,DPD3-14,308,308,0
2023-12-02,24,DPD30-59,11,11,0
2023-12-02,24,DPD60-89,0,0,0
2023-12-02,24,DPD90+,0,0,0
2023-12-02,26,Current,9,9,0
2023-12-02,26,DPD15-29,34,34,0
2023-12-02,26,DPD3-14,47,47,0
2023-12-02,26,DPD30-59,3,3,0
2023-12-02,26,DPD60-89,0,0,0
2023-12-02,26,DPD90+,0,0,0
2023-12-02,32,Current,57,57,0
2023-12-02,32,DPD15-29,201,201,0
2023-12-02,32,DPD3-14,321,321,0
2023-12-02,32,DPD30-59,18,18,0
2023-12-02,32,DPD60-89,0,0,0
2023-12-02,32,DPD90+,0,0,0
2023-12-02,34,Current,24,24,0
2023-12-02,34,DPD15-29,97,97,0
2023-12-02,34,DPD3-14,134,134,0
2023-12-02,34,DPD30-59,10,10,0
2023-12-02,34,DPD60-89,0,0,0
2023-12-02,34,DPD90+,0,0,0
2023-12-02,36,Current,17,17,0
2023-12-02,36,DPD15-29,63,63,0
2023-12-02,36,DPD3-14,91,91,0
2023-12-02,36,DPD30-59,5,5,0
2023-12-02,36,DPD60-89,0,0,0
2023-12-02,36,DPD90+,0,0,0
2023-12-02,38,Current,24,24,0
2023-12-02,38,DPD15-29,60,60,0
2023-12-02,38,DPD3-14,97,97,0
2023-12-02,38,DPD30-59,6,6,0
2023-12-02,38,DPD60-89,0,0,0
2023-12-02,38,DPD90+,0,0,0
2023-12-02,40,Current,9,9,0
2023-12-02,40,DPD15-29,21,21,0
2023-12-02,40,DPD3-14,42,42,0
2023-12-02,40,DPD30-59,4,4,0
2023-12-02,40,DPD60-89,0,0,0
2023-12-02,40,DPD90+,0,0,0
2023-12-02,42,Current,7,7,0
2023-12-02,42,DPD15-29,15,15,0
2023-12-02,42,DPD3-14,27,27,0
2023-12-02,42,DPD30-59,1,1,0
2023-12-02,42,DPD60-89,0,0,0
2023-12-02,42,DPD90+,0,0,0
2023-12-02,44,Current,19,19,0
2023-12-02,44,DPD15-29,45,45,0
2023-12-02,44,DPD3-14,59,59,0
2023-12-02,44,DPD30-59,2,2,0
2023-12-02,44,DPD60-89,0,0,0
2023-12-02,44,DPD90+,0,0,0
2023-12-02,46,Current,2,2,0
2023-12-02,46,DPD30-59,0,0,0
2023-12-02,46,DPD90+,0,0,0
2023-12-02,48,Current,58,58,0
2023-12-02,48,DPD15-29,25,25,0
2023-12-02,48,DPD3-14,30,30,0
2023-12-02,48,DPD30-59,0,0,0
2023-12-02,48,DPD60-89,0,0,0
2023-12-02,48,DPD90+,0,0,0
2023-12-02,6,Current,0,0,0
2023-12-02,6,DPD90+,0,0,0
2023-12-01,100,Current,0,0,0
2023-12-01,100,DPD15-29,0,0,0
2023-12-01,102,Current,0,0,0
2023-12-01,102,DPD3-14,0,0,0
2023-12-01,102,DPD60-89,0,0,0
2023-12-01,102,DPD90+,0,0,0
2023-12-01,104,Current,0,0,0
2023-12-01,104,DPD3-14,0,0,0
2023-12-01,104,DPD60-89,0,0,0
2023-12-01,104,DPD90+,0,0,0
2023-12-01,20,Current,545,545,0
2023-12-01,20,DPD15-29,14,14,0
2023-12-01,20,DPD3-14,173,173,0
2023-12-01,20,DPD30-59,33,33,0
2023-12-01,20,DPD60-89,0,0,0
2023-12-01,20,DPD90+,0,0,0
2023-12-01,22,Current,1,1,0
2023-12-01,22,DPD15-29,0,0,0
2023-12-01,22,DPD3-14,1,1,0
2023-12-01,22,DPD30-59,0,0,0
2023-12-01,22,DPD90+,0,0,0
2023-12-01,24,Current,347,347,0
2023-12-01,24,DPD15-29,35,35,0
2023-12-01,24,DPD3-14,112,112,0
2023-12-01,24,DPD30-59,8,8,0
2023-12-01,24,DPD60-89,0,0,0
2023-12-01,24,DPD90+,0,0,0
2023-12-01,26,Current,32,32,0
2023-12-01,26,DPD15-29,5,5,0
2023-12-01,26,DPD3-14,20,20,0
2023-12-01,26,DPD30-59,2,2,0
2023-12-01,26,DPD60-89,0,0,0
2023-12-01,26,DPD90+,1,1,0
2023-12-01,32,Current,144,144,0
2023-12-01,32,DPD15-29,7,7,0
2023-12-01,32,DPD3-14,56,56,0
2023-12-01,32,DPD30-59,11,11,0
2023-12-01,32,DPD60-89,1,1,0
2023-12-01,32,DPD90+,1,1,0
2023-12-01,34,Current,53,53,0
2023-12-01,34,DPD15-29,2,2,0
2023-12-01,34,DPD3-14,29,29,0
2023-12-01,34,DPD30-59,6,6,0
2023-12-01,34,DPD60-89,0,0,0
2023-12-01,34,DPD90+,0,0,0
2023-12-01,36,Current,72,72,0
2023-12-01,36,DPD15-29,10,10,0
2023-12-01,36,DPD3-14,28,28,0
2023-12-01,36,DPD30-59,2,2,0
2023-12-01,36,DPD60-89,0,0,0
2023-12-01,36,DPD90+,1,1,0
2023-12-01,38,Current,60,60,0
2023-12-01,38,DPD15-29,8,8,0
2023-12-01,38,DPD3-14,31,31,0
2023-12-01,38,DPD30-59,3,3,0
2023-12-01,38,DPD60-89,1,1,0
2023-12-01,38,DPD90+,0,0,0
2023-12-01,40,Current,42,42,0
2023-12-01,40,DPD15-29,6,6,0
2023-12-01,40,DPD3-14,13,13,0
2023-12-01,40,DPD30-59,2,2,0
2023-12-01,40,DPD60-89,1,1,0
2023-12-01,40,DPD90+,1,1,0
2023-12-01,42,Current,20,20,0
2023-12-01,42,DPD15-29,4,4,0
2023-12-01,42,DPD3-14,13,13,0
2023-12-01,42,DPD30-59,1,1,0
2023-12-01,42,DPD60-89,0,0,0
2023-12-01,42,DPD90+,0,0,0
2023-12-01,44,Current,71,71,0
2023-12-01,44,DPD15-29,10,10,0
2023-12-01,44,DPD3-14,16,16,0
2023-12-01,44,DPD30-59,1,1,0
2023-12-01,44,DPD60-89,0,0,0
2023-12-01,44,DPD90+,0,0,0
2023-12-01,46,Current,1,1,0
2023-12-01,46,DPD30-59,0,0,0
2023-12-01,46,DPD90+,0,0,0
2023-12-01,48,Current,159,159,0
2023-12-01,48,DPD15-29,2,2,0
2023-12-01,48,DPD3-14,10,10,0
2023-12-01,48,DPD30-59,2,2,0
2023-12-01,48,DPD60-89,0,0,0
2023-12-01,48,DPD90+,0,0,0
2023-12-01,6,Current,0,0,0
2023-12-01,6,DPD90+,0,0,0
2023-11-30,100,Current,0,0,0
2023-11-30,100,DPD15-29,1,1,0
2023-11-30,102,Current,0,0,0
2023-11-30,102,DPD3-14,1,1,0
2023-11-30,102,DPD60-89,0,0,0
2023-11-30,102,DPD90+,0,0,0
2023-11-30,104,Current,0,0,0
2023-11-30,104,DPD3-14,2,2,0
2023-11-30,104,DPD60-89,0,0,0
2023-11-30,104,DPD90+,0,0,0
2023-11-30,20,Current,174,174,0
2023-11-30,20,DPD15-29,386,386,0
2023-11-30,20,DPD3-14,743,743,0
2023-11-30,20,DPD30-59,644,644,0
2023-11-30,20,DPD60-89,0,0,0
2023-11-30,20,DPD90+,0,0,0
2023-11-30,22,Current,1,1,0
2023-11-30,22,DPD15-29,0,0,0
2023-11-30,22,DPD3-14,5,5,0
2023-11-30,22,DPD30-59,1,1,0
2023-11-30,22,DPD90+,0,0,0
2023-11-30,24,Current,141,141,0
2023-11-30,24,DPD15-29,139,139,0
2023-11-30,24,DPD3-14,382,382,0
2023-11-30,24,DPD30-59,167,167,0
2023-11-30,24,DPD60-89,0,0,0
2023-11-30,24,DPD90+,0,0,0
2023-11-30,26,Current,7,7,0
2023-11-30,26,DPD15-29,22,22,0
2023-11-30,26,DPD3-14,67,67,0
2023-11-30,26,DPD30-59,34,34,0
2023-11-30,26,DPD60-89,0,0,0
2023-11-30,26,DPD90+,0,0,0
2023-11-30,32,Current,28,28,0
2023-11-30,32,DPD15-29,172,172,0
2023-11-30,32,DPD3-14,410,410,0
2023-11-30,32,DPD30-59,245,245,0
2023-11-30,32,DPD60-89,0,0,0
2023-11-30,32,DPD90+,0,0,0
2023-11-30,34,Current,9,9,0
2023-11-30,34,DPD15-29,68,68,0
2023-11-30,34,DPD3-14,175,175,0
2023-11-30,34,DPD30-59,114,114,0
2023-11-30,34,DPD60-89,0,0,0
2023-11-30,34,DPD90+,0,0,0
2023-11-30,36,Current,9,9,0
2023-11-30,36,DPD15-29,51,51,0
2023-11-30,36,DPD3-14,113,113,0
2023-11-30,36,DPD30-59,52,52,0
2023-11-30,36,DPD60-89,0,0,0
2023-11-30,36,DPD90+,0,0,0
2023-11-30,38,Current,10,10,0
2023-11-30,38,DPD15-29,39,39,0
2023-11-30,38,DPD3-14,126,126,0
2023-11-30,38,DPD30-59,42,42,0
2023-11-30,38,DPD60-89,0,0,0
2023-11-30,38,DPD90+,0,0,0
2023-11-30,40,Current,11,11,0
2023-11-30,40,DPD15-29,16,16,0
2023-11-30,40,DPD3-14,47,47,0
2023-11-30,40,DPD30-59,23,23,0
2023-11-30,40,DPD60-89,0,0,0
2023-11-30,40,DPD90+,0,0,0
2023-11-30,42,Current,4,4,0
2023-11-30,42,DPD15-29,12,12,0
2023-11-30,42,DPD3-14,33,33,0
2023-11-30,42,DPD30-59,17,17,0
2023-11-30,42,DPD60-89,0,0,0
2023-11-30,42,DPD90+,0,0,0
2023-11-30,44,Current,17,17,0
2023-11-30,44,DPD15-29,44,44,0
2023-11-30,44,DPD3-14,77,77,0
2023-11-30,44,DPD30-59,48,48,0
2023-11-30,44,DPD60-89,0,0,0
2023-11-30,44,DPD90+,0,0,0
2023-11-30,46,Current,0,0,0
2023-11-30,46,DPD15-29,1,1,0
2023-11-30,46,DPD3-14,1,1,0
2023-11-30,46,DPD30-59,0,0,0
2023-11-30,46,DPD90+,0,0,0
2023-11-30,48,Current,65,65,0
2023-11-30,48,DPD15-29,18,18,0
2023-11-30,48,DPD3-14,39,39,0
2023-11-30,48,DPD30-59,18,18,0
2023-11-30,48,DPD60-89,0,0,0
2023-11-30,48,DPD90+,0,0,0
2023-11-30,6,Current,0,0,0
2023-11-30,6,DPD90+,0,0,0
2023-11-29,100,Current,0,0,0
2023-11-29,100,DPD15-29,0,0,0
2023-11-29,102,Current,0,0,0
2023-11-29,102,DPD15-29,0,0,0
2023-11-29,102,DPD3-14,0,0,0
2023-11-29,102,DPD60-89,0,0,0
2023-11-29,102,DPD90+,0,0,0
2023-11-29,104,Current,0,0,0
2023-11-29,104,DPD3-14,0,0,0
2023-11-29,104,DPD60-89,0,0,0
2023-11-29,104,DPD90+,0,0,0
2023-11-29,20,Current,118,118,0
2023-11-29,20,DPD15-29,0,0,0
2023-11-29,20,DPD3-14,114,114,0
2023-11-29,20,DPD30-59,0,0,0
2023-11-29,20,DPD60-89,0,0,0
2023-11-29,20,DPD90+,0,0,0
2023-11-29,22,Current,0,0,0
2023-11-29,22,DPD15-29,0,0,0
2023-11-29,22,DPD3-14,1,1,0
2023-11-29,22,DPD30-59,0,0,0
2023-11-29,22,DPD90+,0,0,0
2023-11-29,24,Current,62,62,0
2023-11-29,24,DPD15-29,30,30,0
2023-11-29,24,DPD3-14,83,83,0
2023-11-29,24,DPD30-59,47,47,0
2023-11-29,24,DPD60-89,0,0,0
2023-11-29,24,DPD90+,0,0,0
2023-11-29,26,Current,1,1,0
2023-11-29,26,DPD15-29,7,7,0
2023-11-29,26,DPD3-14,13,13,0
2023-11-29,26,DPD30-59,9,9,0
2023-11-29,26,DPD60-89,0,0,0
2023-11-29,26,DPD90+,0,0,0
2023-11-29,32,Current,0,0,0
2023-11-29,32,DPD15-29,2,2,0
2023-11-29,32,DPD3-14,4,4,0
2023-11-29,32,DPD30-59,0,0,0
2023-11-29,32,DPD60-89,0,0,0
2023-11-29,32,DPD90+,0,0,0
2023-11-29,34,Current,0,0,0
2023-11-29,34,DPD15-29,0,0,0
2023-11-29,34,DPD3-14,0,0,0
2023-11-29,34,DPD30-59,0,0,0
2023-11-29,34,DPD60-89,0,0,0
2023-11-29,34,DPD90+,0,0,0
2023-11-29,36,Current,8,8,0
2023-11-29,36,DPD15-29,5,5,0
2023-11-29,36,DPD3-14,24,24,0
2023-11-29,36,DPD30-59,18,18,0
2023-11-29,36,DPD60-89,0,0,0
2023-11-29,36,DPD90+,0,0,0
2023-11-29,38,Current,5,5,0
2023-11-29,38,DPD15-29,8,8,0
2023-11-29,38,DPD3-14,26,26,0
2023-11-29,38,DPD30-59,9,9,0
2023-11-29,38,DPD60-89,0,0,0
2023-11-29,38,DPD90+,0,0,0
2023-11-29,40,Current,3,3,0
2023-11-29,40,DPD15-29,7,7,0
2023-11-29,40,DPD3-14,11,11,0
2023-11-29,40,DPD30-59,8,8,0
2023-11-29,40,DPD60-89,0,0,0
2023-11-29,40,DPD90+,0,0,0
2023-11-29,42,Current,0,0,0
2023-11-29,42,DPD15-29,3,3,0
2023-11-29,42,DPD3-14,8,8,0
2023-11-29,42,DPD30-59,2,2,0
2023-11-29,42,DPD60-89,0,0,0
2023-11-29,42,DPD90+,0,0,0
2023-11-29,44,Current,6,6,0
2023-11-29,44,DPD15-29,12,12,0
2023-11-29,44,DPD3-14,11,11,0
2023-11-29,44,DPD30-59,10,10,0
2023-11-29,44,DPD60-89,0,0,0
2023-11-29,44,DPD90+,0,0,0
2023-11-29,46,Current,0,0,0
2023-11-29,46,DPD15-29,0,0,0
2023-11-29,46,DPD3-14,0,0,0
2023-11-29,46,DPD30-59,0,0,0
2023-11-29,46,DPD90+,0,0,0
2023-11-29,48,Current,67,67,0
2023-11-29,48,DPD15-29,2,2,0
2023-11-29,48,DPD3-14,7,7,0
2023-11-29,48,DPD30-59,2,2,0
2023-11-29,48,DPD60-89,0,0,0
2023-11-29,48,DPD90+,0,0,0
2023-11-29,6,Current,0,0,0
2023-11-29,6,DPD90+,0,0,0
2023-11-28,100,Current,0,0,0
2023-11-28,100,DPD15-29,1,1,0
2023-11-28,102,Current,1,1,0
2023-11-28,102,DPD15-29,0,0,0
2023-11-28,102,DPD3-14,1,1,0
2023-11-28,102,DPD60-89,0,0,0
2023-11-28,102,DPD90+,0,0,0
2023-11-28,104,Current,0,0,0
2023-11-28,104,DPD3-14,2,2,0
2023-11-28,104,DPD60-89,0,0,0
2023-11-28,104,DPD90+,0,0,0
2023-11-28,20,Current,184,184,0
2023-11-28,20,DPD15-29,0,0,0
2023-11-28,20,DPD3-14,524,524,0
2023-11-28,20,DPD30-59,0,0,0
2023-11-28,20,DPD60-89,0,0,0
2023-11-28,20,DPD90+,0,0,0
2023-11-28,22,Current,0,0,0
2023-11-28,22,DPD15-29,0,0,0
2023-11-28,22,DPD3-14,4,4,0
2023-11-28,22,DPD30-59,1,1,0
2023-11-28,22,DPD90+,0,0,0
2023-11-28,24,Current,111,111,0
2023-11-28,24,DPD15-29,86,86,0
2023-11-28,24,DPD3-14,260,260,0
2023-11-28,24,DPD30-59,68,68,0
2023-11-28,24,DPD60-89,0,0,0
2023-11-28,24,DPD90+,0,0,0
2023-11-28,26,Current,9,9,0
2023-11-28,26,DPD15-29,12,12,0
2023-11-28,26,DPD3-14,56,56,0
2023-11-28,26,DPD30-59,21,21,0
2023-11-28,26,DPD60-89,0,0,0
2023-11-28,26,DPD90+,0,0,0
2023-11-28,32,Current,30,30,0
2023-11-28,32,DPD15-29,61,61,0
2023-11-28,32,DPD3-14,194,194,0
2023-11-28,32,DPD30-59,72,72,0
2023-11-28,32,DPD60-89,0,0,0
2023-11-28,32,DPD90+,0,0,0
2023-11-28,34,Current,17,17,0
2023-11-28,34,DPD15-29,25,25,0
2023-11-28,34,DPD3-14,89,89,0
2023-11-28,34,DPD30-59,37,37,0
2023-11-28,34,DPD60-89,0,0,0
2023-11-28,34,DPD90+,0,0,0
2023-11-28,36,Current,9,9,0
2023-11-28,36,DPD15-29,27,27,0
2023-11-28,36,DPD3-14,78,78,0
2023-11-28,36,DPD30-59,30,30,0
2023-11-28,36,DPD60-89,0,0,0
2023-11-28,36,DPD90+,0,0,0
2023-11-28,38,Current,15,15,0
2023-11-28,38,DPD15-29,36,36,0
2023-11-28,38,DPD3-14,85,85,0
2023-11-28,38,DPD30-59,24,24,0
2023-11-28,38,DPD60-89,0,0,0
2023-11-28,38,DPD90+,0,0,0
2023-11-28,40,Current,10,10,0
2023-11-28,40,DPD15-29,18,18,0
2023-11-28,40,DPD3-14,33,33,0
2023-11-28,40,DPD30-59,12,12,0
2023-11-28,40,DPD60-89,0,0,0
2023-11-28,40,DPD90+,0,0,0
2023-11-28,42,Current,8,8,0
2023-11-28,42,DPD15-29,6,6,0
2023-11-28,42,DPD3-14,20,20,0
2023-11-28,42,DPD30-59,9,9,0
2023-11-28,42,DPD60-89,0,0,0
2023-11-28,42,DPD90+,0,0,0
2023-11-28,44,Current,13,13,0
2023-11-28,44,DPD15-29,29,29,0
2023-11-28,44,DPD3-14,66,66,0
2023-11-28,44,DPD30-59,19,19,0
2023-11-28,44,DPD60-89,0,0,0
2023-11-28,44,DPD90+,0,0,0
2023-11-28,46,Current,0,0,0
2023-11-28,46,DPD15-29,1,1,0
2023-11-28,46,DPD3-14,0,0,0
2023-11-28,46,DPD30-59,0,0,0
2023-11-28,46,DPD60-89,0,0,0
2023-11-28,48,Current,61,61,0
2023-11-28,48,DPD15-29,12,12,0
2023-11-28,48,DPD3-14,33,33,0
2023-11-28,48,DPD30-59,11,11,0
2023-11-28,48,DPD60-89,0,0,0
2023-11-28,48,DPD90+,0,0,0
2023-11-28,6,Current,0,0,0
2023-11-28,6,DPD90+,0,0,0
2023-11-27,100,Current,0,0,0
2023-11-27,100,DPD15-29,0,0,0
2023-11-27,102,Current,0,0,0
2023-11-27,102,DPD15-29,0,0,0
2023-11-27,102,DPD3-14,0,0,0
2023-11-27,102,DPD60-89,0,0,0
2023-11-27,102,DPD90+,0,0,0
2023-11-27,104,Current,0,0,0
2023-11-27,104,DPD3-14,0,0,0
2023-11-27,104,DPD60-89,0,0,0
2023-11-27,104,DPD90+,0,0,0
2023-11-27,20,Current,116,116,0
2023-11-27,20,DPD15-29,0,0,0
2023-11-27,20,DPD3-14,457,457,0
2023-11-27,20,DPD30-59,0,0,0
2023-11-27,20,DPD60-89,0,0,0
2023-11-27,20,DPD90+,0,0,0
2023-11-27,22,Current,0,0,0
2023-11-27,22,DPD15-29,1,1,0
2023-11-27,22,DPD3-14,3,3,0
2023-11-27,22,DPD30-59,0,0,0
2023-11-27,22,DPD90+,0,0,0
2023-11-27,24,Current,71,71,0
2023-11-27,24,DPD15-29,97,97,0
2023-11-27,24,DPD3-14,297,297,0
2023-11-27,24,DPD30-59,146,146,0
2023-11-27,24,DPD60-89,0,0,0
2023-11-27,24,DPD90+,0,0,0
2023-11-27,26,Current,0,0,0
2023-11-27,26,DPD15-29,18,18,0
2023-11-27,26,DPD3-14,40,40,0
2023-11-27,26,DPD30-59,23,23,0
2023-11-27,26,DPD60-89,0,0,0
2023-11-27,26,DPD90+,0,0,0
2023-11-27,32,Current,0,0,0
2023-11-27,32,DPD15-29,145,145,0
2023-11-27,32,DPD3-14,282,282,0
2023-11-27,32,DPD30-59,171,171,0
2023-11-27,32,DPD60-89,0,0,0
2023-11-27,32,DPD90+,0,0,0
2023-11-27,34,Current,0,0,0
2023-11-27,34,DPD15-29,63,63,0
2023-11-27,34,DPD3-14,104,104,0
2023-11-27,34,DPD30-59,81,81,0
2023-11-27,34,DPD60-89,0,0,0
2023-11-27,34,DPD90+,0,0,0
2023-11-27,36,Current,0,0,0
2023-11-27,36,DPD15-29,37,37,0
2023-11-27,36,DPD3-14,76,76,0
2023-11-27,36,DPD30-59,39,39,0
2023-11-27,36,DPD60-89,0,0,0
2023-11-27,36,DPD90+,0,0,0
2023-11-27,38,Current,0,0,0
2023-11-27,38,DPD15-29,23,23,0
2023-11-27,38,DPD3-14,80,80,0
2023-11-27,38,DPD30-59,35,35,0
2023-11-27,38,DPD60-89,0,0,0
2023-11-27,38,DPD90+,0,0,0
2023-11-27,40,Current,0,0,0
2023-11-27,40,DPD15-29,13,13,0
2023-11-27,40,DPD3-14,38,38,0
2023-11-27,40,DPD30-59,15,15,0
2023-11-27,40,DPD60-89,0,0,0
2023-11-27,40,DPD90+,0,0,0
2023-11-27,42,Current,0,0,0
2023-11-27,42,DPD15-29,11,11,0
2023-11-27,42,DPD3-14,27,27,0
2023-11-27,42,DPD30-59,13,13,0
2023-11-27,42,DPD60-89,0,0,0
2023-11-27,42,DPD90+,0,0,0
2023-11-27,44,Current,0,0,0
2023-11-27,44,DPD15-29,37,37,0
2023-11-27,44,DPD3-14,52,52,0
2023-11-27,44,DPD30-59,37,37,0
2023-11-27,44,DPD60-89,0,0,0
2023-11-27,44,DPD90+,0,0,0
2023-11-27,46,Current,0,0,0
2023-11-27,46,DPD15-29,0,0,0
2023-11-27,46,DPD3-14,1,1,0
2023-11-27,46,DPD30-59,0,0,0
2023-11-27,46,DPD60-89,0,0,0
2023-11-27,48,Current,67,67,0
2023-11-27,48,DPD15-29,6,6,0
2023-11-27,48,DPD3-14,28,28,0
2023-11-27,48,DPD30-59,8,8,0
2023-11-27,48,DPD60-89,0,0,0
2023-11-27,48,DPD90+,0,0,0
2023-11-27,6,Current,0,0,0
2023-11-27,6,DPD90+,0,0,0
2023-11-26,100,Current,0,0,0
2023-11-26,100,DPD15-29,1,1,0
2023-11-26,102,Current,0,0,0
2023-11-26,102,DPD15-29,0,0,0
2023-11-26,102,DPD3-14,2,2,0
2023-11-26,102,DPD60-89,0,0,0
2023-11-26,102,DPD90+,0,0,0
2023-11-26,104,Current,0,0,0
2023-11-26,104,DPD3-14,1,1,0
2023-11-26,104,DPD60-89,0,0,0
2023-11-26,104,DPD90+,0,0,0
2023-11-26,20,Current,147,147,0
2023-11-26,20,DPD15-29,0,0,0
2023-11-26,20,DPD3-14,547,547,0
2023-11-26,20,DPD30-59,0,0,0
2023-11-26,20,DPD60-89,0,0,0
2023-11-26,20,DPD90+,0,0,0
2023-11-26,22,Current,0,0,0
2023-11-26,22,DPD15-29,0,0,0
2023-11-26,22,DPD3-14,4,4,0
2023-11-26,22,DPD30-59,1,1,0
2023-11-26,22,DPD90+,0,0,0
2023-11-26,24,Current,64,64,0
2023-11-26,24,DPD15-29,87,87,0
2023-11-26,24,DPD3-14,269,269,0
2023-11-26,24,DPD30-59,72,72,0
2023-11-26,24,DPD60-89,0,0,0
2023-11-26,24,DPD90+,0,0,0
2023-11-26,26,Current,0,0,0
2023-11-26,26,DPD15-29,15,15,0
2023-11-26,26,DPD3-14,51,51,0
2023-11-26,26,DPD30-59,22,22,0
2023-11-26,26,DPD60-89,0,0,0
2023-11-26,26,DPD90+,0,0,0
2023-11-26,32,Current,1,1,0
2023-11-26,32,DPD15-29,67,67,0
2023-11-26,32,DPD3-14,171,171,0
2023-11-26,32,DPD30-59,69,69,0
2023-11-26,32,DPD60-89,0,0,0
2023-11-26,32,DPD90+,0,0,0
2023-11-26,34,Current,0,0,0
2023-11-26,34,DPD15-29,28,28,0
2023-11-26,34,DPD3-14,84,84,0
2023-11-26,34,DPD30-59,39,39,0
2023-11-26,34,DPD60-89,0,0,0
2023-11-26,34,DPD90+,0,0,0
2023-11-26,36,Current,1,1,0
2023-11-26,36,DPD15-29,29,29,0
2023-11-26,36,DPD3-14,75,75,0
2023-11-26,36,DPD30-59,30,30,0
2023-11-26,36,DPD60-89,0,0,0
2023-11-26,36,DPD90+,0,0,0
2023-11-26,38,Current,0,0,0
2023-11-26,38,DPD15-29,31,31,0
2023-11-26,38,DPD3-14,85,85,0
2023-11-26,38,DPD30-59,21,21,0
2023-11-26,38,DPD60-89,0,0,0
2023-11-26,38,DPD90+,0,0,0
2023-11-26,40,Current,0,0,0
2023-11-26,40,DPD15-29,14,14,0
2023-11-26,40,DPD3-14,37,37,0
2023-11-26,40,DPD30-59,14,14,0
2023-11-26,40,DPD60-89,0,0,0
2023-11-26,40,DPD90+,0,0,0
2023-11-26,42,Current,0,0,0
2023-11-26,42,DPD15-29,6,6,0
2023-11-26,42,DPD3-14,20,20,0
2023-11-26,42,DPD30-59,10,10,0
2023-11-26,42,DPD60-89,0,0,0
2023-11-26,42,DPD90+,0,0,0
2023-11-26,44,Current,1,1,0
2023-11-26,44,DPD15-29,28,28,0
2023-11-26,44,DPD3-14,68,68,0
2023-11-26,44,DPD30-59,18,18,0
2023-11-26,44,DPD60-89,0,0,0
2023-11-26,44,DPD90+,0,0,0
2023-11-26,46,Current,0,0,0
2023-11-26,46,DPD15-29,1,1,0
2023-11-26,46,DPD3-14,0,0,0
2023-11-26,46,DPD30-59,0,0,0
2023-11-26,46,DPD90+,0,0,0
2023-11-26,48,Current,93,93,0
2023-11-26,48,DPD15-29,14,14,0
2023-11-26,48,DPD3-14,32,32,0
2023-11-26,48,DPD30-59,10,10,0
2023-11-26,48,DPD60-89,0,0,0
2023-11-26,48,DPD90+,0,0,0
2023-11-26,6,Current,0,0,0
2023-11-26,6,DPD90+,0,0,0
2023-11-25,100,Current,0,0,0
2023-11-25,100,DPD15-29,0,0,0
2023-11-25,102,Current,0,0,0
2023-11-25,102,DPD15-29,0,0,0
2023-11-25,102,DPD3-14,0,0,0
2023-11-25,102,DPD60-89,0,0,0
2023-11-25,102,DPD90+,0,0,0
2023-11-25,104,Current,0,0,0
2023-11-25,104,DPD3-14,0,0,0
2023-11-25,104,DPD60-89,0,0,0
2023-11-25,104,DPD90+,0,0,0
2023-11-25,20,Current,136,136,0
2023-11-25,20,DPD15-29,0,0,0
2023-11-25,20,DPD3-14,407,407,0
2023-11-25,20,DPD30-59,0,0,0
2023-11-25,20,DPD60-89,0,0,0
2023-11-25,20,DPD90+,0,0,0
2023-11-25,22,Current,0,0,0
2023-11-25,22,DPD15-29,1,1,0
2023-11-25,22,DPD3-14,1,1,0
2023-11-25,22,DPD30-59,0,0,0
2023-11-25,22,DPD60-89,0,0,0
2023-11-25,22,DPD90+,0,0,0
2023-11-25,24,Current,124,124,0
2023-11-25,24,DPD15-29,91,91,0
2023-11-25,24,DPD3-14,278,278,0
2023-11-25,24,DPD30-59,147,147,0
2023-11-25,24,DPD60-89,0,0,0
2023-11-25,24,DPD90+,0,0,0
2023-11-25,26,Current,6,6,0
2023-11-25,26,DPD15-29,18,18,0
2023-11-25,26,DPD3-14,41,41,0
2023-11-25,26,DPD30-59,20,20,0
2023-11-25,26,DPD60-89,0,0,0
2023-11-25,26,DPD90+,0,0,0
2023-11-25,32,Current,37,37,0
2023-11-25,32,DPD15-29,139,139,0
2023-11-25,32,DPD3-14,286,286,0
2023-11-25,32,DPD30-59,173,173,0
2023-11-25,32,DPD60-89,0,0,0
2023-11-25,32,DPD90+,0,0,0
2023-11-25,34,Current,21,21,0
2023-11-25,34,DPD15-29,57,57,0
2023-11-25,34,DPD3-14,104,104,0
2023-11-25,34,DPD30-59,82,82,0
2023-11-25,34,DPD60-89,0,0,0
2023-11-25,34,DPD90+,0,0,0
2023-11-25,36,Current,10,10,0
2023-11-25,36,DPD15-29,31,31,0
2023-11-25,36,DPD3-14,71,71,0
2023-11-25,36,DPD30-59,39,39,0
2023-11-25,36,DPD60-89,0,0,0
2023-11-25,36,DPD90+,0,0,0
2023-11-25,38,Current,11,11,0
2023-11-25,38,DPD15-29,22,22,0
2023-11-25,38,DPD3-14,67,67,0
2023-11-25,38,DPD30-59,35,35,0
2023-11-25,38,DPD60-89,0,0,0
2023-11-25,38,DPD90+,0,0,0
2023-11-25,40,Current,7,7,0
2023-11-25,40,DPD15-29,15,15,0
2023-11-25,40,DPD3-14,38,38,0
2023-11-25,40,DPD30-59,16,16,0
2023-11-25,40,DPD60-89,0,0,0
2023-11-25,40,DPD90+,0,0,0
2023-11-25,42,Current,2,2,0
2023-11-25,42,DPD15-29,12,12,0
2023-11-25,42,DPD3-14,26,26,0
2023-11-25,42,DPD30-59,15,15,0
2023-11-25,42,DPD60-89,0,0,0
2023-11-25,42,DPD90+,0,0,0
2023-11-25,44,Current,9,9,0
2023-11-25,44,DPD15-29,32,32,0
2023-11-25,44,DPD3-14,58,58,0
2023-11-25,44,DPD30-59,33,33,0
2023-11-25,44,DPD60-89,0,0,0
2023-11-25,44,DPD90+,0,0,0
2023-11-25,46,Current,0,0,0
2023-11-25,46,DPD15-29,0,0,0
2023-11-25,46,DPD3-14,0,0,0
2023-11-25,46,DPD30-59,0,0,0
2023-11-25,46,DPD90+,0,0,0
2023-11-25,48,Current,67,67,0
2023-11-25,48,DPD15-29,4,4,0
2023-11-25,48,DPD3-14,28,28,0
2023-11-25,48,DPD30-59,8,8,0
2023-11-25,48,DPD60-89,0,0,0
2023-11-25,48,DPD90+,0,0,0
2023-11-25,6,Current,0,0,0
2023-11-25,6,DPD90+,0,0,0
2023-11-24,100,Current,0,0,0
2023-11-24,100,DPD15-29,1,1,0
2023-11-24,102,Current,0,0,0
2023-11-24,102,DPD15-29,0,0,0
2023-11-24,102,DPD3-14,2,2,0
2023-11-24,102,DPD60-89,0,0,0
2023-11-24,102,DPD90+,0,0,0
2023-11-24,104,Current,1,1,0
2023-11-24,104,DPD3-14,1,1,0
2023-11-24,104,DPD30-59,0,0,0
2023-11-24,104,DPD90+,0,0,0
2023-11-24,20,Current,490,490,0
2023-11-24,20,DPD15-29,1,1,0
2023-11-24,20,DPD3-14,574,574,0
2023-11-24,20,DPD30-59,1,1,0
2023-11-24,20,DPD60-89,0,0,0
2023-11-24,20,DPD90+,0,0,0
2023-11-24,22,Current,0,0,0
2023-11-24,22,DPD15-29,0,0,0
2023-11-24,22,DPD3-14,2,2,0
2023-11-24,22,DPD30-59,1,1,0
2023-11-24,22,DPD60-89,0,0,0
2023-11-24,22,DPD90+,0,0,0
2023-11-24,24,Current,289,289,0
2023-11-24,24,DPD15-29,91,91,0
2023-11-24,24,DPD3-14,248,248,0
2023-11-24,24,DPD30-59,65,65,0
2023-11-24,24,DPD60-89,0,0,0
2023-11-24,24,DPD90+,0,0,0
2023-11-24,26,Current,29,29,0
2023-11-24,26,DPD15-29,18,18,0
2023-11-24,26,DPD3-14,40,40,0
2023-11-24,26,DPD30-59,19,19,0
2023-11-24,26,DPD60-89,0,0,0
2023-11-24,26,DPD90+,0,0,0
2023-11-24,32,Current,113,113,0
2023-11-24,32,DPD15-29,62,62,0
2023-11-24,32,DPD3-14,151,151,0
2023-11-24,32,DPD30-59,58,58,0
2023-11-24,32,DPD60-89,0,0,0
2023-11-24,32,DPD90+,1,1,0
2023-11-24,34,Current,43,43,0
2023-11-24,34,DPD15-29,33,33,0
2023-11-24,34,DPD3-14,69,69,0
2023-11-24,34,DPD30-59,35,35,0
2023-11-24,34,DPD60-89,0,0,0
2023-11-24,34,DPD90+,0,0,0
2023-11-24,36,Current,47,47,0
2023-11-24,36,DPD15-29,28,28,0
2023-11-24,36,DPD3-14,68,68,0
2023-11-24,36,DPD30-59,34,34,0
2023-11-24,36,DPD60-89,0,0,0
2023-11-24,36,DPD90+,0,0,0
2023-11-24,38,Current,52,52,0
2023-11-24,38,DPD15-29,28,28,0
2023-11-24,38,DPD3-14,85,85,0
2023-11-24,38,DPD30-59,21,21,0
2023-11-24,38,DPD60-89,0,0,0
2023-11-24,38,DPD90+,0,0,0
2023-11-24,40,Current,37,37,0
2023-11-24,40,DPD15-29,14,14,0
2023-11-24,40,DPD3-14,32,32,0
2023-11-24,40,DPD30-59,13,13,0
2023-11-24,40,DPD60-89,1,1,0
2023-11-24,40,DPD90+,0,0,0
2023-11-24,42,Current,25,25,0
2023-11-24,42,DPD15-29,7,7,0
2023-11-24,42,DPD3-14,23,23,0
2023-11-24,42,DPD30-59,6,6,0
2023-11-24,42,DPD60-89,0,0,0
2023-11-24,42,DPD90+,0,0,0
2023-11-24,44,Current,50,50,0
2023-11-24,44,DPD15-29,27,27,0
2023-11-24,44,DPD3-14,62,62,0
2023-11-24,44,DPD30-59,19,19,0
2023-11-24,44,DPD60-89,0,0,0
2023-11-24,44,DPD90+,0,0,0
2023-11-24,46,Current,0,0,0
2023-11-24,46,DPD15-29,1,1,0
2023-11-24,46,DPD30-59,0,0,0
2023-11-24,46,DPD60-89,0,0,0
2023-11-24,48,Current,167,167,0
2023-11-24,48,DPD15-29,13,13,0
2023-11-24,48,DPD3-14,31,31,0
2023-11-24,48,DPD30-59,8,8,0
2023-11-24,48,DPD60-89,0,0,0
2023-11-24,48,DPD90+,0,0,0
2023-11-24,6,Current,0,0,0
2023-11-24,6,DPD60-89,0,0,0
2023-11-23,100,Current,0,0,0
2023-11-23,100,DPD15-29,0,0,0
2023-11-23,102,Current,0,0,0
2023-11-23,102,DPD15-29,0,0,0
2023-11-23,102,DPD3-14,0,0,0
2023-11-23,102,DPD60-89,0,0,0
2023-11-23,104,Current,0,0,0
2023-11-23,104,DPD3-14,0,0,0
2023-11-23,104,DPD30-59,0,0,0
2023-11-23,104,DPD90+,0,0,0
2023-11-23,20,Current,90,90,0
2023-11-23,20,DPD15-29,0,0,0
2023-11-23,20,DPD3-14,279,279,0
2023-11-23,20,DPD30-59,7,7,0
2023-11-23,20,DPD60-89,0,0,0
2023-11-23,20,DPD90+,0,0,0
2023-11-23,22,Current,0,0,0
2023-11-23,22,DPD15-29,0,0,0
2023-11-23,22,DPD3-14,1,1,0
2023-11-23,22,DPD30-59,0,0,0
2023-11-23,22,DPD60-89,0,0,0
2023-11-23,22,DPD90+,0,0,0
2023-11-23,24,Current,82,82,0
2023-11-23,24,DPD15-29,95,95,0
2023-11-23,24,DPD3-14,227,227,0
2023-11-23,24,DPD30-59,155,155,0
2023-11-23,24,DPD60-89,0,0,0
2023-11-23,24,DPD90+,0,0,0
2023-11-23,26,Current,4,4,0
2023-11-23,26,DPD15-29,17,17,0
2023-11-23,26,DPD3-14,30,30,0
2023-11-23,26,DPD30-59,21,21,0
2023-11-23,26,DPD60-89,0,0,0
2023-11-23,26,DPD90+,0,0,0
2023-11-23,32,Current,20,20,0
2023-11-23,32,DPD15-29,142,142,0
2023-11-23,32,DPD3-14,246,246,0
2023-11-23,32,DPD30-59,174,174,0
2023-11-23,32,DPD60-89,0,0,0
2023-11-23,32,DPD90+,0,0,0
2023-11-23,34,Current,7,7,0
2023-11-23,34,DPD15-29,59,59,0
2023-11-23,34,DPD3-14,101,101,0
2023-11-23,34,DPD30-59,78,78,0
2023-11-23,34,DPD60-89,0,0,0
2023-11-23,34,DPD90+,0,0,0
2023-11-23,36,Current,7,7,0
2023-11-23,36,DPD15-29,31,31,0
2023-11-23,36,DPD3-14,60,60,0
2023-11-23,36,DPD30-59,39,39,0
2023-11-23,36,DPD60-89,0,0,0
2023-11-23,36,DPD90+,0,0,0
2023-11-23,38,Current,9,9,0
2023-11-23,38,DPD15-29,18,18,0
2023-11-23,38,DPD3-14,55,55,0
2023-11-23,38,DPD30-59,35,35,0
2023-11-23,38,DPD60-89,0,0,0
2023-11-23,38,DPD90+,0,0,0
2023-11-23,40,Current,4,4,0
2023-11-23,40,DPD15-29,13,13,0
2023-11-23,40,DPD3-14,31,31,0
2023-11-23,40,DPD30-59,17,17,0
2023-11-23,40,DPD60-89,0,0,0
2023-11-23,40,DPD90+,0,0,0
2023-11-23,42,Current,2,2,0
2023-11-23,42,DPD15-29,10,10,0
2023-11-23,42,DPD3-14,23,23,0
2023-11-23,42,DPD30-59,17,17,0
2023-11-23,42,DPD60-89,0,0,0
2023-11-23,42,DPD90+,0,0,0
2023-11-23,44,Current,7,7,0
2023-11-23,44,DPD15-29,26,26,0
2023-11-23,44,DPD3-14,63,63,0
2023-11-23,44,DPD30-59,31,31,0
2023-11-23,44,DPD60-89,0,0,0
2023-11-23,44,DPD90+,0,0,0
2023-11-23,46,Current,0,0,0
2023-11-23,46,DPD15-29,0,0,0
2023-11-23,46,DPD30-59,0,0,0
2023-11-23,46,DPD60-89,0,0,0
2023-11-23,48,Current,58,58,0
2023-11-23,48,DPD15-29,4,4,0
2023-11-23,48,DPD3-14,23,23,0
2023-11-23,48,DPD30-59,9,9,0
2023-11-23,48,DPD60-89,0,0,0
2023-11-23,48,DPD90+,0,0,0
2023-11-23,6,Current,0,0,0
2023-11-23,6,DPD60-89,0,0,0
2023-11-22,100,Current,0,0,0
2023-11-22,100,DPD15-29,1,1,0
2023-11-22,100,DPD90+,0,0,0
2023-11-22,102,Current,0,0,0
2023-11-22,102,DPD15-29,0,0,0
2023-11-22,102,DPD3-14,2,2,0
2023-11-22,102,DPD60-89,0,0,0
2023-11-22,104,Current,0,0,0
2023-11-22,104,DPD3-14,0,0,0
2023-11-22,104,DPD30-59,0,0,0
2023-11-22,104,DPD90+,0,0,0
2023-11-22,20,Current,171,171,0
2023-11-22,20,DPD15-29,0,0,0
2023-11-22,20,DPD3-14,568,568,0
2023-11-22,20,DPD30-59,10,10,0
2023-11-22,20,DPD60-89,0,0,0
2023-11-22,20,DPD90+,0,0,0
2023-11-22,22,Current,0,0,0
2023-11-22,22,DPD15-29,0,0,0
2023-11-22,22,DPD3-14,0,0,0
2023-11-22,22,DPD30-59,1,1,0
2023-11-22,22,DPD60-89,0,0,0
2023-11-22,22,DPD90+,0,0,0
2023-11-22,24,Current,98,98,0
2023-11-22,24,DPD15-29,91,91,0
2023-11-22,24,DPD3-14,210,210,0
2023-11-22,24,DPD30-59,60,60,0
2023-11-22,24,DPD60-89,0,0,0
2023-11-22,24,DPD90+,0,0,0
2023-11-22,26,Current,8,8,0
2023-11-22,26,DPD15-29,16,16,0
2023-11-22,26,DPD3-14,40,40,0
2023-11-22,26,DPD30-59,18,18,0
2023-11-22,26,DPD60-89,0,0,0
2023-11-22,26,DPD90+,0,0,0
2023-11-22,32,Current,23,23,0
2023-11-22,32,DPD15-29,64,64,0
2023-11-22,32,DPD3-14,120,120,0
2023-11-22,32,DPD30-59,56,56,0
2023-11-22,32,DPD60-89,0,0,0
2023-11-22,32,DPD90+,0,0,0
2023-11-22,34,Current,14,14,0
2023-11-22,34,DPD15-29,30,30,0
2023-11-22,34,DPD3-14,62,62,0
2023-11-22,34,DPD30-59,28,28,0
2023-11-22,34,DPD60-89,0,0,0
2023-11-22,34,DPD90+,0,0,0
2023-11-22,36,Current,8,8,0
2023-11-22,36,DPD15-29,26,26,0
2023-11-22,36,DPD3-14,66,66,0
2023-11-22,36,DPD30-59,31,31,0
2023-11-22,36,DPD60-89,0,0,0
2023-11-22,36,DPD90+,0,0,0
2023-11-22,38,Current,7,7,0
2023-11-22,38,DPD15-29,25,25,0
2023-11-22,38,DPD3-14,71,71,0
2023-11-22,38,DPD30-59,17,17,0
2023-11-22,38,DPD60-89,0,0,0
2023-11-22,38,DPD90+,0,0,0
2023-11-22,40,Current,8,8,0
2023-11-22,40,DPD15-29,10,10,0
2023-11-22,40,DPD3-14,36,36,0
2023-11-22,40,DPD30-59,12,12,0
2023-11-22,40,DPD60-89,0,0,0
2023-11-22,40,DPD90+,0,0,0
2023-11-22,42,Current,4,4,0
2023-11-22,42,DPD15-29,8,8,0
2023-11-22,42,DPD3-14,24,24,0
2023-11-22,42,DPD30-59,5,5,0
2023-11-22,42,DPD60-89,0,0,0
2023-11-22,42,DPD90+,0,0,0
2023-11-22,44,Current,17,17,0
2023-11-22,44,DPD15-29,28,28,0
2023-11-22,44,DPD3-14,47,47,0
2023-11-22,44,DPD30-59,16,16,0
2023-11-22,44,DPD60-89,0,0,0
2023-11-22,44,DPD90+,0,0,0
2023-11-22,46,Current,0,0,0
2023-11-22,46,DPD15-29,1,1,0
2023-11-22,46,DPD30-59,0,0,0
2023-11-22,46,DPD60-89,0,0,0
2023-11-22,48,Current,53,53,0
2023-11-22,48,DPD15-29,12,12,0
2023-11-22,48,DPD3-14,19,19,0
2023-11-22,48,DPD30-59,6,6,0
2023-11-22,48,DPD60-89,0,0,0
2023-11-22,48,DPD90+,0,0,0
2023-11-22,6,Current,0,0,0
2023-11-22,6,DPD60-89,0,0,0
2023-11-21,100,Current,0,0,0
2023-11-21,100,DPD15-29,0,0,0
2023-11-21,100,DPD90+,0,0,0
2023-11-21,102,Current,0,0,0
2023-11-21,102,DPD15-29,0,0,0
2023-11-21,102,DPD3-14,0,0,0
2023-11-21,102,DPD60-89,0,0,0
2023-11-21,104,Current,0,0,0
2023-11-21,104,DPD3-14,0,0,0
2023-11-21,104,DPD30-59,0,0,0
2023-11-21,104,DPD60-89,0,0,0
2023-11-21,104,DPD90+,0,0,0
2023-11-21,20,Current,105,105,0
2023-11-21,20,DPD15-29,0,0,0
2023-11-21,20,DPD3-14,191,191,0
2023-11-21,20,DPD30-59,9,9,0
2023-11-21,20,DPD60-89,0,0,0
2023-11-21,20,DPD90+,0,0,0
2023-11-21,22,Current,1,1,0
2023-11-21,22,DPD15-29,0,0,0
2023-11-21,22,DPD3-14,1,1,0
2023-11-21,22,DPD30-59,0,0,0
2023-11-21,22,DPD60-89,0,0,0
2023-11-21,22,DPD90+,0,0,0
2023-11-21,24,Current,81,81,0
2023-11-21,24,DPD15-29,104,104,0
2023-11-21,24,DPD3-14,182,182,0
2023-11-21,24,DPD30-59,154,154,0
2023-11-21,24,DPD60-89,0,0,0
2023-11-21,24,DPD90+,0,0,0
2023-11-21,26,Current,7,7,0
2023-11-21,26,DPD15-29,22,22,0
2023-11-21,26,DPD3-14,33,33,0
2023-11-21,26,DPD30-59,20,20,0
2023-11-21,26,DPD60-89,0,0,0
2023-11-21,26,DPD90+,0,0,0
2023-11-21,32,Current,30,30,0
2023-11-21,32,DPD15-29,81,81,0
2023-11-21,32,DPD3-14,157,157,0
2023-11-21,32,DPD30-59,107,107,0
2023-11-21,32,DPD60-89,0,0,0
2023-11-21,32,DPD90+,0,0,0
2023-11-21,34,Current,15,15,0
2023-11-21,34,DPD15-29,29,29,0
2023-11-21,34,DPD3-14,59,59,0
2023-11-21,34,DPD30-59,54,54,0
2023-11-21,34,DPD60-89,0,0,0
2023-11-21,34,DPD90+,0,0,0
2023-11-21,36,Current,14,14,0
2023-11-21,36,DPD15-29,33,33,0
2023-11-21,36,DPD3-14,65,65,0
2023-11-21,36,DPD30-59,36,36,0
2023-11-21,36,DPD60-89,0,0,0
2023-11-21,36,DPD90+,0,0,0
2023-11-21,38,Current,15,15,0
2023-11-21,38,DPD15-29,23,23,0
2023-11-21,38,DPD3-14,54,54,0
2023-11-21,38,DPD30-59,36,36,0
2023-11-21,38,DPD60-89,0,0,0
2023-11-21,38,DPD90+,0,0,0
2023-11-21,40,Current,9,9,0
2023-11-21,40,DPD15-29,14,14,0
2023-11-21,40,DPD3-14,25,25,0
2023-11-21,40,DPD30-59,16,16,0
2023-11-21,40,DPD60-89,0,0,0
2023-11-21,40,DPD90+,0,0,0
2023-11-21,42,Current,4,4,0
2023-11-21,42,DPD15-29,7,7,0
2023-11-21,42,DPD3-14,18,18,0
2023-11-21,42,DPD30-59,17,17,0
2023-11-21,42,DPD60-89,0,0,0
2023-11-21,42,DPD90+,0,0,0
2023-11-21,44,Current,7,7,0
2023-11-21,44,DPD15-29,27,27,0
2023-11-21,44,DPD3-14,60,60,0
2023-11-21,44,DPD30-59,29,29,0
2023-11-21,44,DPD60-89,0,0,0
2023-11-21,44,DPD90+,0,0,0
2023-11-21,46,Current,0,0,0
2023-11-21,46,DPD15-29,0,0,0
2023-11-21,46,DPD30-59,0,0,0
2023-11-21,46,DPD60-89,0,0,0
2023-11-21,48,Current,66,66,0
2023-11-21,48,DPD15-29,5,5,0
2023-11-21,48,DPD3-14,19,19,0
2023-11-21,48,DPD30-59,11,11,0
2023-11-21,48,DPD60-89,0,0,0
2023-11-21,48,DPD90+,0,0,0
2023-11-21,6,Current,0,0,0
2023-11-21,6,DPD60-89,0,0,0
2023-11-21,6,DPD90+,0,0,0
2023-11-20,100,Current,0,0,0
2023-11-20,100,DPD15-29,1,1,0
2023-11-20,100,DPD3-14,0,0,0
2023-11-20,100,DPD90+,0,0,0
2023-11-20,102,Current,0,0,0
2023-11-20,102,DPD3-14,1,1,0
2023-11-20,102,DPD60-89,0,0,0
2023-11-20,104,Current,0,0,0
2023-11-20,104,DPD3-14,0,0,0
2023-11-20,104,DPD60-89,0,0,0
2023-11-20,104,DPD90+,0,0,0
2023-11-20,20,Current,111,111,0
2023-11-20,20,DPD15-29,0,0,0
2023-11-20,20,DPD3-14,774,774,0
2023-11-20,20,DPD30-59,0,0,0
2023-11-20,20,DPD60-89,0,0,0
2023-11-20,20,DPD90+,0,0,0
2023-11-20,22,Current,0,0,0
2023-11-20,22,DPD15-29,2,2,0
2023-11-20,22,DPD3-14,0,0,0
2023-11-20,22,DPD30-59,1,1,0
2023-11-20,22,DPD60-89,0,0,0
2023-11-20,22,DPD90+,0,0,0
2023-11-20,24,Current,71,71,0
2023-11-20,24,DPD15-29,101,101,0
2023-11-20,24,DPD3-14,251,251,0
2023-11-20,24,DPD30-59,71,71,0
2023-11-20,24,DPD60-89,0,0,0
2023-11-20,24,DPD90+,0,0,0
2023-11-20,26,Current,0,0,0
2023-11-20,26,DPD15-29,16,16,0
2023-11-20,26,DPD3-14,49,49,0
2023-11-20,26,DPD30-59,21,21,0
2023-11-20,26,DPD60-89,0,0,0
2023-11-20,26,DPD90+,0,0,0
2023-11-20,32,Current,1,1,0
2023-11-20,32,DPD15-29,166,166,0
2023-11-20,32,DPD3-14,224,224,0
2023-11-20,32,DPD30-59,131,131,0
2023-11-20,32,DPD60-89,0,0,0
2023-11-20,32,DPD90+,0,0,0
2023-11-20,34,Current,0,0,0
2023-11-20,34,DPD15-29,70,70,0
2023-11-20,34,DPD3-14,103,103,0
2023-11-20,34,DPD30-59,46,46,0
2023-11-20,34,DPD60-89,0,0,0
2023-11-20,34,DPD90+,0,0,0
2023-11-20,36,Current,0,0,0
2023-11-20,36,DPD15-29,35,35,0
2023-11-20,36,DPD3-14,71,71,0
2023-11-20,36,DPD30-59,27,27,0
2023-11-20,36,DPD60-89,0,0,0
2023-11-20,36,DPD90+,0,0,0
2023-11-20,38,Current,0,0,0
2023-11-20,38,DPD15-29,32,32,0
2023-11-20,38,DPD3-14,77,77,0
2023-11-20,38,DPD30-59,16,16,0
2023-11-20,38,DPD60-89,0,0,0
2023-11-20,38,DPD90+,0,0,0
2023-11-20,40,Current,0,0,0
2023-11-20,40,DPD15-29,14,14,0
2023-11-20,40,DPD3-14,41,41,0
2023-11-20,40,DPD30-59,13,13,0
2023-11-20,40,DPD60-89,0,0,0
2023-11-20,40,DPD90+,0,0,0
2023-11-20,42,Current,0,0,0
2023-11-20,42,DPD15-29,13,13,0
2023-11-20,42,DPD3-14,31,31,0
2023-11-20,42,DPD30-59,6,6,0
2023-11-20,42,DPD60-89,0,0,0
2023-11-20,42,DPD90+,0,0,0
2023-11-20,44,Current,0,0,0
2023-11-20,44,DPD15-29,25,25,0
2023-11-20,44,DPD3-14,66,66,0
2023-11-20,44,DPD30-59,15,15,0
2023-11-20,44,DPD60-89,0,0,0
2023-11-20,44,DPD90+,0,0,0
2023-11-20,46,Current,0,0,0
2023-11-20,46,DPD15-29,1,1,0
2023-11-20,46,DPD30-59,0,0,0
2023-11-20,46,DPD60-89,0,0,0
2023-11-20,48,Current,61,61,0
2023-11-20,48,DPD15-29,16,16,0
2023-11-20,48,DPD3-14,26,26,0
2023-11-20,48,DPD30-59,8,8,0
2023-11-20,48,DPD60-89,0,0,0
2023-11-20,48,DPD90+,0,0,0
2023-11-20,6,Current,0,0,0
2023-11-20,6,DPD60-89,0,0,0
2023-11-20,6,DPD90+,0,0,0
2023-11-19,100,Current,0,0,0
2023-11-19,100,DPD15-29,0,0,0
2023-11-19,100,DPD90+,0,0,0
2023-11-19,102,Current,0,0,0
2023-11-19,102,DPD3-14,0,0,0
2023-11-19,102,DPD60-89,0,0,0
2023-11-19,104,Current,0,0,0
2023-11-19,104,DPD3-14,0,0,0
2023-11-19,104,DPD60-89,0,0,0
2023-11-19,104,DPD90+,0,0,0
2023-11-19,20,Current,196,196,0
2023-11-19,20,DPD15-29,0,0,0
2023-11-19,20,DPD3-14,99,99,0
2023-11-19,20,DPD30-59,0,0,0
2023-11-19,20,DPD60-89,0,0,0
2023-11-19,20,DPD90+,0,0,0
2023-11-19,22,Current,0,0,0
2023-11-19,22,DPD15-29,0,0,0
2023-11-19,22,DPD3-14,1,1,0
2023-11-19,22,DPD30-59,0,0,0
2023-11-19,22,DPD60-89,0,0,0
2023-11-19,22,DPD90+,0,0,0
2023-11-19,24,Current,108,108,0
2023-11-19,24,DPD15-29,120,120,0
2023-11-19,24,DPD3-14,154,154,0
2023-11-19,24,DPD30-59,149,149,0
2023-11-19,24,DPD60-89,1,1,0
2023-11-19,24,DPD90+,0,0,0
2023-11-19,26,Current,0,0,0
2023-11-19,26,DPD15-29,20,20,0
2023-11-19,26,DPD3-14,31,31,0
2023-11-19,26,DPD30-59,21,21,0
2023-11-19,26,DPD60-89,0,0,0
2023-11-19,26,DPD90+,0,0,0
2023-11-19,32,Current,0,0,0
2023-11-19,32,DPD15-29,80,80,0
2023-11-19,32,DPD3-14,141,141,0
2023-11-19,32,DPD30-59,114,114,0
2023-11-19,32,DPD60-89,0,0,0
2023-11-19,32,DPD90+,0,0,0
2023-11-19,34,Current,0,0,0
2023-11-19,34,DPD15-29,28,28,0
2023-11-19,34,DPD3-14,63,63,0
2023-11-19,34,DPD30-59,61,61,0
2023-11-19,34,DPD60-89,0,0,0
2023-11-19,34,DPD90+,0,0,0
2023-11-19,36,Current,1,1,0
2023-11-19,36,DPD15-29,35,35,0
2023-11-19,36,DPD3-14,59,59,0
2023-11-19,36,DPD30-59,36,36,0
2023-11-19,36,DPD60-89,0,0,0
2023-11-19,36,DPD90+,0,0,0
2023-11-19,38,Current,0,0,0
2023-11-19,38,DPD15-29,31,31,0
2023-11-19,38,DPD3-14,48,48,0
2023-11-19,38,DPD30-59,36,36,0
2023-11-19,38,DPD60-89,0,0,0
2023-11-19,38,DPD90+,0,0,0
2023-11-19,40,Current,1,1,0
2023-11-19,40,DPD15-29,14,14,0
2023-11-19,40,DPD3-14,26,26,0
2023-11-19,40,DPD30-59,15,15,0
2023-11-19,40,DPD60-89,0,0,0
2023-11-19,40,DPD90+,0,0,0
2023-11-19,42,Current,0,0,0
2023-11-19,42,DPD15-29,9,9,0
2023-11-19,42,DPD3-14,15,15,0
2023-11-19,42,DPD30-59,18,18,0
2023-11-19,42,DPD60-89,0,0,0
2023-11-19,42,DPD90+,0,0,0
2023-11-19,44,Current,0,0,0
2023-11-19,44,DPD15-29,30,30,0
2023-11-19,44,DPD3-14,43,43,0
2023-11-19,44,DPD30-59,33,33,0
2023-11-19,44,DPD60-89,0,0,0
2023-11-19,44,DPD90+,0,0,0
2023-11-19,46,Current,0,0,0
2023-11-19,46,DPD15-29,0,0,0
2023-11-19,46,DPD30-59,0,0,0
2023-11-19,46,DPD60-89,0,0,0
2023-11-19,48,Current,133,133,0
2023-11-19,48,DPD15-29,7,7,0
2023-11-19,48,DPD3-14,24,24,0
2023-11-19,48,DPD30-59,11,11,0
2023-11-19,48,DPD60-89,0,0,0
2023-11-19,48,DPD90+,0,0,0
2023-11-19,6,Current,0,0,0
2023-11-19,6,DPD60-89,0,0,0
2023-11-19,6,DPD90+,0,0,0
2023-11-18,100,Current,0,0,0
2023-11-18,100,DPD15-29,0,0,0
2023-11-18,100,DPD90+,0,0,0
2023-11-18,102,Current,0,0,0
2023-11-18,102,DPD3-14,0,0,0
2023-11-18,102,DPD60-89,0,0,0
2023-11-18,104,Current,0,0,0
2023-11-18,104,DPD3-14,0,0,0
2023-11-18,104,DPD60-89,0,0,0
2023-11-18,104,DPD90+,0,0,0
2023-11-18,20,Current,112,112,0
2023-11-18,20,DPD15-29,0,0,0
2023-11-18,20,DPD3-14,546,546,0
2023-11-18,20,DPD30-59,0,0,0
2023-11-18,20,DPD60-89,0,0,0
2023-11-18,20,DPD90+,0,0,0
2023-11-18,22,Current,0,0,0
2023-11-18,22,DPD15-29,2,2,0
2023-11-18,22,DPD3-14,1,1,0
2023-11-18,22,DPD30-59,1,1,0
2023-11-18,22,DPD60-89,0,0,0
2023-11-18,22,DPD90+,0,0,0
2023-11-18,24,Current,70,70,0
2023-11-18,24,DPD15-29,89,89,0
2023-11-18,24,DPD3-14,154,154,0
2023-11-18,24,DPD30-59,63,63,0
2023-11-18,24,DPD60-89,0,0,0
2023-11-18,24,DPD90+,0,0,0
2023-11-18,26,Current,0,0,0
2023-11-18,26,DPD15-29,15,15,0
2023-11-18,26,DPD3-14,26,26,0
2023-11-18,26,DPD30-59,17,17,0
2023-11-18,26,DPD60-89,0,0,0
2023-11-18,26,DPD90+,0,0,0
2023-11-18,32,Current,3,3,0
2023-11-18,32,DPD15-29,173,173,0
2023-11-18,32,DPD3-14,116,116,0
2023-11-18,32,DPD30-59,116,116,0
2023-11-18,32,DPD60-89,0,0,0
2023-11-18,32,DPD90+,0,0,0
2023-11-18,34,Current,1,1,0
2023-11-18,34,DPD15-29,74,74,0
2023-11-18,34,DPD3-14,46,46,0
2023-11-18,34,DPD30-59,48,48,0
2023-11-18,34,DPD60-89,0,0,0
2023-11-18,34,DPD90+,0,0,0
2023-11-18,36,Current,1,1,0
2023-11-18,36,DPD15-29,31,31,0
2023-11-18,36,DPD3-14,38,38,0
2023-11-18,36,DPD30-59,24,24,0
2023-11-18,36,DPD60-89,0,0,0
2023-11-18,36,DPD90+,0,0,0
2023-11-18,38,Current,1,1,0
2023-11-18,38,DPD15-29,30,30,0
2023-11-18,38,DPD3-14,39,39,0
2023-11-18,38,DPD30-59,17,17,0
2023-11-18,38,DPD60-89,0,0,0
2023-11-18,38,DPD90+,0,0,0
2023-11-18,40,Current,0,0,0
2023-11-18,40,DPD15-29,15,15,0
2023-11-18,40,DPD3-14,13,13,0
2023-11-18,40,DPD30-59,10,10,0
2023-11-18,40,DPD60-89,0,0,0
2023-11-18,40,DPD90+,0,0,0
2023-11-18,42,Current,0,0,0
2023-11-18,42,DPD15-29,11,11,0
2023-11-18,42,DPD3-14,12,12,0
2023-11-18,42,DPD30-59,7,7,0
2023-11-18,42,DPD60-89,0,0,0
2023-11-18,42,DPD90+,0,0,0
2023-11-18,44,Current,0,0,0
2023-11-18,44,DPD15-29,23,23,0
2023-11-18,44,DPD3-14,33,33,0
2023-11-18,44,DPD30-59,16,16,0
2023-11-18,44,DPD60-89,0,0,0
2023-11-18,44,DPD90+,0,0,0
2023-11-18,46,Current,0,0,0
2023-11-18,46,DPD15-29,1,1,0
2023-11-18,46,DPD30-59,0,0,0
2023-11-18,46,DPD60-89,0,0,0
2023-11-18,48,Current,74,74,0
2023-11-18,48,DPD15-29,7,7,0
2023-11-18,48,DPD3-14,25,25,0
2023-11-18,48,DPD30-59,8,8,0
2023-11-18,48,DPD60-89,0,0,0
2023-11-18,48,DPD90+,0,0,0
2023-11-18,6,Current,0,0,0
2023-11-18,6,DPD60-89,0,0,0
2023-11-18,6,DPD90+,0,0,0
2023-11-17,100,Current,0,0,0
2023-11-17,100,DPD3-14,0,0,0
2023-11-17,100,DPD90+,0,0,0
2023-11-17,102,Current,0,0,0
2023-11-17,102,DPD3-14,0,0,0
2023-11-17,102,DPD60-89,0,0,0
2023-11-17,104,Current,0,0,0
2023-11-17,104,DPD3-14,0,0,0
2023-11-17,104,DPD60-89,0,0,0
2023-11-17,104,DPD90+,0,0,0
2023-11-17,20,Current,557,557,0
2023-11-17,20,DPD15-29,0,0,0
2023-11-17,20,DPD3-14,2,2,0
2023-11-17,20,DPD30-59,1,1,0
2023-11-17,20,DPD60-89,0,0,0
2023-11-17,20,DPD90+,0,0,0
2023-11-17,22,Current,0,0,0
2023-11-17,22,DPD15-29,1,1,0
2023-11-17,22,DPD3-14,1,1,0
2023-11-17,22,DPD30-59,0,0,0
2023-11-17,22,DPD60-89,0,0,0
2023-11-17,22,DPD90+,0,0,0
2023-11-17,24,Current,420,420,0
2023-11-17,24,DPD15-29,110,110,0
2023-11-17,24,DPD3-14,177,177,0
2023-11-17,24,DPD30-59,145,145,0
2023-11-17,24,DPD60-89,0,0,0
2023-11-17,24,DPD90+,0,0,0
2023-11-17,26,Current,28,28,0
2023-11-17,26,DPD15-29,23,23,0
2023-11-17,26,DPD3-14,35,35,0
2023-11-17,26,DPD30-59,20,20,0
2023-11-17,26,DPD60-89,0,0,0
2023-11-17,26,DPD90+,0,0,0
2023-11-17,32,Current,183,183,0
2023-11-17,32,DPD15-29,81,81,0
2023-11-17,32,DPD3-14,125,125,0
2023-11-17,32,DPD30-59,125,125,0
2023-11-17,32,DPD60-89,0,0,0
2023-11-17,32,DPD90+,0,0,0
2023-11-17,34,Current,67,67,0
2023-11-17,34,DPD15-29,36,36,0
2023-11-17,34,DPD3-14,65,65,0
2023-11-17,34,DPD30-59,68,68,0
2023-11-17,34,DPD60-89,0,0,0
2023-11-17,34,DPD90+,0,0,0
2023-11-17,36,Current,67,67,0
2023-11-17,36,DPD15-29,31,31,0
2023-11-17,36,DPD3-14,56,56,0
2023-11-17,36,DPD30-59,38,38,0
2023-11-17,36,DPD60-89,0,0,0
2023-11-17,36,DPD90+,0,0,0
2023-11-17,38,Current,68,68,0
2023-11-17,38,DPD15-29,30,30,0
2023-11-17,38,DPD3-14,45,45,0
2023-11-17,38,DPD30-59,36,36,0
2023-11-17,38,DPD60-89,0,0,0
2023-11-17,38,DPD90+,0,0,0
2023-11-17,40,Current,59,59,0
2023-11-17,40,DPD15-29,14,14,0
2023-11-17,40,DPD3-14,29,29,0
2023-11-17,40,DPD30-59,14,14,0
2023-11-17,40,DPD60-89,1,1,0
2023-11-17,40,DPD90+,1,1,0
2023-11-17,42,Current,16,16,0
2023-11-17,42,DPD15-29,10,10,0
2023-11-17,42,DPD3-14,17,17,0
2023-11-17,42,DPD30-59,17,17,0
2023-11-17,42,DPD60-89,0,0,0
2023-11-17,42,DPD90+,0,0,0
2023-11-17,44,Current,69,69,0
2023-11-17,44,DPD15-29,25,25,0
2023-11-17,44,DPD3-14,46,46,0
2023-11-17,44,DPD30-59,36,36,0
2023-11-17,44,DPD60-89,0,0,0
2023-11-17,44,DPD90+,0,0,0
2023-11-17,46,Current,0,0,0
2023-11-17,46,DPD15-29,0,0,0
2023-11-17,46,DPD30-59,0,0,0
2023-11-17,46,DPD60-89,0,0,0
2023-11-17,48,Current,168,168,0
2023-11-17,48,DPD15-29,5,5,0
2023-11-17,48,DPD3-14,17,17,0
2023-11-17,48,DPD30-59,7,7,0
2023-11-17,48,DPD60-89,0,0,0
2023-11-17,48,DPD90+,0,0,0
2023-11-17,6,Current,0,0,0
2023-11-17,6,DPD60-89,0,0,0
2023-11-17,6,DPD90+,0,0,0
2023-11-16,100,Current,0,0,0
2023-11-16,100,DPD3-14,1,1,0
2023-11-16,100,DPD90+,0,0,0
2023-11-16,102,Current,0,0,0
2023-11-16,102,DPD3-14,0,0,0
2023-11-16,102,DPD60-89,0,0,0
2023-11-16,104,Current,0,0,0
2023-11-16,104,DPD3-14,1,1,0
2023-11-16,104,DPD30-59,1,1,0
2023-11-16,104,DPD60-89,0,0,0
2023-11-16,104,DPD90+,0,0,0
2023-11-16,20,Current,118,118,0
2023-11-16,20,DPD15-29,0,0,0
2023-11-16,20,DPD3-14,1,1,0
2023-11-16,20,DPD30-59,0,0,0
2023-11-16,20,DPD60-89,0,0,0
2023-11-16,20,DPD90+,0,0,0
2023-11-16,22,Current,0,0,0
2023-11-16,22,DPD15-29,2,2,0
2023-11-16,22,DPD3-14,0,0,0
2023-11-16,22,DPD30-59,1,1,0
2023-11-16,22,DPD60-89,0,0,0
2023-11-16,22,DPD90+,0,0,0
2023-11-16,24,Current,100,100,0
2023-11-16,24,DPD15-29,86,86,0
2023-11-16,24,DPD3-14,173,173,0
2023-11-16,24,DPD30-59,62,62,0
2023-11-16,24,DPD60-89,0,0,0
2023-11-16,24,DPD90+,1,1,0
2023-11-16,26,Current,3,3,0
2023-11-16,26,DPD15-29,15,15,0
2023-11-16,26,DPD3-14,24,24,0
2023-11-16,26,DPD30-59,15,15,0
2023-11-16,26,DPD60-89,0,0,0
2023-11-16,26,DPD90+,0,0,0
2023-11-16,32,Current,24,24,0
2023-11-16,32,DPD15-29,175,175,0
2023-11-16,32,DPD3-14,147,147,0
2023-11-16,32,DPD30-59,109,109,0
2023-11-16,32,DPD60-89,0,0,0
2023-11-16,32,DPD90+,0,0,0
2023-11-16,34,Current,10,10,0
2023-11-16,34,DPD15-29,74,74,0
2023-11-16,34,DPD3-14,60,60,0
2023-11-16,34,DPD30-59,48,48,0
2023-11-16,34,DPD60-89,0,0,0
2023-11-16,34,DPD90+,0,0,0
2023-11-16,36,Current,11,11,0
2023-11-16,36,DPD15-29,32,32,0
2023-11-16,36,DPD3-14,40,40,0
2023-11-16,36,DPD30-59,25,25,0
2023-11-16,36,DPD60-89,0,0,0
2023-11-16,36,DPD90+,0,0,0
2023-11-16,38,Current,8,8,0
2023-11-16,38,DPD15-29,26,26,0
2023-11-16,38,DPD3-14,42,42,0
2023-11-16,38,DPD30-59,20,20,0
2023-11-16,38,DPD60-89,0,0,0
2023-11-16,38,DPD90+,0,0,0
2023-11-16,40,Current,14,14,0
2023-11-16,40,DPD15-29,17,17,0
2023-11-16,40,DPD3-14,17,17,0
2023-11-16,40,DPD30-59,9,9,0
2023-11-16,40,DPD60-89,0,0,0
2023-11-16,40,DPD90+,0,0,0
2023-11-16,42,Current,5,5,0
2023-11-16,42,DPD15-29,9,9,0
2023-11-16,42,DPD3-14,14,14,0
2023-11-16,42,DPD30-59,5,5,0
2023-11-16,42,DPD60-89,0,0,0
2023-11-16,42,DPD90+,0,0,0
2023-11-16,44,Current,10,10,0
2023-11-16,44,DPD15-29,24,24,0
2023-11-16,44,DPD3-14,37,37,0
2023-11-16,44,DPD30-59,13,13,0
2023-11-16,44,DPD60-89,0,0,0
2023-11-16,44,DPD90+,0,0,0
2023-11-16,46,Current,0,0,0
2023-11-16,46,DPD15-29,0,0,0
2023-11-16,46,DPD30-59,0,0,0
2023-11-16,46,DPD60-89,0,0,0
2023-11-16,48,Current,83,83,0
2023-11-16,48,DPD15-29,7,7,0
2023-11-16,48,DPD3-14,22,22,0
2023-11-16,48,DPD30-59,9,9,0
2023-11-16,48,DPD60-89,0,0,0
2023-11-16,48,DPD90+,0,0,0
2023-11-16,6,Current,0,0,0
2023-11-16,6,DPD60-89,0,0,0
2023-11-16,6,DPD90+,0,0,0
2023-11-15,100,Current,0,0,0
2023-11-15,100,DPD3-14,0,0,0
2023-11-15,100,DPD90+,0,0,0
2023-11-15,102,Current,0,0,0
2023-11-15,102,DPD3-14,0,0,0
2023-11-15,102,DPD60-89,0,0,0
2023-11-15,104,Current,0,0,0
2023-11-15,104,DPD3-14,0,0,0
2023-11-15,104,DPD30-59,0,0,0
2023-11-15,104,DPD60-89,0,0,0
2023-11-15,104,DPD90+,0,0,0
2023-11-15,20,Current,73,73,0
2023-11-15,20,DPD15-29,0,0,0
2023-11-15,20,DPD3-14,0,0,0
2023-11-15,20,DPD30-59,0,0,0
2023-11-15,20,DPD60-89,0,0,0
2023-11-15,20,DPD90+,0,0,0
2023-11-15,22,Current,0,0,0
2023-11-15,22,DPD15-29,1,1,0
2023-11-15,22,DPD3-14,1,1,0
2023-11-15,22,DPD30-59,0,0,0
2023-11-15,22,DPD60-89,0,0,0
2023-11-15,22,DPD90+,0,0,0
2023-11-15,24,Current,99,99,0
2023-11-15,24,DPD15-29,151,151,0
2023-11-15,24,DPD3-14,171,171,0
2023-11-15,24,DPD30-59,145,145,0
2023-11-15,24,DPD60-89,0,0,0
2023-11-15,24,DPD90+,0,0,0
2023-11-15,26,Current,8,8,0
2023-11-15,26,DPD15-29,32,32,0
2023-11-15,26,DPD3-14,29,29,0
2023-11-15,26,DPD30-59,23,23,0
2023-11-15,26,DPD60-89,0,0,0
2023-11-15,26,DPD90+,0,0,0
2023-11-15,32,Current,23,23,0
2023-11-15,32,DPD15-29,104,104,0
2023-11-15,32,DPD3-14,110,110,0
2023-11-15,32,DPD30-59,122,122,0
2023-11-15,32,DPD60-89,0,0,0
2023-11-15,32,DPD90+,0,0,0
2023-11-15,34,Current,10,10,0
2023-11-15,34,DPD15-29,52,52,0
2023-11-15,34,DPD3-14,57,57,0
2023-11-15,34,DPD30-59,77,77,0
2023-11-15,34,DPD60-89,0,0,0
2023-11-15,34,DPD90+,0,0,0
2023-11-15,36,Current,6,6,0
2023-11-15,36,DPD15-29,35,35,0
2023-11-15,36,DPD3-14,58,58,0
2023-11-15,36,DPD30-59,43,43,0
2023-11-15,36,DPD60-89,0,0,0
2023-11-15,36,DPD90+,0,0,0
2023-11-15,38,Current,15,15,0
2023-11-15,38,DPD15-29,37,37,0
2023-11-15,38,DPD3-14,45,45,0
2023-11-15,38,DPD30-59,35,35,0
2023-11-15,38,DPD60-89,0,0,0
2023-11-15,38,DPD90+,0,0,0
2023-11-15,40,Current,11,11,0
2023-11-15,40,DPD15-29,18,18,0
2023-11-15,40,DPD3-14,26,26,0
2023-11-15,40,DPD30-59,16,16,0
2023-11-15,40,DPD60-89,0,0,0
2023-11-15,40,DPD90+,0,0,0
2023-11-15,42,Current,6,6,0
2023-11-15,42,DPD15-29,14,14,0
2023-11-15,42,DPD3-14,16,16,0
2023-11-15,42,DPD30-59,21,21,0
2023-11-15,42,DPD60-89,0,0,0
2023-11-15,42,DPD90+,0,0,0
2023-11-15,44,Current,9,9,0
2023-11-15,44,DPD15-29,32,32,0
2023-11-15,44,DPD3-14,50,50,0
2023-11-15,44,DPD30-59,36,36,0
2023-11-15,44,DPD60-89,0,0,0
2023-11-15,44,DPD90+,0,0,0
2023-11-15,46,Current,0,0,0
2023-11-15,46,DPD3-14,0,0,0
2023-11-15,46,DPD30-59,0,0,0
2023-11-15,46,DPD60-89,0,0,0
2023-11-15,48,Current,53,53,0
2023-11-15,48,DPD15-29,10,10,0
2023-11-15,48,DPD3-14,15,15,0
2023-11-15,48,DPD30-59,10,10,0
2023-11-15,48,DPD60-89,0,0,0
2023-11-15,48,DPD90+,0,0,0
2023-11-15,6,Current,0,0,0
2023-11-15,6,DPD60-89,0,0,0
2023-11-15,6,DPD90+,0,0,0
2023-11-14,100,Current,0,0,0
2023-11-14,100,DPD3-14,1,1,0
2023-11-14,100,DPD90+,0,0,0
2023-11-14,102,Current,0,0,0
2023-11-14,102,DPD3-14,1,1,0
2023-11-14,102,DPD60-89,0,0,0
2023-11-14,104,Current,0,0,0
2023-11-14,104,DPD3-14,0,0,0
2023-11-14,104,DPD30-59,1,1,0
2023-11-14,104,DPD60-89,0,0,0
2023-11-14,104,DPD90+,0,0,0
2023-11-14,20,Current,77,77,0
2023-11-14,20,DPD15-29,0,0,0
2023-11-14,20,DPD3-14,1,1,0
2023-11-14,20,DPD30-59,0,0,0
2023-11-14,20,DPD60-89,0,0,0
2023-11-14,20,DPD90+,0,0,0
2023-11-14,22,Current,1,1,0
2023-11-14,22,DPD15-29,2,2,0
2023-11-14,22,DPD3-14,0,0,0
2023-11-14,22,DPD30-59,1,1,0
2023-11-14,22,DPD60-89,0,0,0
2023-11-14,22,DPD90+,0,0,0
2023-11-14,24,Current,73,73,0
2023-11-14,24,DPD15-29,109,109,0
2023-11-14,24,DPD3-14,169,169,0
2023-11-14,24,DPD30-59,56,56,0
2023-11-14,24,DPD60-89,0,0,0
2023-11-14,24,DPD90+,0,0,0
2023-11-14,26,Current,3,3,0
2023-11-14,26,DPD15-29,18,18,0
2023-11-14,26,DPD3-14,22,22,0
2023-11-14,26,DPD30-59,14,14,0
2023-11-14,26,DPD60-89,0,0,0
2023-11-14,26,DPD90+,0,0,0
2023-11-14,32,Current,35,35,0
2023-11-14,32,DPD15-29,208,208,0
2023-11-14,32,DPD3-14,143,143,0
2023-11-14,32,DPD30-59,119,119,0
2023-11-14,32,DPD60-89,0,0,0
2023-11-14,32,DPD90+,0,0,0
2023-11-14,34,Current,8,8,0
2023-11-14,34,DPD15-29,100,100,0
2023-11-14,34,DPD3-14,57,57,0
2023-11-14,34,DPD30-59,53,53,0
2023-11-14,34,DPD60-89,0,0,0
2023-11-14,34,DPD90+,0,0,0
2023-11-14,36,Current,9,9,0
2023-11-14,36,DPD15-29,41,41,0
2023-11-14,36,DPD3-14,44,44,0
2023-11-14,36,DPD30-59,26,26,0
2023-11-14,36,DPD60-89,0,0,0
2023-11-14,36,DPD90+,0,0,0
2023-11-14,38,Current,9,9,0
2023-11-14,38,DPD15-29,29,29,0
2023-11-14,38,DPD3-14,40,40,0
2023-11-14,38,DPD30-59,16,16,0
2023-11-14,38,DPD60-89,0,0,0
2023-11-14,38,DPD90+,0,0,0
2023-11-14,40,Current,9,9,0
2023-11-14,40,DPD15-29,25,25,0
2023-11-14,40,DPD3-14,19,19,0
2023-11-14,40,DPD30-59,9,9,0
2023-11-14,40,DPD60-89,0,0,0
2023-11-14,40,DPD90+,0,0,0
2023-11-14,42,Current,5,5,0
2023-11-14,42,DPD15-29,11,11,0
2023-11-14,42,DPD3-14,13,13,0
2023-11-14,42,DPD30-59,6,6,0
2023-11-14,42,DPD60-89,0,0,0
2023-11-14,42,DPD90+,0,0,0
2023-11-14,44,Current,7,7,0
2023-11-14,44,DPD15-29,32,32,0
2023-11-14,44,DPD3-14,46,46,0
2023-11-14,44,DPD30-59,13,13,0
2023-11-14,44,DPD60-89,0,0,0
2023-11-14,44,DPD90+,0,0,0
2023-11-14,46,Current,0,0,0
2023-11-14,46,DPD3-14,1,1,0
2023-11-14,46,DPD30-59,0,0,0
2023-11-14,46,DPD60-89,0,0,0
2023-11-14,48,Current,44,44,0
2023-11-14,48,DPD15-29,7,7,0
2023-11-14,48,DPD3-14,21,21,0
2023-11-14,48,DPD30-59,7,7,0
2023-11-14,48,DPD60-89,0,0,0
2023-11-14,48,DPD90+,0,0,0
2023-11-14,6,Current,0,0,0
2023-11-14,6,DPD60-89,0,0,0
2023-11-14,6,DPD90+,0,0,0
2023-11-13,100,Current,0,0,0
2023-11-13,100,DPD3-14,0,0,0
2023-11-13,100,DPD90+,0,0,0
2023-11-13,102,Current,0,0,0
2023-11-13,102,DPD3-14,0,0,0
2023-11-13,102,DPD60-89,0,0,0
2023-11-13,104,Current,0,0,0
2023-11-13,104,DPD15-29,0,0,0
2023-11-13,104,DPD30-59,0,0,0
2023-11-13,104,DPD60-89,0,0,0
2023-11-13,104,DPD90+,0,0,0
2023-11-13,20,Current,112,112,0
2023-11-13,20,DPD15-29,0,0,0
2023-11-13,20,DPD3-14,0,0,0
2023-11-13,20,DPD30-59,0,0,0
2023-11-13,20,DPD60-89,0,0,0
2023-11-13,20,DPD90+,0,0,0
2023-11-13,22,Current,0,0,0
2023-11-13,22,DPD15-29,1,1,0
2023-11-13,22,DPD3-14,1,1,0
2023-11-13,22,DPD30-59,0,0,0
2023-11-13,22,DPD60-89,0,0,0
2023-11-13,22,DPD90+,0,0,0
2023-11-13,24,Current,68,68,0
2023-11-13,24,DPD15-29,168,168,0
2023-11-13,24,DPD3-14,164,164,0
2023-11-13,24,DPD30-59,145,145,0
2023-11-13,24,DPD60-89,0,0,0
2023-11-13,24,DPD90+,0,0,0
2023-11-13,26,Current,2,2,0
2023-11-13,26,DPD15-29,37,37,0
2023-11-13,26,DPD3-14,31,31,0
2023-11-13,26,DPD30-59,23,23,0
2023-11-13,26,DPD60-89,0,0,0
2023-11-13,26,DPD90+,0,0,0
2023-11-13,32,Current,1,1,0
2023-11-13,32,DPD15-29,111,111,0
2023-11-13,32,DPD3-14,120,120,0
2023-11-13,32,DPD30-59,122,122,0
2023-11-13,32,DPD60-89,0,0,0
2023-11-13,32,DPD90+,0,0,0
2023-11-13,34,Current,0,0,0
2023-11-13,34,DPD15-29,50,50,0
2023-11-13,34,DPD3-14,51,51,0
2023-11-13,34,DPD30-59,76,76,0
2023-11-13,34,DPD60-89,0,0,0
2023-11-13,34,DPD90+,0,0,0
2023-11-13,36,Current,2,2,0
2023-11-13,36,DPD15-29,33,33,0
2023-11-13,36,DPD3-14,53,53,0
2023-11-13,36,DPD30-59,44,44,0
2023-11-13,36,DPD60-89,0,0,0
2023-11-13,36,DPD90+,0,0,0
2023-11-13,38,Current,1,1,0
2023-11-13,38,DPD15-29,49,49,0
2023-11-13,38,DPD3-14,47,47,0
2023-11-13,38,DPD30-59,42,42,0
2023-11-13,38,DPD60-89,0,0,0
2023-11-13,38,DPD90+,0,0,0
2023-11-13,40,Current,6,6,0
2023-11-13,40,DPD15-29,22,22,0
2023-11-13,40,DPD3-14,35,35,0
2023-11-13,40,DPD30-59,17,17,0
2023-11-13,40,DPD60-89,0,0,0
2023-11-13,40,DPD90+,0,0,0
2023-11-13,42,Current,3,3,0
2023-11-13,42,DPD15-29,16,16,0
2023-11-13,42,DPD3-14,17,17,0
2023-11-13,42,DPD30-59,21,21,0
2023-11-13,42,DPD60-89,0,0,0
2023-11-13,42,DPD90+,0,0,0
2023-11-13,44,Current,3,3,0
2023-11-13,44,DPD15-29,33,33,0
2023-11-13,44,DPD3-14,50,50,0
2023-11-13,44,DPD30-59,39,39,0
2023-11-13,44,DPD60-89,0,0,0
2023-11-13,44,DPD90+,0,0,0
2023-11-13,46,Current,0,0,0
2023-11-13,46,DPD15-29,0,0,0
2023-11-13,46,DPD3-14,0,0,0
2023-11-13,46,DPD60-89,0,0,0
2023-11-13,48,Current,61,61,0
2023-11-13,48,DPD15-29,13,13,0
2023-11-13,48,DPD3-14,15,15,0
2023-11-13,48,DPD30-59,9,9,0
2023-11-13,48,DPD60-89,0,0,0
2023-11-13,48,DPD90+,0,0,0
2023-11-13,6,Current,0,0,0
2023-11-13,6,DPD60-89,0,0,0
2023-11-13,6,DPD90+,0,0,0
2023-11-12,100,Current,0,0,0
2023-11-12,100,DPD3-14,1,1,0
2023-11-12,100,DPD90+,0,0,0
2023-11-12,102,Current,0,0,0
2023-11-12,102,DPD3-14,1,1,0
2023-11-12,102,DPD60-89,0,0,0
2023-11-12,104,Current,0,0,0
2023-11-12,104,DPD15-29,0,0,0
2023-11-12,104,DPD30-59,1,1,0
2023-11-12,104,DPD60-89,0,0,0
2023-11-12,20,Current,171,171,0
2023-11-12,20,DPD15-29,0,0,0
2023-11-12,20,DPD3-14,1,1,0
2023-11-12,20,DPD30-59,0,0,0
2023-11-12,20,DPD60-89,0,0,0
2023-11-12,20,DPD90+,0,0,0
2023-11-12,22,Current,0,0,0
2023-11-12,22,DPD15-29,1,1,0
2023-11-12,22,DPD3-14,2,2,0
2023-11-12,22,DPD30-59,1,1,0
2023-11-12,22,DPD60-89,0,0,0
2023-11-12,22,DPD90+,0,0,0
2023-11-12,24,Current,98,98,0
2023-11-12,24,DPD15-29,89,89,0
2023-11-12,24,DPD3-14,179,179,0
2023-11-12,24,DPD30-59,57,57,0
2023-11-12,24,DPD60-89,1,1,0
2023-11-12,24,DPD90+,0,0,0
2023-11-12,26,Current,0,0,0
2023-11-12,26,DPD15-29,18,18,0
2023-11-12,26,DPD3-14,24,24,0
2023-11-12,26,DPD30-59,14,14,0
2023-11-12,26,DPD60-89,0,0,0
2023-11-12,26,DPD90+,0,0,0
2023-11-12,32,Current,0,0,0
2023-11-12,32,DPD15-29,174,174,0
2023-11-12,32,DPD3-14,177,177,0
2023-11-12,32,DPD30-59,112,112,0
2023-11-12,32,DPD60-89,0,0,0
2023-11-12,32,DPD90+,0,0,0
2023-11-12,34,Current,0,0,0
2023-11-12,34,DPD15-29,70,70,0
2023-11-12,34,DPD3-14,89,89,0
2023-11-12,34,DPD30-59,52,52,0
2023-11-12,34,DPD60-89,0,0,0
2023-11-12,34,DPD90+,0,0,0
2023-11-12,36,Current,0,0,0
2023-11-12,36,DPD15-29,36,36,0
2023-11-12,36,DPD3-14,48,48,0
2023-11-12,36,DPD30-59,20,20,0
2023-11-12,36,DPD60-89,0,0,0
2023-11-12,36,DPD90+,0,0,0
2023-11-12,38,Current,0,0,0
2023-11-12,38,DPD15-29,20,20,0
2023-11-12,38,DPD3-14,51,51,0
2023-11-12,38,DPD30-59,17,17,0
2023-11-12,38,DPD60-89,0,0,0
2023-11-12,38,DPD90+,0,0,0
2023-11-12,40,Current,0,0,0
2023-11-12,40,DPD15-29,19,19,0
2023-11-12,40,DPD3-14,25,25,0
2023-11-12,40,DPD30-59,9,9,0
2023-11-12,40,DPD60-89,0,0,0
2023-11-12,40,DPD90+,0,0,0
2023-11-12,42,Current,0,0,0
2023-11-12,42,DPD15-29,8,8,0
2023-11-12,42,DPD3-14,15,15,0
2023-11-12,42,DPD30-59,8,8,0
2023-11-12,42,DPD60-89,0,0,0
2023-11-12,42,DPD90+,0,0,0
2023-11-12,44,Current,0,0,0
2023-11-12,44,DPD15-29,24,24,0
2023-11-12,44,DPD3-14,50,50,0
2023-11-12,44,DPD30-59,11,11,0
2023-11-12,44,DPD60-89,0,0,0
2023-11-12,44,DPD90+,0,0,0
2023-11-12,46,Current,0,0,0
2023-11-12,46,DPD15-29,0,0,0
2023-11-12,46,DPD3-14,1,1,0
2023-11-12,46,DPD60-89,0,0,0
2023-11-12,48,Current,154,154,0
2023-11-12,48,DPD15-29,6,6,0
2023-11-12,48,DPD3-14,24,24,0
2023-11-12,48,DPD30-59,7,7,0
2023-11-12,48,DPD60-89,0,0,0
2023-11-12,48,DPD90+,0,0,0
2023-11-12,6,Current,0,0,0
2023-11-12,6,DPD60-89,0,0,0
2023-11-12,6,DPD90+,0,0,0
2023-11-11,100,Current,0,0,0
2023-11-11,100,DPD3-14,0,0,0
2023-11-11,100,DPD90+,0,0,0
2023-11-11,102,Current,0,0,0
2023-11-11,102,DPD3-14,0,0,0
2023-11-11,102,DPD60-89,0,0,0
2023-11-11,104,Current,0,0,0
2023-11-11,104,DPD3-14,0,0,0
2023-11-11,104,DPD30-59,0,0,0
2023-11-11,104,DPD60-89,0,0,0
2023-11-11,20,Current,59,59,0
2023-11-11,20,DPD15-29,0,0,0
2023-11-11,20,DPD3-14,0,0,0
2023-11-11,20,DPD30-59,0,0,0
2023-11-11,20,DPD60-89,0,0,0
2023-11-11,20,DPD90+,0,0,0
2023-11-11,22,Current,0,0,0
2023-11-11,22,DPD15-29,1,1,0
2023-11-11,22,DPD3-14,1,1,0
2023-11-11,22,DPD30-59,0,0,0
2023-11-11,22,DPD60-89,0,0,0
2023-11-11,22,DPD90+,0,0,0
2023-11-11,24,Current,60,60,0
2023-11-11,24,DPD15-29,160,160,0
2023-11-11,24,DPD3-14,144,144,0
2023-11-11,24,DPD30-59,148,148,0
2023-11-11,24,DPD60-89,0,0,0
2023-11-11,24,DPD90+,0,0,0
2023-11-11,26,Current,4,4,0
2023-11-11,26,DPD15-29,34,34,0
2023-11-11,26,DPD3-14,25,25,0
2023-11-11,26,DPD30-59,22,22,0
2023-11-11,26,DPD60-89,0,0,0
2023-11-11,26,DPD90+,0,0,0
2023-11-11,32,Current,18,18,0
2023-11-11,32,DPD15-29,103,103,0
2023-11-11,32,DPD3-14,87,87,0
2023-11-11,32,DPD30-59,129,129,0
2023-11-11,32,DPD60-89,0,0,0
2023-11-11,32,DPD90+,0,0,0
2023-11-11,34,Current,5,5,0
2023-11-11,34,DPD15-29,38,38,0
2023-11-11,34,DPD3-14,49,49,0
2023-11-11,34,DPD30-59,71,71,0
2023-11-11,34,DPD60-89,0,0,0
2023-11-11,34,DPD90+,0,0,0
2023-11-11,36,Current,10,10,0
2023-11-11,36,DPD15-29,28,28,0
2023-11-11,36,DPD3-14,48,48,0
2023-11-11,36,DPD30-59,46,46,0
2023-11-11,36,DPD60-89,0,0,0
2023-11-11,36,DPD90+,0,0,0
2023-11-11,38,Current,11,11,0
2023-11-11,38,DPD15-29,42,42,0
2023-11-11,38,DPD3-14,32,32,0
2023-11-11,38,DPD30-59,41,41,0
2023-11-11,38,DPD60-89,0,0,0
2023-11-11,38,DPD90+,0,0,0
2023-11-11,40,Current,4,4,0
2023-11-11,40,DPD15-29,16,16,0
2023-11-11,40,DPD3-14,31,31,0
2023-11-11,40,DPD30-59,19,19,0
2023-11-11,40,DPD60-89,0,0,0
2023-11-11,40,DPD90+,0,0,0
2023-11-11,42,Current,5,5,0
2023-11-11,42,DPD15-29,15,15,0
2023-11-11,42,DPD3-14,14,14,0
2023-11-11,42,DPD30-59,19,19,0
2023-11-11,42,DPD60-89,0,0,0
2023-11-11,42,DPD90+,0,0,0
2023-11-11,44,Current,6,6,0
2023-11-11,44,DPD15-29,34,34,0
2023-11-11,44,DPD3-14,34,34,0
2023-11-11,44,DPD30-59,35,35,0
2023-11-11,44,DPD60-89,0,0,0
2023-11-11,44,DPD90+,0,0,0
2023-11-11,46,Current,0,0,0
2023-11-11,46,DPD15-29,0,0,0
2023-11-11,46,DPD3-14,0,0,0
2023-11-11,46,DPD60-89,0,0,0
2023-11-11,48,Current,45,45,0
2023-11-11,48,DPD15-29,11,11,0
2023-11-11,48,DPD3-14,11,11,0
2023-11-11,48,DPD30-59,12,12,0
2023-11-11,48,DPD60-89,0,0,0
2023-11-11,48,DPD90+,0,0,0
2023-11-11,6,Current,0,0,0
2023-11-11,6,DPD60-89,0,0,0
2023-11-11,6,DPD90+,0,0,0
2023-11-10,100,Current,1,1,0
2023-11-10,100,DPD3-14,1,1,0
2023-11-10,100,DPD90+,0,0,0
2023-11-10,102,Current,0,0,0
2023-11-10,102,DPD3-14,0,0,0
2023-11-10,102,DPD60-89,0,0,0
2023-11-10,104,Current,1,1,0
2023-11-10,104,DPD3-14,0,0,0
2023-11-10,104,DPD30-59,1,1,0
2023-11-10,104,DPD60-89,0,0,0
2023-11-10,20,Current,573,573,0
2023-11-10,20,DPD15-29,0,0,0
2023-11-10,20,DPD3-14,1,1,0
2023-11-10,20,DPD30-59,0,0,0
2023-11-10,20,DPD60-89,0,0,0
2023-11-10,20,DPD90+,0,0,0
2023-11-10,22,Current,0,0,0
2023-11-10,22,DPD15-29,1,1,0
2023-11-10,22,DPD3-14,2,2,0
2023-11-10,22,DPD30-59,1,1,0
2023-11-10,22,DPD60-89,0,0,0
2023-11-10,22,DPD90+,0,0,0
2023-11-10,24,Current,384,384,0
2023-11-10,24,DPD15-29,96,96,0
2023-11-10,24,DPD3-14,178,178,0
2023-11-10,24,DPD30-59,56,56,0
2023-11-10,24,DPD60-89,0,0,0
2023-11-10,24,DPD90+,0,0,0
2023-11-10,26,Current,46,46,0
2023-11-10,26,DPD15-29,15,15,0
2023-11-10,26,DPD3-14,23,23,0
2023-11-10,26,DPD30-59,16,16,0
2023-11-10,26,DPD60-89,0,0,0
2023-11-10,26,DPD90+,0,0,0
2023-11-10,32,Current,185,185,0
2023-11-10,32,DPD15-29,175,175,0
2023-11-10,32,DPD3-14,195,195,0
2023-11-10,32,DPD30-59,103,103,0
2023-11-10,32,DPD60-89,0,0,0
2023-11-10,32,DPD90+,0,0,0
2023-11-10,34,Current,68,68,0
2023-11-10,34,DPD15-29,78,78,0
2023-11-10,34,DPD3-14,91,91,0
2023-11-10,34,DPD30-59,49,49,0
2023-11-10,34,DPD60-89,0,0,0
2023-11-10,34,DPD90+,0,0,0
2023-11-10,36,Current,86,86,0
2023-11-10,36,DPD15-29,38,38,0
2023-11-10,36,DPD3-14,43,43,0
2023-11-10,36,DPD30-59,19,19,0
2023-11-10,36,DPD60-89,0,0,0
2023-11-10,36,DPD90+,0,0,0
2023-11-10,38,Current,72,72,0
2023-11-10,38,DPD15-29,16,16,0
2023-11-10,38,DPD3-14,48,48,0
2023-11-10,38,DPD30-59,14,14,0
2023-11-10,38,DPD60-89,0,0,0
2023-11-10,38,DPD90+,0,0,0
2023-11-10,40,Current,57,57,0
2023-11-10,40,DPD15-29,20,20,0
2023-11-10,40,DPD3-14,23,23,0
2023-11-10,40,DPD30-59,9,9,0
2023-11-10,40,DPD60-89,1,1,0
2023-11-10,40,DPD90+,0,0,0
2023-11-10,42,Current,20,20,0
2023-11-10,42,DPD15-29,9,9,0
2023-11-10,42,DPD3-14,18,18,0
2023-11-10,42,DPD30-59,6,6,0
2023-11-10,42,DPD60-89,0,0,0
2023-11-10,42,DPD90+,0,0,0
2023-11-10,44,Current,75,75,0
2023-11-10,44,DPD15-29,29,29,0
2023-11-10,44,DPD3-14,48,48,0
2023-11-10,44,DPD30-59,8,8,0
2023-11-10,44,DPD60-89,0,0,0
2023-11-10,44,DPD90+,0,0,0
2023-11-10,46,Current,0,0,0
2023-11-10,46,DPD15-29,0,0,0
2023-11-10,46,DPD3-14,1,1,0
2023-11-10,46,DPD60-89,0,0,0
2023-11-10,48,Current,168,168,0
2023-11-10,48,DPD15-29,6,6,0
2023-11-10,48,DPD3-14,24,24,0
2023-11-10,48,DPD30-59,6,6,0
2023-11-10,48,DPD60-89,0,0,0
2023-11-10,48,DPD90+,0,0,0
2023-11-10,6,Current,0,0,0
2023-11-10,6,DPD60-89,0,0,0
2023-11-10,6,DPD90+,0,0,0
2023-11-09,100,Current,0,0,0
2023-11-09,100,DPD3-14,0,0,0
2023-11-09,100,DPD90+,0,0,0
2023-11-09,102,Current,0,0,0
2023-11-09,102,DPD3-14,0,0,0
2023-11-09,102,DPD60-89,0,0,0
2023-11-09,104,Current,0,0,0
2023-11-09,104,DPD3-14,0,0,0
2023-11-09,104,DPD30-59,0,0,0
2023-11-09,104,DPD60-89,0,0,0
2023-11-09,20,Current,53,53,0
2023-11-09,20,DPD15-29,0,0,0
2023-11-09,20,DPD3-14,0,0,0
2023-11-09,20,DPD30-59,0,0,0
2023-11-09,20,DPD60-89,0,0,0
2023-11-09,20,DPD90+,0,0,0
2023-11-09,22,Current,0,0,0
2023-11-09,22,DPD15-29,1,1,0
2023-11-09,22,DPD3-14,1,1,0
2023-11-09,22,DPD30-59,0,0,0
2023-11-09,22,DPD60-89,0,0,0
2023-11-09,22,DPD90+,0,0,0
2023-11-09,24,Current,48,48,0
2023-11-09,24,DPD15-29,160,160,0
2023-11-09,24,DPD3-14,163,163,0
2023-11-09,24,DPD30-59,156,156,0
2023-11-09,24,DPD60-89,0,0,0
2023-11-09,24,DPD90+,0,0,0
2023-11-09,26,Current,1,1,0
2023-11-09,26,DPD15-29,36,36,0
2023-11-09,26,DPD3-14,21,21,0
2023-11-09,26,DPD30-59,22,22,0
2023-11-09,26,DPD60-89,0,0,0
2023-11-09,26,DPD90+,0,0,0
2023-11-09,32,Current,9,9,0
2023-11-09,32,DPD15-29,95,95,0
2023-11-09,32,DPD3-14,97,97,0
2023-11-09,32,DPD30-59,136,136,0
2023-11-09,32,DPD60-89,0,0,0
2023-11-09,32,DPD90+,0,0,0
2023-11-09,34,Current,6,6,0
2023-11-09,34,DPD15-29,38,38,0
2023-11-09,34,DPD3-14,46,46,0
2023-11-09,34,DPD30-59,72,72,0
2023-11-09,34,DPD60-89,0,0,0
2023-11-09,34,DPD90+,0,0,0
2023-11-09,36,Current,8,8,0
2023-11-09,36,DPD15-29,27,27,0
2023-11-09,36,DPD3-14,56,56,0
2023-11-09,36,DPD30-59,45,45,0
2023-11-09,36,DPD60-89,0,0,0
2023-11-09,36,DPD90+,0,0,0
2023-11-09,38,Current,6,6,0
2023-11-09,38,DPD15-29,50,50,0
2023-11-09,38,DPD3-14,40,40,0
2023-11-09,38,DPD30-59,41,41,0
2023-11-09,38,DPD60-89,0,0,0
2023-11-09,38,DPD90+,0,0,0
2023-11-09,40,Current,2,2,0
2023-11-09,40,DPD15-29,18,18,0
2023-11-09,40,DPD3-14,26,26,0
2023-11-09,40,DPD30-59,19,19,0
2023-11-09,40,DPD60-89,0,0,0
2023-11-09,40,DPD90+,0,0,0
2023-11-09,42,Current,2,2,0
2023-11-09,42,DPD15-29,19,19,0
2023-11-09,42,DPD3-14,15,15,0
2023-11-09,42,DPD30-59,18,18,0
2023-11-09,42,DPD60-89,0,0,0
2023-11-09,42,DPD90+,0,0,0
2023-11-09,44,Current,5,5,0
2023-11-09,44,DPD15-29,30,30,0
2023-11-09,44,DPD3-14,33,33,0
2023-11-09,44,DPD30-59,34,34,0
2023-11-09,44,DPD60-89,0,0,0
2023-11-09,44,DPD90+,0,0,0
2023-11-09,46,Current,1,1,0
2023-11-09,46,DPD15-29,0,0,0
2023-11-09,46,DPD3-14,0,0,0
2023-11-09,46,DPD60-89,0,0,0
2023-11-09,48,Current,36,36,0
2023-11-09,48,DPD15-29,11,11,0
2023-11-09,48,DPD3-14,16,16,0
2023-11-09,48,DPD30-59,12,12,0
2023-11-09,48,DPD60-89,0,0,0
2023-11-09,48,DPD90+,0,0,0
2023-11-09,6,Current,0,0,0
2023-11-09,6,DPD60-89,0,0,0
2023-11-09,6,DPD90+,0,0,0
2023-11-08,100,Current,0,0,0
2023-11-08,100,DPD3-14,2,2,0
2023-11-08,100,DPD90+,0,0,0
2023-11-08,102,Current,0,0,0
2023-11-08,102,DPD60-89,0,0,0
2023-11-08,104,Current,0,0,0
2023-11-08,104,DPD3-14,1,1,0
2023-11-08,104,DPD30-59,1,1,0
2023-11-08,104,DPD60-89,0,0,0
2023-11-08,20,Current,32,32,0
2023-11-08,20,DPD15-29,0,0,0
2023-11-08,20,DPD3-14,0,0,0
2023-11-08,20,DPD30-59,0,0,0
2023-11-08,20,DPD60-89,0,0,0
2023-11-08,20,DPD90+,0,0,0
2023-11-08,22,Current,0,0,0
2023-11-08,22,DPD15-29,2,2,0
2023-11-08,22,DPD3-14,2,2,0
2023-11-08,22,DPD30-59,0,0,0
2023-11-08,22,DPD60-89,0,0,0
2023-11-08,22,DPD90+,0,0,0
2023-11-08,24,Current,64,64,0
2023-11-08,24,DPD15-29,94,94,0
2023-11-08,24,DPD3-14,159,159,0
2023-11-08,24,DPD30-59,57,57,0
2023-11-08,24,DPD60-89,0,0,0
2023-11-08,24,DPD90+,0,0,0
2023-11-08,26,Current,5,5,0
2023-11-08,26,DPD15-29,14,14,0
2023-11-08,26,DPD3-14,28,28,0
2023-11-08,26,DPD30-59,14,14,0
2023-11-08,26,DPD60-89,0,0,0
2023-11-08,26,DPD90+,0,0,0
2023-11-08,32,Current,33,33,0
2023-11-08,32,DPD15-29,160,160,0
2023-11-08,32,DPD3-14,221,221,0
2023-11-08,32,DPD30-59,114,114,0
2023-11-08,32,DPD60-89,0,0,0
2023-11-08,32,DPD90+,0,0,0
2023-11-08,34,Current,10,10,0
2023-11-08,34,DPD15-29,74,74,0
2023-11-08,34,DPD3-14,100,100,0
2023-11-08,34,DPD30-59,51,51,0
2023-11-08,34,DPD60-89,0,0,0
2023-11-08,34,DPD90+,0,0,0
2023-11-08,36,Current,9,9,0
2023-11-08,36,DPD15-29,33,33,0
2023-11-08,36,DPD3-14,56,56,0
2023-11-08,36,DPD30-59,13,13,0
2023-11-08,36,DPD60-89,0,0,0
2023-11-08,36,DPD90+,0,0,0
2023-11-08,38,Current,13,13,0
2023-11-08,38,DPD15-29,16,16,0
2023-11-08,38,DPD3-14,47,47,0
2023-11-08,38,DPD30-59,12,12,0
2023-11-08,38,DPD60-89,0,0,0
2023-11-08,38,DPD90+,0,0,0
2023-11-08,40,Current,6,6,0
2023-11-08,40,DPD15-29,22,22,0
2023-11-08,40,DPD3-14,33,33,0
2023-11-08,40,DPD30-59,7,7,0
2023-11-08,40,DPD60-89,0,0,0
2023-11-08,40,DPD90+,0,0,0
2023-11-08,42,Current,1,1,0
2023-11-08,42,DPD15-29,6,6,0
2023-11-08,42,DPD3-14,17,17,0
2023-11-08,42,DPD30-59,6,6,0
2023-11-08,42,DPD60-89,0,0,0
2023-11-08,42,DPD90+,0,0,0
2023-11-08,44,Current,12,12,0
2023-11-08,44,DPD15-29,22,22,0
2023-11-08,44,DPD3-14,54,54,0
2023-11-08,44,DPD30-59,8,8,0
2023-11-08,44,DPD60-89,0,0,0
2023-11-08,44,DPD90+,0,0,0
2023-11-08,46,Current,0,0,0
2023-11-08,46,DPD15-29,0,0,0
2023-11-08,46,DPD3-14,1,1,0
2023-11-08,46,DPD60-89,0,0,0
2023-11-08,48,Current,21,21,0
2023-11-08,48,DPD15-29,7,7,0
2023-11-08,48,DPD3-14,23,23,0
2023-11-08,48,DPD30-59,6,6,0
2023-11-08,48,DPD60-89,0,0,0
2023-11-08,48,DPD90+,0,0,0
2023-11-08,6,Current,0,0,0
2023-11-08,6,DPD60-89,0,0,0
2023-11-08,6,DPD90+,0,0,0
2023-11-07,100,Current,0,0,0
2023-11-07,100,DPD3-14,0,0,0
2023-11-07,100,DPD90+,0,0,0
2023-11-07,102,Current,0,0,0
2023-11-07,102,DPD30-59,0,0,0
2023-11-07,102,DPD60-89,0,0,0
2023-11-07,104,Current,0,0,0
2023-11-07,104,DPD3-14,0,0,0
2023-11-07,104,DPD30-59,0,0,0
2023-11-07,104,DPD60-89,0,0,0
2023-11-07,20,Current,45,45,0
2023-11-07,20,DPD15-29,0,0,0
2023-11-07,20,DPD3-14,0,0,0
2023-11-07,20,DPD30-59,0,0,0
2023-11-07,20,DPD60-89,0,0,0
2023-11-07,20,DPD90+,0,0,0
2023-11-07,22,Current,1,1,0
2023-11-07,22,DPD15-29,1,1,0
2023-11-07,22,DPD3-14,1,1,0
2023-11-07,22,DPD30-59,0,0,0
2023-11-07,22,DPD60-89,0,0,0
2023-11-07,22,DPD90+,0,0,0
2023-11-07,24,Current,63,63,0
2023-11-07,24,DPD15-29,155,155,0
2023-11-07,24,DPD3-14,194,194,0
2023-11-07,24,DPD30-59,157,157,0
2023-11-07,24,DPD60-89,0,0,0
2023-11-07,24,DPD90+,0,0,0
2023-11-07,26,Current,4,4,0
2023-11-07,26,DPD15-29,35,35,0
2023-11-07,26,DPD3-14,31,31,0
2023-11-07,26,DPD30-59,27,27,0
2023-11-07,26,DPD60-89,0,0,0
2023-11-07,26,DPD90+,0,0,0
2023-11-07,32,Current,15,15,0
2023-11-07,32,DPD15-29,83,83,0
2023-11-07,32,DPD3-14,104,104,0
2023-11-07,32,DPD30-59,139,139,0
2023-11-07,32,DPD60-89,0,0,0
2023-11-07,32,DPD90+,0,0,0
2023-11-07,34,Current,4,4,0
2023-11-07,34,DPD15-29,45,45,0
2023-11-07,34,DPD3-14,49,49,0
2023-11-07,34,DPD30-59,65,65,0
2023-11-07,34,DPD60-89,0,0,0
2023-11-07,34,DPD90+,0,0,0
2023-11-07,36,Current,10,10,0
2023-11-07,36,DPD15-29,32,32,0
2023-11-07,36,DPD3-14,60,60,0
2023-11-07,36,DPD30-59,47,47,0
2023-11-07,36,DPD60-89,0,0,0
2023-11-07,36,DPD90+,0,0,0
2023-11-07,38,Current,7,7,0
2023-11-07,38,DPD15-29,54,54,0
2023-11-07,38,DPD3-14,53,53,0
2023-11-07,38,DPD30-59,43,43,0
2023-11-07,38,DPD60-89,0,0,0
2023-11-07,38,DPD90+,0,0,0
2023-11-07,40,Current,5,5,0
2023-11-07,40,DPD15-29,22,22,0
2023-11-07,40,DPD3-14,29,29,0
2023-11-07,40,DPD30-59,20,20,0
2023-11-07,40,DPD60-89,0,0,0
2023-11-07,40,DPD90+,0,0,0
2023-11-07,42,Current,5,5,0
2023-11-07,42,DPD15-29,18,18,0
2023-11-07,42,DPD3-14,20,20,0
2023-11-07,42,DPD30-59,21,21,0
2023-11-07,42,DPD60-89,0,0,0
2023-11-07,42,DPD90+,0,0,0
2023-11-07,44,Current,10,10,0
2023-11-07,44,DPD15-29,37,37,0
2023-11-07,44,DPD3-14,45,45,0
2023-11-07,44,DPD30-59,33,33,0
2023-11-07,44,DPD60-89,0,0,0
2023-11-07,44,DPD90+,0,0,0
2023-11-07,46,Current,0,0,0
2023-11-07,46,DPD15-29,1,1,0
2023-11-07,46,DPD3-14,1,1,0
2023-11-07,46,DPD30-59,0,0,0
2023-11-07,46,DPD60-89,0,0,0
2023-11-07,48,Current,44,44,0
2023-11-07,48,DPD15-29,12,12,0
2023-11-07,48,DPD3-14,13,13,0
2023-11-07,48,DPD30-59,13,13,0
2023-11-07,48,DPD60-89,0,0,0
2023-11-07,48,DPD90+,0,0,0
2023-11-07,6,Current,0,0,0
2023-11-07,6,DPD60-89,0,0,0
2023-11-07,6,DPD90+,0,0,0
2023-11-06,100,Current,0,0,0
2023-11-06,100,DPD3-14,0,0,0
2023-11-06,100,DPD90+,0,0,0
2023-11-06,102,Current,0,0,0
2023-11-06,102,DPD30-59,0,0,0
2023-11-06,102,DPD60-89,0,0,0
2023-11-06,104,Current,0,0,0
2023-11-06,104,DPD3-14,0,0,0
2023-11-06,104,DPD30-59,1,1,0
2023-11-06,104,DPD60-89,0,0,0
2023-11-06,20,Current,151,151,0
2023-11-06,20,DPD15-29,1,1,0
2023-11-06,20,DPD3-14,1,1,0
2023-11-06,20,DPD30-59,0,0,0
2023-11-06,20,DPD60-89,0,0,0
2023-11-06,20,DPD90+,0,0,0
2023-11-06,22,Current,0,0,0
2023-11-06,22,DPD15-29,1,1,0
2023-11-06,22,DPD3-14,3,3,0
2023-11-06,22,DPD30-59,0,0,0
2023-11-06,22,DPD60-89,0,0,0
2023-11-06,22,DPD90+,0,0,0
2023-11-06,24,Current,90,90,0
2023-11-06,24,DPD15-29,94,94,0
2023-11-06,24,DPD3-14,176,176,0
2023-11-06,24,DPD30-59,52,52,0
2023-11-06,24,DPD60-89,1,1,0
2023-11-06,24,DPD90+,0,0,0
2023-11-06,26,Current,2,2,0
2023-11-06,26,DPD15-29,17,17,0
2023-11-06,26,DPD3-14,35,35,0
2023-11-06,26,DPD30-59,9,9,0
2023-11-06,26,DPD60-89,0,0,0
2023-11-06,26,DPD90+,0,0,0
2023-11-06,32,Current,2,2,0
2023-11-06,32,DPD15-29,156,156,0
2023-11-06,32,DPD3-14,289,289,0
2023-11-06,32,DPD30-59,115,115,0
2023-11-06,32,DPD60-89,0,0,0
2023-11-06,32,DPD90+,0,0,0
2023-11-06,34,Current,0,0,0
2023-11-06,34,DPD15-29,66,66,0
2023-11-06,34,DPD3-14,123,123,0
2023-11-06,34,DPD30-59,53,53,0
2023-11-06,34,DPD60-89,0,0,0
2023-11-06,34,DPD90+,0,0,0
2023-11-06,36,Current,2,2,0
2023-11-06,36,DPD15-29,37,37,0
2023-11-06,36,DPD3-14,52,52,0
2023-11-06,36,DPD30-59,12,12,0
2023-11-06,36,DPD60-89,0,0,0
2023-11-06,36,DPD90+,0,0,0
2023-11-06,38,Current,2,2,0
2023-11-06,38,DPD15-29,15,15,0
2023-11-06,38,DPD3-14,57,57,0
2023-11-06,38,DPD30-59,12,12,0
2023-11-06,38,DPD60-89,0,0,0
2023-11-06,38,DPD90+,0,0,0
2023-11-06,40,Current,8,8,0
2023-11-06,40,DPD15-29,23,23,0
2023-11-06,40,DPD3-14,37,37,0
2023-11-06,40,DPD30-59,8,8,0
2023-11-06,40,DPD60-89,0,0,0
2023-11-06,40,DPD90+,0,0,0
2023-11-06,42,Current,3,3,0
2023-11-06,42,DPD15-29,5,5,0
2023-11-06,42,DPD3-14,19,19,0
2023-11-06,42,DPD30-59,5,5,0
2023-11-06,42,DPD60-89,0,0,0
2023-11-06,42,DPD90+,0,0,0
2023-11-06,44,Current,5,5,0
2023-11-06,44,DPD15-29,22,22,0
2023-11-06,44,DPD3-14,58,58,0
2023-11-06,44,DPD30-59,9,9,0
2023-11-06,44,DPD60-89,0,0,0
2023-11-06,44,DPD90+,0,0,0
2023-11-06,46,Current,0,0,0
2023-11-06,46,DPD15-29,0,0,0
2023-11-06,46,DPD3-14,1,1,0
2023-11-06,46,DPD30-59,0,0,0
2023-11-06,46,DPD60-89,0,0,0
2023-11-06,48,Current,90,90,0
2023-11-06,48,DPD15-29,8,8,0
2023-11-06,48,DPD3-14,18,18,0
2023-11-06,48,DPD30-59,3,3,0
2023-11-06,48,DPD60-89,0,0,0
2023-11-06,48,DPD90+,0,0,0
2023-11-06,6,Current,0,0,0
2023-11-06,6,DPD60-89,0,0,0
2023-11-06,6,DPD90+,0,0,0
2023-11-05,100,Current,0,0,0
2023-11-05,100,DPD90+,0,0,0
2023-11-05,102,Current,0,0,0
2023-11-05,102,DPD60-89,0,0,0
2023-11-05,104,Current,0,0,0
2023-11-05,104,DPD3-14,0,0,0
2023-11-05,104,DPD30-59,0,0,0
2023-11-05,104,DPD60-89,0,0,0
2023-11-05,20,Current,251,251,0
2023-11-05,20,DPD15-29,2,2,0
2023-11-05,20,DPD3-14,0,0,0
2023-11-05,20,DPD30-59,0,0,0
2023-11-05,20,DPD60-89,0,0,0
2023-11-05,20,DPD90+,0,0,0
2023-11-05,22,Current,0,0,0
2023-11-05,22,DPD15-29,1,1,0
2023-11-05,22,DPD3-14,1,1,0
2023-11-05,22,DPD30-59,0,0,0
2023-11-05,22,DPD60-89,0,0,0
2023-11-05,22,DPD90+,0,0,0
2023-11-05,24,Current,158,158,0
2023-11-05,24,DPD15-29,95,95,0
2023-11-05,24,DPD3-14,120,120,0
2023-11-05,24,DPD30-59,154,154,0
2023-11-05,24,DPD60-89,0,0,0
2023-11-05,24,DPD90+,0,0,0
2023-11-05,26,Current,0,0,0
2023-11-05,26,DPD15-29,22,22,0
2023-11-05,26,DPD3-14,24,24,0
2023-11-05,26,DPD30-59,21,21,0
2023-11-05,26,DPD60-89,0,0,0
2023-11-05,26,DPD90+,0,0,0
2023-11-05,32,Current,1,1,0
2023-11-05,32,DPD15-29,71,71,0
2023-11-05,32,DPD3-14,103,103,0
2023-11-05,32,DPD30-59,148,148,0
2023-11-05,32,DPD60-89,0,0,0
2023-11-05,32,DPD90+,0,0,0
2023-11-05,34,Current,0,0,0
2023-11-05,34,DPD15-29,42,42,0
2023-11-05,34,DPD3-14,41,41,0
2023-11-05,34,DPD30-59,71,71,0
2023-11-05,34,DPD60-89,0,0,0
2023-11-05,34,DPD90+,0,0,0
2023-11-05,36,Current,0,0,0
2023-11-05,36,DPD15-29,23,23,0
2023-11-05,36,DPD3-14,40,40,0
2023-11-05,36,DPD30-59,46,46,0
2023-11-05,36,DPD60-89,0,0,0
2023-11-05,36,DPD90+,0,0,0
2023-11-05,38,Current,0,0,0
2023-11-05,38,DPD15-29,40,40,0
2023-11-05,38,DPD3-14,32,32,0
2023-11-05,38,DPD30-59,39,39,0
2023-11-05,38,DPD60-89,0,0,0
2023-11-05,38,DPD90+,0,0,0
2023-11-05,40,Current,0,0,0
2023-11-05,40,DPD15-29,14,14,0
2023-11-05,40,DPD3-14,14,14,0
2023-11-05,40,DPD30-59,17,17,0
2023-11-05,40,DPD60-89,0,0,0
2023-11-05,40,DPD90+,0,0,0
2023-11-05,42,Current,0,0,0
2023-11-05,42,DPD15-29,14,14,0
2023-11-05,42,DPD3-14,10,10,0
2023-11-05,42,DPD30-59,18,18,0
2023-11-05,42,DPD60-89,0,0,0
2023-11-05,42,DPD90+,0,0,0
2023-11-05,44,Current,0,0,0
2023-11-05,44,DPD15-29,27,27,0
2023-11-05,44,DPD3-14,26,26,0
2023-11-05,44,DPD30-59,31,31,0
2023-11-05,44,DPD60-89,0,0,0
2023-11-05,44,DPD90+,0,0,0
2023-11-05,46,Current,0,0,0
2023-11-05,46,DPD15-29,1,1,0
2023-11-05,46,DPD3-14,0,0,0
2023-11-05,46,DPD60-89,0,0,0
2023-11-05,48,Current,192,192,0
2023-11-05,48,DPD15-29,8,8,0
2023-11-05,48,DPD3-14,8,8,0
2023-11-05,48,DPD30-59,14,14,0
2023-11-05,48,DPD60-89,0,0,0
2023-11-05,48,DPD90+,0,0,0
2023-11-05,6,Current,0,0,0
2023-11-05,6,DPD60-89,0,0,0
2023-11-05,6,DPD90+,0,0,0
2023-11-04,100,Current,0,0,0
2023-11-04,100,DPD90+,0,0,0
2023-11-04,102,Current,0,0,0
2023-11-04,102,DPD30-59,0,0,0
2023-11-04,102,DPD60-89,0,0,0
2023-11-04,104,Current,0,0,0
2023-11-04,104,DPD3-14,0,0,0
2023-11-04,104,DPD30-59,1,1,0
2023-11-04,104,DPD60-89,0,0,0
2023-11-04,20,Current,51,51,0
2023-11-04,20,DPD15-29,0,0,0
2023-11-04,20,DPD3-14,0,0,0
2023-11-04,20,DPD30-59,0,0,0
2023-11-04,20,DPD60-89,0,0,0
2023-11-04,20,DPD90+,0,0,0
2023-11-04,22,Current,0,0,0
2023-11-04,22,DPD15-29,0,0,0
2023-11-04,22,DPD3-14,3,3,0
2023-11-04,22,DPD30-59,0,0,0
2023-11-04,22,DPD60-89,0,0,0
2023-11-04,22,DPD90+,0,0,0
2023-11-04,24,Current,59,59,0
2023-11-04,24,DPD15-29,87,87,0
2023-11-04,24,DPD3-14,170,170,0
2023-11-04,24,DPD30-59,24,24,0
2023-11-04,24,DPD60-89,0,0,0
2023-11-04,24,DPD90+,0,0,0
2023-11-04,26,Current,2,2,0
2023-11-04,26,DPD15-29,18,18,0
2023-11-04,26,DPD3-14,27,27,0
2023-11-04,26,DPD30-59,6,6,0
2023-11-04,26,DPD60-89,0,0,0
2023-11-04,26,DPD90+,0,0,0
2023-11-04,32,Current,21,21,0
2023-11-04,32,DPD15-29,115,115,0
2023-11-04,32,DPD3-14,238,238,0
2023-11-04,32,DPD30-59,101,101,0
2023-11-04,32,DPD60-89,0,0,0
2023-11-04,32,DPD90+,0,0,0
2023-11-04,34,Current,17,17,0
2023-11-04,34,DPD15-29,53,53,0
2023-11-04,34,DPD3-14,101,101,0
2023-11-04,34,DPD30-59,49,49,0
2023-11-04,34,DPD60-89,0,0,0
2023-11-04,34,DPD90+,0,0,0
2023-11-04,36,Current,13,13,0
2023-11-04,36,DPD15-29,29,29,0
2023-11-04,36,DPD3-14,42,42,0
2023-11-04,36,DPD30-59,6,6,0
2023-11-04,36,DPD60-89,0,0,0
2023-11-04,36,DPD90+,0,0,0
2023-11-04,38,Current,7,7,0
2023-11-04,38,DPD15-29,16,16,0
2023-11-04,38,DPD3-14,43,43,0
2023-11-04,38,DPD30-59,7,7,0
2023-11-04,38,DPD60-89,0,0,0
2023-11-04,38,DPD90+,0,0,0
2023-11-04,40,Current,2,2,0
2023-11-04,40,DPD15-29,22,22,0
2023-11-04,40,DPD3-14,32,32,0
2023-11-04,40,DPD30-59,4,4,0
2023-11-04,40,DPD60-89,0,0,0
2023-11-04,40,DPD90+,0,0,0
2023-11-04,42,Current,3,3,0
2023-11-04,42,DPD15-29,4,4,0
2023-11-04,42,DPD3-14,19,19,0
2023-11-04,42,DPD30-59,5,5,0
2023-11-04,42,DPD60-89,0,0,0
2023-11-04,42,DPD90+,0,0,0
2023-11-04,44,Current,5,5,0
2023-11-04,44,DPD15-29,22,22,0
2023-11-04,44,DPD3-14,29,29,0
2023-11-04,44,DPD30-59,2,2,0
2023-11-04,44,DPD60-89,0,0,0
2023-11-04,44,DPD90+,0,0,0
2023-11-04,46,Current,0,0,0
2023-11-04,46,DPD15-29,0,0,0
2023-11-04,46,DPD3-14,0,0,0
2023-11-04,46,DPD60-89,0,0,0
2023-11-04,48,Current,30,30,0
2023-11-04,48,DPD15-29,10,10,0
2023-11-04,48,DPD3-14,11,11,0
2023-11-04,48,DPD30-59,0,0,0
2023-11-04,48,DPD60-89,0,0,0
2023-11-04,48,DPD90+,0,0,0
2023-11-04,6,Current,0,0,0
2023-11-04,6,DPD60-89,0,0,0
2023-11-04,6,DPD90+,0,0,0
2023-11-03,100,Current,1,1,0
2023-11-03,100,DPD90+,0,0,0
2023-11-03,102,Current,0,0,0
2023-11-03,102,DPD30-59,2,2,0
2023-11-03,102,DPD60-89,0,0,0
2023-11-03,104,Current,0,0,0
2023-11-03,104,DPD3-14,0,0,0
2023-11-03,104,DPD30-59,1,1,0
2023-11-03,104,DPD60-89,0,0,0
2023-11-03,20,Current,465,465,0
2023-11-03,20,DPD15-29,0,0,0
2023-11-03,20,DPD3-14,0,0,0
2023-11-03,20,DPD30-59,1,1,0
2023-11-03,20,DPD60-89,0,0,0
2023-11-03,20,DPD90+,1,1,0
2023-11-03,22,Current,1,1,0
2023-11-03,22,DPD15-29,1,1,0
2023-11-03,22,DPD3-14,7,7,0
2023-11-03,22,DPD30-59,0,0,0
2023-11-03,22,DPD60-89,1,1,0
2023-11-03,22,DPD90+,0,0,0
2023-11-03,24,Current,548,548,0
2023-11-03,24,DPD15-29,285,285,0
2023-11-03,24,DPD3-14,531,531,0
2023-11-03,24,DPD30-59,227,227,0
2023-11-03,24,DPD60-89,31,31,0
2023-11-03,24,DPD90+,32,32,0
2023-11-03,26,Current,74,74,0
2023-11-03,26,DPD15-29,61,61,0
2023-11-03,26,DPD3-14,94,94,0
2023-11-03,26,DPD30-59,41,41,0
2023-11-03,26,DPD60-89,4,4,0
2023-11-03,26,DPD90+,5,5,0
2023-11-03,32,Current,314,314,0
2023-11-03,32,DPD15-29,220,220,0
2023-11-03,32,DPD3-14,499,499,0
2023-11-03,32,DPD30-59,226,226,0
2023-11-03,32,DPD60-89,45,45,0
2023-11-03,32,DPD90+,38,38,0
2023-11-03,34,Current,128,128,0
2023-11-03,34,DPD15-29,131,131,0
2023-11-03,34,DPD3-14,213,213,0
2023-11-03,34,DPD30-59,103,103,0
2023-11-03,34,DPD60-89,14,14,0
2023-11-03,34,DPD90+,14,14,0
2023-11-03,36,Current,138,138,0
2023-11-03,36,DPD15-29,94,94,0
2023-11-03,36,DPD3-14,167,167,0
2023-11-03,36,DPD30-59,72,72,0
2023-11-03,36,DPD60-89,14,14,0
2023-11-03,36,DPD90+,11,11,0
2023-11-03,38,Current,114,114,0
2023-11-03,38,DPD15-29,89,89,0
2023-11-03,38,DPD3-14,149,149,0
2023-11-03,38,DPD30-59,58,58,0
2023-11-03,38,DPD60-89,9,9,0
2023-11-03,38,DPD90+,10,10,0
2023-11-03,40,Current,81,81,0
2023-11-03,40,DPD15-29,43,43,0
2023-11-03,40,DPD3-14,93,93,0
2023-11-03,40,DPD30-59,40,40,0
2023-11-03,40,DPD60-89,9,9,0
2023-11-03,40,DPD90+,10,10,0
2023-11-03,42,Current,40,40,0
2023-11-03,42,DPD15-29,24,24,0
2023-11-03,42,DPD3-14,54,54,0
2023-11-03,42,DPD30-59,32,32,0
2023-11-03,42,DPD60-89,4,4,0
2023-11-03,42,DPD90+,3,3,0
2023-11-03,44,Current,112,112,0
2023-11-03,44,DPD15-29,79,79,0
2023-11-03,44,DPD3-14,121,121,0
2023-11-03,44,DPD30-59,48,48,0
2023-11-03,44,DPD60-89,12,12,0
2023-11-03,44,DPD90+,7,7,0
2023-11-03,46,Current,3,3,0
2023-11-03,46,DPD15-29,2,2,0
2023-11-03,46,DPD60-89,0,0,0
2023-11-03,48,Current,144,144,0
2023-11-03,48,DPD15-29,25,25,0
2023-11-03,48,DPD3-14,37,37,0
2023-11-03,48,DPD30-59,16,16,0
2023-11-03,48,DPD60-89,2,2,0
2023-11-03,48,DPD90+,2,2,0
2023-11-03,6,Current,0,0,0
2023-11-03,6,DPD60-89,1,1,0
2023-11-03,6,DPD90+,0,0,0
2023-11-02,100,Current,0,0,0
2023-11-02,100,DPD90+,0,0,0
2023-11-02,102,Current,0,0,0
2023-11-02,102,DPD15-29,0,0,0
2023-11-02,102,DPD30-59,0,0,0
2023-11-02,102,DPD60-89,0,0,0
2023-11-02,104,Current,0,0,0
2023-11-02,104,DPD3-14,0,0,0
2023-11-02,104,DPD30-59,0,0,0
2023-11-02,104,DPD60-89,0,0,0
2023-11-02,20,Current,32,32,0
2023-11-02,20,DPD15-29,0,0,0
2023-11-02,20,DPD3-14,0,0,0
2023-11-02,20,DPD30-59,0,0,0
2023-11-02,20,DPD60-89,0,0,0
2023-11-02,20,DPD90+,0,0,0
2023-11-02,22,Current,0,0,0
2023-11-02,22,DPD15-29,0,0,0
2023-11-02,22,DPD3-14,0,0,0
2023-11-02,22,DPD30-59,0,0,0
2023-11-02,22,DPD60-89,0,0,0
2023-11-02,22,DPD90+,0,0,0
2023-11-02,24,Current,10,10,0
2023-11-02,24,DPD15-29,0,0,0
2023-11-02,24,DPD3-14,0,0,0
2023-11-02,24,DPD30-59,0,0,0
2023-11-02,24,DPD60-89,1,1,0
2023-11-02,24,DPD90+,0,0,0
2023-11-02,26,Current,0,0,0
2023-11-02,26,DPD15-29,0,0,0
2023-11-02,26,DPD3-14,0,0,0
2023-11-02,26,DPD30-59,0,0,0
2023-11-02,26,DPD60-89,0,0,0
2023-11-02,26,DPD90+,0,0,0
2023-11-02,32,Current,0,0,0
2023-11-02,32,DPD15-29,0,0,0
2023-11-02,32,DPD3-14,0,0,0
2023-11-02,32,DPD30-59,0,0,0
2023-11-02,32,DPD60-89,0,0,0
2023-11-02,32,DPD90+,0,0,0
2023-11-02,34,Current,0,0,0
2023-11-02,34,DPD15-29,0,0,0
2023-11-02,34,DPD3-14,0,0,0
2023-11-02,34,DPD30-59,0,0,0
2023-11-02,34,DPD60-89,0,0,0
2023-11-02,34,DPD90+,0,0,0
2023-11-02,36,Current,0,0,0
2023-11-02,36,DPD15-29,0,0,0
2023-11-02,36,DPD3-14,0,0,0
2023-11-02,36,DPD30-59,0,0,0
2023-11-02,36,DPD60-89,1,1,0
2023-11-02,36,DPD90+,0,0,0
2023-11-02,38,Current,0,0,0
2023-11-02,38,DPD15-29,0,0,0
2023-11-02,38,DPD3-14,0,0,0
2023-11-02,38,DPD30-59,0,0,0
2023-11-02,38,DPD60-89,0,0,0
2023-11-02,38,DPD90+,0,0,0
2023-11-02,40,Current,0,0,0
2023-11-02,40,DPD15-29,0,0,0
2023-11-02,40,DPD3-14,0,0,0
2023-11-02,40,DPD30-59,0,0,0
2023-11-02,40,DPD60-89,0,0,0
2023-11-02,40,DPD90+,0,0,0
2023-11-02,42,Current,0,0,0
2023-11-02,42,DPD15-29,0,0,0
2023-11-02,42,DPD3-14,0,0,0
2023-11-02,42,DPD30-59,0,0,0
2023-11-02,42,DPD60-89,0,0,0
2023-11-02,42,DPD90+,0,0,0
2023-11-02,44,Current,0,0,0
2023-11-02,44,DPD15-29,0,0,0
2023-11-02,44,DPD3-14,0,0,0
2023-11-02,44,DPD30-59,0,0,0
2023-11-02,44,DPD60-89,0,0,0
2023-11-02,44,DPD90+,0,0,0
2023-11-02,46,Current,0,0,0
2023-11-02,46,DPD15-29,0,0,0
2023-11-02,46,DPD60-89,0,0,0
2023-11-02,48,Current,12,12,0
2023-11-02,48,DPD15-29,0,0,0
2023-11-02,48,DPD3-14,0,0,0
2023-11-02,48,DPD30-59,0,0,0
2023-11-02,48,DPD60-89,0,0,0
2023-11-02,48,DPD90+,0,0,0
2023-11-02,6,Current,0,0,0
2023-11-02,6,DPD60-89,0,0,0
2023-11-02,6,DPD90+,0,0,0
2023-11-01,100,Current,0,0,0
2023-11-01,100,DPD15-29,0,0,0
2023-11-01,100,DPD90+,0,0,0
2023-11-01,102,Current,0,0,0
2023-11-01,102,DPD15-29,0,0,0
2023-11-01,102,DPD30-59,0,0,0
2023-11-01,102,DPD60-89,0,0,0
2023-11-01,104,Current,0,0,0
2023-11-01,104,DPD3-14,0,0,0
2023-11-01,104,DPD30-59,0,0,0
2023-11-01,104,DPD60-89,0,0,0
2023-11-01,20,Current,51,51,0
2023-11-01,20,DPD15-29,1,1,0
2023-11-01,20,DPD3-14,0,0,0
2023-11-01,20,DPD30-59,0,0,0
2023-11-01,20,DPD60-89,0,0,0
2023-11-01,20,DPD90+,0,0,0
2023-11-01,22,Current,0,0,0
2023-11-01,22,DPD15-29,0,0,0
2023-11-01,22,DPD3-14,0,0,0
2023-11-01,22,DPD30-59,0,0,0
2023-11-01,22,DPD60-89,0,0,0
2023-11-01,22,DPD90+,0,0,0
2023-11-01,24,Current,44,44,0
2023-11-01,24,DPD15-29,0,0,0
2023-11-01,24,DPD3-14,0,0,0
2023-11-01,24,DPD30-59,0,0,0
2023-11-01,24,DPD60-89,0,0,0
2023-11-01,24,DPD90+,0,0,0
2023-11-01,26,Current,2,2,0
2023-11-01,26,DPD15-29,0,0,0
2023-11-01,26,DPD3-14,0,0,0
2023-11-01,26,DPD30-59,0,0,0
2023-11-01,26,DPD60-89,0,0,0
2023-11-01,26,DPD90+,0,0,0
2023-11-01,32,Current,1,1,0
2023-11-01,32,DPD15-29,0,0,0
2023-11-01,32,DPD3-14,0,0,0
2023-11-01,32,DPD30-59,0,0,0
2023-11-01,32,DPD60-89,0,0,0
2023-11-01,32,DPD90+,0,0,0
2023-11-01,34,Current,0,0,0
2023-11-01,34,DPD15-29,0,0,0
2023-11-01,34,DPD3-14,0,0,0
2023-11-01,34,DPD30-59,0,0,0
2023-11-01,34,DPD60-89,0,0,0
2023-11-01,34,DPD90+,0,0,0
2023-11-01,36,Current,2,2,0
2023-11-01,36,DPD15-29,0,0,0
2023-11-01,36,DPD3-14,0,0,0
2023-11-01,36,DPD30-59,0,0,0
2023-11-01,36,DPD60-89,0,0,0
2023-11-01,36,DPD90+,0,0,0
2023-11-01,38,Current,1,1,0
2023-11-01,38,DPD15-29,0,0,0
2023-11-01,38,DPD3-14,0,0,0
2023-11-01,38,DPD30-59,0,0,0
2023-11-01,38,DPD60-89,0,0,0
2023-11-01,38,DPD90+,0,0,0
2023-11-01,40,Current,6,6,0
2023-11-01,40,DPD15-29,0,0,0
2023-11-01,40,DPD3-14,0,0,0
2023-11-01,40,DPD30-59,0,0,0
2023-11-01,40,DPD60-89,0,0,0
2023-11-01,40,DPD90+,0,0,0
2023-11-01,42,Current,3,3,0
2023-11-01,42,DPD15-29,0,0,0
2023-11-01,42,DPD3-14,0,0,0
2023-11-01,42,DPD30-59,0,0,0
2023-11-01,42,DPD60-89,0,0,0
2023-11-01,42,DPD90+,0,0,0
2023-11-01,44,Current,3,3,0
2023-11-01,44,DPD15-29,0,0,0
2023-11-01,44,DPD3-14,0,0,0
2023-11-01,44,DPD30-59,0,0,0
2023-11-01,44,DPD60-89,0,0,0
2023-11-01,44,DPD90+,0,0,0
2023-11-01,46,Current,0,0,0
2023-11-01,46,DPD15-29,0,0,0
2023-11-01,46,DPD3-14,0,0,0
2023-11-01,46,DPD60-89,0,0,0
2023-11-01,48,Current,48,48,0
2023-11-01,48,DPD15-29,0,0,0
2023-11-01,48,DPD3-14,0,0,0
2023-11-01,48,DPD30-59,0,0,0
2023-11-01,48,DPD60-89,0,0,0
2023-11-01,48,DPD90+,0,0,0
2023-11-01,6,Current,0,0,0
2023-11-01,6,DPD60-89,0,0,0
2023-11-01,6,DPD90+,0,0,0
2023-10-31,100,Current,1,1,0
2023-10-31,100,DPD15-29,0,0,0
2023-10-31,100,DPD90+,0,0,0
2023-10-31,102,Current,0,0,0
2023-10-31,102,DPD15-29,0,0,0
2023-10-31,102,DPD30-59,0,0,0
2023-10-31,102,DPD60-89,0,0,0
2023-10-31,104,Current,0,0,0
2023-10-31,104,DPD3-14,0,0,0
2023-10-31,104,DPD30-59,1,1,0
2023-10-31,104,DPD60-89,0,0,0
2023-10-31,20,Current,39,39,0
2023-10-31,20,DPD15-29,0,0,0
2023-10-31,20,DPD3-14,0,0,0
2023-10-31,20,DPD30-59,0,0,0
2023-10-31,20,DPD60-89,0,0,0
2023-10-31,20,DPD90+,0,0,0
2023-10-31,22,Current,0,0,0
2023-10-31,22,DPD15-29,0,0,0
2023-10-31,22,DPD3-14,2,2,0
2023-10-31,22,DPD30-59,0,0,0
2023-10-31,22,DPD60-89,0,0,0
2023-10-31,22,DPD90+,0,0,0
2023-10-31,24,Current,70,70,0
2023-10-31,24,DPD15-29,69,69,0
2023-10-31,24,DPD3-14,218,218,0
2023-10-31,24,DPD30-59,28,28,0
2023-10-31,24,DPD60-89,15,15,0
2023-10-31,24,DPD90+,11,11,0
2023-10-31,26,Current,8,8,0
2023-10-31,26,DPD15-29,12,12,0
2023-10-31,26,DPD3-14,41,41,0
2023-10-31,26,DPD30-59,4,4,0
2023-10-31,26,DPD60-89,1,1,0
2023-10-31,26,DPD90+,2,2,0
2023-10-31,32,Current,26,26,0
2023-10-31,32,DPD15-29,74,74,0
2023-10-31,32,DPD3-14,193,193,0
2023-10-31,32,DPD30-59,29,29,0
2023-10-31,32,DPD60-89,17,17,0
2023-10-31,32,DPD90+,12,12,0
2023-10-31,34,Current,10,10,0
2023-10-31,34,DPD15-29,33,33,0
2023-10-31,34,DPD3-14,81,81,0
2023-10-31,34,DPD30-59,17,17,0
2023-10-31,34,DPD60-89,8,8,0
2023-10-31,34,DPD90+,7,7,0
2023-10-31,36,Current,13,13,0
2023-10-31,36,DPD15-29,22,22,0
2023-10-31,36,DPD3-14,60,60,0
2023-10-31,36,DPD30-59,8,8,0
2023-10-31,36,DPD60-89,2,2,0
2023-10-31,36,DPD90+,6,6,0
2023-10-31,38,Current,11,11,0
2023-10-31,38,DPD15-29,16,16,0
2023-10-31,38,DPD3-14,63,63,0
2023-10-31,38,DPD30-59,6,6,0
2023-10-31,38,DPD60-89,5,5,0
2023-10-31,38,DPD90+,3,3,0
2023-10-31,40,Current,6,6,0
2023-10-31,40,DPD15-29,16,16,0
2023-10-31,40,DPD3-14,31,31,0
2023-10-31,40,DPD30-59,5,5,0
2023-10-31,40,DPD60-89,6,6,0
2023-10-31,40,DPD90+,4,4,0
2023-10-31,42,Current,2,2,0
2023-10-31,42,DPD15-29,4,4,0
2023-10-31,42,DPD3-14,23,23,0
2023-10-31,42,DPD30-59,4,4,0
2023-10-31,42,DPD60-89,1,1,0
2023-10-31,42,DPD90+,1,1,0
2023-10-31,44,Current,17,17,0
2023-10-31,44,DPD15-29,25,25,0
2023-10-31,44,DPD3-14,34,34,0
2023-10-31,44,DPD30-59,3,3,0
2023-10-31,44,DPD60-89,7,7,0
2023-10-31,44,DPD90+,2,2,0
2023-10-31,46,Current,0,0,0
2023-10-31,46,DPD15-29,0,0,0
2023-10-31,46,DPD3-14,0,0,0
2023-10-31,46,DPD60-89,0,0,0
2023-10-31,48,Current,33,33,0
2023-10-31,48,DPD15-29,9,9,0
2023-10-31,48,DPD3-14,20,20,0
2023-10-31,48,DPD30-59,0,0,0
2023-10-31,48,DPD60-89,1,1,0
2023-10-31,48,DPD90+,1,1,0
2023-10-31,6,Current,0,0,0
2023-10-31,6,DPD60-89,0,0,0
2023-10-31,6,DPD90+,0,0,0
2023-10-30,100,Current,0,0,0
2023-10-30,100,DPD15-29,0,0,0
2023-10-30,100,DPD90+,0,0,0
2023-10-30,102,Current,0,0,0
2023-10-30,102,DPD15-29,0,0,0
2023-10-30,102,DPD30-59,1,1,0
2023-10-30,102,DPD60-89,0,0,0
2023-10-30,104,Current,0,0,0
2023-10-30,104,DPD30-59,0,0,0
2023-10-30,104,DPD60-89,0,0,0
2023-10-30,20,Current,63,63,0
2023-10-30,20,DPD15-29,0,0,0
2023-10-30,20,DPD3-14,0,0,0
2023-10-30,20,DPD30-59,0,0,0
2023-10-30,20,DPD60-89,0,0,0
2023-10-30,20,DPD90+,0,0,0
2023-10-30,22,Current,0,0,0
2023-10-30,22,DPD15-29,1,1,0
2023-10-30,22,DPD3-14,2,2,0
2023-10-30,22,DPD30-59,0,0,0
2023-10-30,22,DPD60-89,1,1,0
2023-10-30,22,DPD90+,0,0,0
2023-10-30,24,Current,34,34,0
2023-10-30,24,DPD15-29,65,65,0
2023-10-30,24,DPD3-14,265,265,0
2023-10-30,24,DPD30-59,20,20,0
2023-10-30,24,DPD60-89,21,21,0
2023-10-30,24,DPD90+,19,19,0
2023-10-30,26,Current,0,0,0
2023-10-30,26,DPD15-29,10,10,0
2023-10-30,26,DPD3-14,49,49,0
2023-10-30,26,DPD30-59,7,7,0
2023-10-30,26,DPD60-89,2,2,0
2023-10-30,26,DPD90+,3,3,0
2023-10-30,32,Current,0,0,0
2023-10-30,32,DPD15-29,73,73,0
2023-10-30,32,DPD3-14,223,223,0
2023-10-30,32,DPD30-59,32,32,0
2023-10-30,32,DPD60-89,32,32,0
2023-10-30,32,DPD90+,23,23,0
2023-10-30,34,Current,0,0,0
2023-10-30,34,DPD15-29,46,46,0
2023-10-30,34,DPD3-14,78,78,0
2023-10-30,34,DPD30-59,22,22,0
2023-10-30,34,DPD60-89,9,9,0
2023-10-30,34,DPD90+,6,6,0
2023-10-30,36,Current,0,0,0
2023-10-30,36,DPD15-29,35,35,0
2023-10-30,36,DPD3-14,77,77,0
2023-10-30,36,DPD30-59,7,7,0
2023-10-30,36,DPD60-89,12,12,0
2023-10-30,36,DPD90+,6,6,0
2023-10-30,38,Current,0,0,0
2023-10-30,38,DPD15-29,24,24,0
2023-10-30,38,DPD3-14,69,69,0
2023-10-30,38,DPD30-59,6,6,0
2023-10-30,38,DPD60-89,5,5,0
2023-10-30,38,DPD90+,4,4,0
2023-10-30,40,Current,0,0,0
2023-10-30,40,DPD15-29,9,9,0
2023-10-30,40,DPD3-14,37,37,0
2023-10-30,40,DPD30-59,3,3,0
2023-10-30,40,DPD60-89,4,4,0
2023-10-30,40,DPD90+,5,5,0
2023-10-30,42,Current,0,0,0
2023-10-30,42,DPD15-29,2,2,0
2023-10-30,42,DPD3-14,23,23,0
2023-10-30,42,DPD30-59,7,7,0
2023-10-30,42,DPD60-89,4,4,0
2023-10-30,42,DPD90+,0,0,0
2023-10-30,44,Current,0,0,0
2023-10-30,44,DPD15-29,23,23,0
2023-10-30,44,DPD3-14,53,53,0
2023-10-30,44,DPD30-59,7,7,0
2023-10-30,44,DPD60-89,8,8,0
2023-10-30,44,DPD90+,3,3,0
2023-10-30,46,Current,0,0,0
2023-10-30,46,DPD15-29,1,1,0
2023-10-30,46,DPD30-59,0,0,0
2023-10-30,48,Current,44,44,0
2023-10-30,48,DPD15-29,9,9,0
2023-10-30,48,DPD3-14,21,21,0
2023-10-30,48,DPD30-59,1,1,0
2023-10-30,48,DPD60-89,1,1,0
2023-10-30,48,DPD90+,1,1,0
2023-10-30,6,Current,0,0,0
2023-10-30,6,DPD60-89,1,1,0
2023-10-30,6,DPD90+,0,0,0
2023-10-29,100,Current,0,0,0
2023-10-29,100,DPD3-14,0,0,0
2023-10-29,100,DPD90+,0,0,0
2023-10-29,102,Current,0,0,0
2023-10-29,102,DPD15-29,0,0,0
2023-10-29,102,DPD3-14,0,0,0
2023-10-29,102,DPD30-59,0,0,0
2023-10-29,102,DPD60-89,0,0,0
2023-10-29,104,Current,0,0,0
2023-10-29,104,DPD30-59,1,1,0
2023-10-29,104,DPD60-89,0,0,0
2023-10-29,20,Current,67,67,0
2023-10-29,20,DPD15-29,0,0,0
2023-10-29,20,DPD3-14,0,0,0
2023-10-29,20,DPD30-59,0,0,0
2023-10-29,20,DPD60-89,0,0,0
2023-10-29,20,DPD90+,0,0,0
2023-10-29,22,Current,0,0,0
2023-10-29,22,DPD15-29,0,0,0
2023-10-29,22,DPD3-14,1,1,0
2023-10-29,22,DPD30-59,0,0,0
2023-10-29,22,DPD60-89,0,0,0
2023-10-29,22,DPD90+,0,0,0
2023-10-29,24,Current,32,32,0
2023-10-29,24,DPD15-29,63,63,0
2023-10-29,24,DPD3-14,218,218,0
2023-10-29,24,DPD30-59,22,22,0
2023-10-29,24,DPD60-89,19,19,0
2023-10-29,24,DPD90+,8,8,0
2023-10-29,26,Current,0,0,0
2023-10-29,26,DPD15-29,13,13,0
2023-10-29,26,DPD3-14,42,42,0
2023-10-29,26,DPD30-59,2,2,0
2023-10-29,26,DPD60-89,1,1,0
2023-10-29,26,DPD90+,3,3,0
2023-10-29,32,Current,0,0,0
2023-10-29,32,DPD15-29,79,79,0
2023-10-29,32,DPD3-14,197,197,0
2023-10-29,32,DPD30-59,22,22,0
2023-10-29,32,DPD60-89,19,19,0
2023-10-29,32,DPD90+,13,13,0
2023-10-29,34,Current,0,0,0
2023-10-29,34,DPD15-29,37,37,0
2023-10-29,34,DPD3-14,78,78,0
2023-10-29,34,DPD30-59,14,14,0
2023-10-29,34,DPD60-89,8,8,0
2023-10-29,34,DPD90+,7,7,0
2023-10-29,36,Current,0,0,0
2023-10-29,36,DPD15-29,21,21,0
2023-10-29,36,DPD3-14,66,66,0
2023-10-29,36,DPD30-59,6,6,0
2023-10-29,36,DPD60-89,2,2,0
2023-10-29,36,DPD90+,6,6,0
2023-10-29,38,Current,0,0,0
2023-10-29,38,DPD15-29,17,17,0
2023-10-29,38,DPD3-14,63,63,0
2023-10-29,38,DPD30-59,6,6,0
2023-10-29,38,DPD60-89,2,2,0
2023-10-29,38,DPD90+,8,8,0
2023-10-29,40,Current,0,0,0
2023-10-29,40,DPD15-29,11,11,0
2023-10-29,40,DPD3-14,34,34,0
2023-10-29,40,DPD30-59,2,2,0
2023-10-29,40,DPD60-89,5,5,0
2023-10-29,40,DPD90+,4,4,0
2023-10-29,42,Current,0,0,0
2023-10-29,42,DPD15-29,5,5,0
2023-10-29,42,DPD3-14,11,11,0
2023-10-29,42,DPD30-59,3,3,0
2023-10-29,42,DPD60-89,1,1,0
2023-10-29,42,DPD90+,1,1,0
2023-10-29,44,Current,0,0,0
2023-10-29,44,DPD15-29,22,22,0
2023-10-29,44,DPD3-14,49,49,0
2023-10-29,44,DPD30-59,2,2,0
2023-10-29,44,DPD60-89,7,7,0
2023-10-29,44,DPD90+,2,2,0
2023-10-29,46,Current,0,0,0
2023-10-29,46,DPD15-29,0,0,0
2023-10-29,46,DPD3-14,0,0,0
2023-10-29,46,DPD30-59,0,0,0
2023-10-29,48,Current,31,31,0
2023-10-29,48,DPD15-29,9,9,0
2023-10-29,48,DPD3-14,21,21,0
2023-10-29,48,DPD30-59,0,0,0
2023-10-29,48,DPD60-89,1,1,0
2023-10-29,48,DPD90+,1,1,0
2023-10-29,6,Current,0,0,0
2023-10-29,6,DPD60-89,0,0,0
2023-10-29,6,DPD90+,0,0,0
2023-10-28,100,Current,0,0,0
2023-10-28,100,DPD3-14,1,1,0
2023-10-28,100,DPD90+,0,0,0
2023-10-28,102,Current,0,0,0
2023-10-28,102,DPD15-29,0,0,0
2023-10-28,102,DPD3-14,1,1,0
2023-10-28,102,DPD30-59,1,1,0
2023-10-28,102,DPD60-89,0,0,0
2023-10-28,104,Current,0,0,0
2023-10-28,104,DPD30-59,0,0,0
2023-10-28,104,DPD60-89,0,0,0
2023-10-28,20,Current,31,31,0
2023-10-28,20,DPD15-29,0,0,0
2023-10-28,20,DPD3-14,0,0,0
2023-10-28,20,DPD30-59,0,0,0
2023-10-28,20,DPD60-89,0,0,0
2023-10-28,20,DPD90+,0,0,0
2023-10-28,22,Current,0,0,0
2023-10-28,22,DPD15-29,1,1,0
2023-10-28,22,DPD3-14,2,2,0
2023-10-28,22,DPD30-59,0,0,0
2023-10-28,22,DPD60-89,1,1,0
2023-10-28,22,DPD90+,0,0,0
2023-10-28,24,Current,49,49,0
2023-10-28,24,DPD15-29,65,65,0
2023-10-28,24,DPD3-14,220,220,0
2023-10-28,24,DPD30-59,23,23,0
2023-10-28,24,DPD60-89,19,19,0
2023-10-28,24,DPD90+,19,19,0
2023-10-28,26,Current,3,3,0
2023-10-28,26,DPD15-29,13,13,0
2023-10-28,26,DPD3-14,43,43,0
2023-10-28,26,DPD30-59,4,4,0
2023-10-28,26,DPD60-89,3,3,0
2023-10-28,26,DPD90+,3,3,0
2023-10-28,32,Current,34,34,0
2023-10-28,32,DPD15-29,77,77,0
2023-10-28,32,DPD3-14,184,184,0
2023-10-28,32,DPD30-59,32,32,0
2023-10-28,32,DPD60-89,26,26,0
2023-10-28,32,DPD90+,26,26,0
2023-10-28,34,Current,15,15,0
2023-10-28,34,DPD15-29,44,44,0
2023-10-28,34,DPD3-14,78,78,0
2023-10-28,34,DPD30-59,20,20,0
2023-10-28,34,DPD60-89,9,9,0
2023-10-28,34,DPD90+,6,6,0
2023-10-28,36,Current,12,12,0
2023-10-28,36,DPD15-29,36,36,0
2023-10-28,36,DPD3-14,56,56,0
2023-10-28,36,DPD30-59,6,6,0
2023-10-28,36,DPD60-89,13,13,0
2023-10-28,36,DPD90+,6,6,0
2023-10-28,38,Current,12,12,0
2023-10-28,38,DPD15-29,28,28,0
2023-10-28,38,DPD3-14,58,58,0
2023-10-28,38,DPD30-59,5,5,0
2023-10-28,38,DPD60-89,6,6,0
2023-10-28,38,DPD90+,4,4,0
2023-10-28,40,Current,2,2,0
2023-10-28,40,DPD15-29,9,9,0
2023-10-28,40,DPD3-14,28,28,0
2023-10-28,40,DPD30-59,4,4,0
2023-10-28,40,DPD60-89,4,4,0
2023-10-28,40,DPD90+,5,5,0
2023-10-28,42,Current,6,6,0
2023-10-28,42,DPD15-29,4,4,0
2023-10-28,42,DPD3-14,19,19,0
2023-10-28,42,DPD30-59,6,6,0
2023-10-28,42,DPD60-89,4,4,0
2023-10-28,42,DPD90+,0,0,0
2023-10-28,44,Current,10,10,0
2023-10-28,44,DPD15-29,23,23,0
2023-10-28,44,DPD3-14,50,50,0
2023-10-28,44,DPD30-59,8,8,0
2023-10-28,44,DPD60-89,8,8,0
2023-10-28,44,DPD90+,3,3,0
2023-10-28,46,Current,0,0,0
2023-10-28,46,DPD15-29,1,1,0
2023-10-28,46,DPD3-14,0,0,0
2023-10-28,46,DPD30-59,0,0,0
2023-10-28,48,Current,23,23,0
2023-10-28,48,DPD15-29,10,10,0
2023-10-28,48,DPD3-14,19,19,0
2023-10-28,48,DPD30-59,1,1,0
2023-10-28,48,DPD60-89,1,1,0
2023-10-28,48,DPD90+,1,1,0
2023-10-28,6,Current,0,0,0
2023-10-28,6,DPD60-89,1,1,0
2023-10-28,6,DPD90+,0,0,0
2023-10-27,100,Current,0,0,0
2023-10-27,100,DPD15-29,0,0,0
2023-10-27,100,DPD3-14,0,0,0
2023-10-27,100,DPD90+,0,0,0
2023-10-27,102,Current,0,0,0
2023-10-27,102,DPD15-29,0,0,0
2023-10-27,102,DPD3-14,0,0,0
2023-10-27,102,DPD30-59,0,0,0
2023-10-27,102,DPD60-89,0,0,0
2023-10-27,104,Current,0,0,0
2023-10-27,104,DPD30-59,1,1,0
2023-10-27,104,DPD60-89,0,0,0
2023-10-27,20,Current,0,0,0
2023-10-27,20,DPD15-29,0,0,0
2023-10-27,20,DPD3-14,0,0,0
2023-10-27,20,DPD30-59,0,0,0
2023-10-27,20,DPD60-89,0,0,0
2023-10-27,20,DPD90+,0,0,0
2023-10-27,22,Current,0,0,0
2023-10-27,22,DPD15-29,1,1,0
2023-10-27,22,DPD3-14,1,1,0
2023-10-27,22,DPD30-59,0,0,0
2023-10-27,22,DPD60-89,0,0,0
2023-10-27,22,DPD90+,0,0,0
2023-10-27,24,Current,23,23,0
2023-10-27,24,DPD15-29,70,70,0
2023-10-27,24,DPD3-14,231,231,0
2023-10-27,24,DPD30-59,26,26,0
2023-10-27,24,DPD60-89,17,17,0
2023-10-27,24,DPD90+,10,10,0
2023-10-27,26,Current,4,4,0
2023-10-27,26,DPD15-29,14,14,0
2023-10-27,26,DPD3-14,41,41,0
2023-10-27,26,DPD30-59,3,3,0
2023-10-27,26,DPD60-89,1,1,0
2023-10-27,26,DPD90+,4,4,0
2023-10-27,32,Current,24,24,0
2023-10-27,32,DPD15-29,82,82,0
2023-10-27,32,DPD3-14,204,204,0
2023-10-27,32,DPD30-59,28,28,0
2023-10-27,32,DPD60-89,13,13,0
2023-10-27,32,DPD90+,16,16,0
2023-10-27,34,Current,6,6,0
2023-10-27,34,DPD15-29,38,38,0
2023-10-27,34,DPD3-14,70,70,0
2023-10-27,34,DPD30-59,17,17,0
2023-10-27,34,DPD60-89,5,5,0
2023-10-27,34,DPD90+,7,7,0
2023-10-27,36,Current,12,12,0
2023-10-27,36,DPD15-29,22,22,0
2023-10-27,36,DPD3-14,71,71,0
2023-10-27,36,DPD30-59,6,6,0
2023-10-27,36,DPD60-89,2,2,0
2023-10-27,36,DPD90+,7,7,0
2023-10-27,38,Current,3,3,0
2023-10-27,38,DPD15-29,19,19,0
2023-10-27,38,DPD3-14,59,59,0
2023-10-27,38,DPD30-59,6,6,0
2023-10-27,38,DPD60-89,2,2,0
2023-10-27,38,DPD90+,8,8,0
2023-10-27,40,Current,8,8,0
2023-10-27,40,DPD15-29,14,14,0
2023-10-27,40,DPD3-14,39,39,0
2023-10-27,40,DPD30-59,3,3,0
2023-10-27,40,DPD60-89,4,4,0
2023-10-27,40,DPD90+,4,4,0
2023-10-27,42,Current,2,2,0
2023-10-27,42,DPD15-29,6,6,0
2023-10-27,42,DPD3-14,14,14,0
2023-10-27,42,DPD30-59,3,3,0
2023-10-27,42,DPD60-89,1,1,0
2023-10-27,42,DPD90+,1,1,0
2023-10-27,44,Current,9,9,0
2023-10-27,44,DPD15-29,20,20,0
2023-10-27,44,DPD3-14,49,49,0
2023-10-27,44,DPD30-59,5,5,0
2023-10-27,44,DPD60-89,5,5,0
2023-10-27,44,DPD90+,2,2,0
2023-10-27,46,Current,0,0,0
2023-10-27,46,DPD15-29,1,1,0
2023-10-27,46,DPD3-14,0,0,0
2023-10-27,46,DPD30-59,0,0,0
2023-10-27,48,Current,1,1,0
2023-10-27,48,DPD15-29,9,9,0
2023-10-27,48,DPD3-14,18,18,0
2023-10-27,48,DPD30-59,0,0,0
2023-10-27,48,DPD60-89,1,1,0
2023-10-27,48,DPD90+,1,1,0
2023-10-27,6,Current,0,0,0
2023-10-27,6,DPD60-89,0,0,0
2023-10-27,6,DPD90+,0,0,0
2023-10-26,100,Current,0,0,0
2023-10-26,100,DPD15-29,1,1,0
2023-10-26,100,DPD3-14,1,1,0
2023-10-26,100,DPD90+,0,0,0
2023-10-26,102,Current,0,0,0
2023-10-26,102,DPD15-29,0,0,0
2023-10-26,102,DPD3-14,1,1,0
2023-10-26,102,DPD30-59,1,1,0
2023-10-26,102,DPD60-89,0,0,0
2023-10-26,104,Current,0,0,0
2023-10-26,104,DPD30-59,0,0,0
2023-10-26,104,DPD60-89,0,0,0
2023-10-26,20,Current,63,63,0
2023-10-26,20,DPD15-29,0,0,0
2023-10-26,20,DPD3-14,0,0,0
2023-10-26,20,DPD30-59,0,0,0
2023-10-26,20,DPD60-89,0,0,0
2023-10-26,20,DPD90+,0,0,0
2023-10-26,22,Current,0,0,0
2023-10-26,22,DPD15-29,1,1,0
2023-10-26,22,DPD3-14,2,2,0
2023-10-26,22,DPD30-59,0,0,0
2023-10-26,22,DPD60-89,1,1,0
2023-10-26,22,DPD90+,0,0,0
2023-10-26,24,Current,67,67,0
2023-10-26,24,DPD15-29,80,80,0
2023-10-26,24,DPD3-14,230,230,0
2023-10-26,24,DPD30-59,27,27,0
2023-10-26,24,DPD60-89,17,17,0
2023-10-26,24,DPD90+,18,18,0
2023-10-26,26,Current,2,2,0
2023-10-26,26,DPD15-29,15,15,0
2023-10-26,26,DPD3-14,36,36,0
2023-10-26,26,DPD30-59,4,4,0
2023-10-26,26,DPD60-89,4,4,0
2023-10-26,26,DPD90+,2,2,0
2023-10-26,32,Current,18,18,0
2023-10-26,32,DPD15-29,103,103,0
2023-10-26,32,DPD3-14,192,192,0
2023-10-26,32,DPD30-59,36,36,0
2023-10-26,32,DPD60-89,27,27,0
2023-10-26,32,DPD90+,28,28,0
2023-10-26,34,Current,5,5,0
2023-10-26,34,DPD15-29,50,50,0
2023-10-26,34,DPD3-14,91,91,0
2023-10-26,34,DPD30-59,21,21,0
2023-10-26,34,DPD60-89,7,7,0
2023-10-26,34,DPD90+,8,8,0
2023-10-26,36,Current,7,7,0
2023-10-26,36,DPD15-29,38,38,0
2023-10-26,36,DPD3-14,55,55,0
2023-10-26,36,DPD30-59,10,10,0
2023-10-26,36,DPD60-89,11,11,0
2023-10-26,36,DPD90+,6,6,0
2023-10-26,38,Current,6,6,0
2023-10-26,38,DPD15-29,30,30,0
2023-10-26,38,DPD3-14,55,55,0
2023-10-26,38,DPD30-59,6,6,0
2023-10-26,38,DPD60-89,7,7,0
2023-10-26,38,DPD90+,4,4,0
2023-10-26,40,Current,5,5,0
2023-10-26,40,DPD15-29,10,10,0
2023-10-26,40,DPD3-14,37,37,0
2023-10-26,40,DPD30-59,4,4,0
2023-10-26,40,DPD60-89,6,6,0
2023-10-26,40,DPD90+,4,4,0
2023-10-26,42,Current,0,0,0
2023-10-26,42,DPD15-29,9,9,0
2023-10-26,42,DPD3-14,21,21,0
2023-10-26,42,DPD30-59,6,6,0
2023-10-26,42,DPD60-89,3,3,0
2023-10-26,42,DPD90+,1,1,0
2023-10-26,44,Current,7,7,0
2023-10-26,44,DPD15-29,21,21,0
2023-10-26,44,DPD3-14,62,62,0
2023-10-26,44,DPD30-59,8,8,0
2023-10-26,44,DPD60-89,9,9,0
2023-10-26,44,DPD90+,2,2,0
2023-10-26,46,Current,0,0,0
2023-10-26,46,DPD15-29,1,1,0
2023-10-26,46,DPD3-14,0,0,0
2023-10-26,46,DPD60-89,0,0,0
2023-10-26,48,Current,46,46,0
2023-10-26,48,DPD15-29,12,12,0
2023-10-26,48,DPD3-14,20,20,0
2023-10-26,48,DPD30-59,1,1,0
2023-10-26,48,DPD60-89,1,1,0
2023-10-26,48,DPD90+,2,2,0
2023-10-26,6,Current,0,0,0
2023-10-26,6,DPD60-89,0,0,0
2023-10-26,6,DPD90+,0,0,0
2023-10-25,100,Current,0,0,0
2023-10-25,100,DPD15-29,0,0,0
2023-10-25,100,DPD3-14,0,0,0
2023-10-25,100,DPD90+,0,0,0
2023-10-25,102,Current,0,0,0
2023-10-25,102,DPD15-29,1,1,0
2023-10-25,102,DPD3-14,0,0,0
2023-10-25,102,DPD30-59,0,0,0
2023-10-25,102,DPD60-89,0,0,0
2023-10-25,104,Current,0,0,0
2023-10-25,104,DPD3-14,1,1,0
2023-10-25,104,DPD30-59,1,1,0
2023-10-25,104,DPD60-89,0,0,0
2023-10-25,20,Current,25,25,0
2023-10-25,20,DPD15-29,0,0,0
2023-10-25,20,DPD3-14,0,0,0
2023-10-25,20,DPD30-59,0,0,0
2023-10-25,20,DPD60-89,0,0,0
2023-10-25,20,DPD90+,0,0,0
2023-10-25,22,Current,0,0,0
2023-10-25,22,DPD15-29,1,1,0
2023-10-25,22,DPD3-14,0,0,0
2023-10-25,22,DPD30-59,0,0,0
2023-10-25,22,DPD60-89,0,0,0
2023-10-25,22,DPD90+,0,0,0
2023-10-25,24,Current,81,81,0
2023-10-25,24,DPD15-29,67,67,0
2023-10-25,24,DPD3-14,238,238,0
2023-10-25,24,DPD30-59,27,27,0
2023-10-25,24,DPD60-89,18,18,0
2023-10-25,24,DPD90+,10,10,0
2023-10-25,26,Current,5,5,0
2023-10-25,26,DPD15-29,16,16,0
2023-10-25,26,DPD3-14,42,42,0
2023-10-25,26,DPD30-59,3,3,0
2023-10-25,26,DPD60-89,1,1,0
2023-10-25,26,DPD90+,4,4,0
2023-10-25,32,Current,29,29,0
2023-10-25,32,DPD15-29,82,82,0
2023-10-25,32,DPD3-14,202,202,0
2023-10-25,32,DPD30-59,29,29,0
2023-10-25,32,DPD60-89,13,13,0
2023-10-25,32,DPD90+,17,17,0
2023-10-25,34,Current,12,12,0
2023-10-25,34,DPD15-29,36,36,0
2023-10-25,34,DPD3-14,69,69,0
2023-10-25,34,DPD30-59,18,18,0
2023-10-25,34,DPD60-89,5,5,0
2023-10-25,34,DPD90+,8,8,0
2023-10-25,36,Current,11,11,0
2023-10-25,36,DPD15-29,23,23,0
2023-10-25,36,DPD3-14,74,74,0
2023-10-25,36,DPD30-59,6,6,0
2023-10-25,36,DPD60-89,2,2,0
2023-10-25,36,DPD90+,7,7,0
2023-10-25,38,Current,16,16,0
2023-10-25,38,DPD15-29,17,17,0
2023-10-25,38,DPD3-14,56,56,0
2023-10-25,38,DPD30-59,7,7,0
2023-10-25,38,DPD60-89,5,5,0
2023-10-25,38,DPD90+,5,5,0
2023-10-25,40,Current,7,7,0
2023-10-25,40,DPD15-29,15,15,0
2023-10-25,40,DPD3-14,44,44,0
2023-10-25,40,DPD30-59,4,4,0
2023-10-25,40,DPD60-89,4,4,0
2023-10-25,40,DPD90+,3,3,0
2023-10-25,42,Current,5,5,0
2023-10-25,42,DPD15-29,7,7,0
2023-10-25,42,DPD3-14,17,17,0
2023-10-25,42,DPD30-59,5,5,0
2023-10-25,42,DPD60-89,1,1,0
2023-10-25,42,DPD90+,0,0,0
2023-10-25,44,Current,14,14,0
2023-10-25,44,DPD15-29,18,18,0
2023-10-25,44,DPD3-14,61,61,0
2023-10-25,44,DPD30-59,8,8,0
2023-10-25,44,DPD60-89,3,3,0
2023-10-25,44,DPD90+,2,2,0
2023-10-25,46,Current,0,0,0
2023-10-25,46,DPD15-29,0,0,0
2023-10-25,46,DPD3-14,0,0,0
2023-10-25,46,DPD30-59,0,0,0
2023-10-25,48,Current,22,22,0
2023-10-25,48,DPD15-29,9,9,0
2023-10-25,48,DPD3-14,16,16,0
2023-10-25,48,DPD30-59,0,0,0
2023-10-25,48,DPD60-89,1,1,0
2023-10-25,48,DPD90+,1,1,0
2023-10-25,6,Current,0,0,0
2023-10-25,6,DPD30-59,0,0,0
2023-10-25,6,DPD90+,0,0,0
2023-10-24,100,Current,1,1,0
2023-10-24,100,DPD15-29,1,1,0
2023-10-24,100,DPD3-14,1,1,0
2023-10-24,100,DPD90+,0,0,0
2023-10-24,102,Current,0,0,0
2023-10-24,102,DPD15-29,0,0,0
2023-10-24,102,DPD3-14,1,1,0
2023-10-24,102,DPD30-59,1,1,0
2023-10-24,104,Current,0,0,0
2023-10-24,104,DPD3-14,1,1,0
2023-10-24,104,DPD30-59,0,0,0
2023-10-24,104,DPD60-89,0,0,0
2023-10-24,20,Current,52,52,0
2023-10-24,20,DPD15-29,0,0,0
2023-10-24,20,DPD3-14,0,0,0
2023-10-24,20,DPD30-59,0,0,0
2023-10-24,20,DPD60-89,0,0,0
2023-10-24,20,DPD90+,0,0,0
2023-10-24,22,Current,0,0,0
2023-10-24,22,DPD15-29,1,1,0
2023-10-24,22,DPD3-14,2,2,0
2023-10-24,22,DPD30-59,1,1,0
2023-10-24,22,DPD60-89,0,0,0
2023-10-24,22,DPD90+,0,0,0
2023-10-24,24,Current,64,64,0
2023-10-24,24,DPD15-29,96,96,0
2023-10-24,24,DPD3-14,252,252,0
2023-10-24,24,DPD30-59,29,29,0
2023-10-24,24,DPD60-89,15,15,0
2023-10-24,24,DPD90+,18,18,0
2023-10-24,26,Current,5,5,0
2023-10-24,26,DPD15-29,19,19,0
2023-10-24,26,DPD3-14,34,34,0
2023-10-24,26,DPD30-59,6,6,0
2023-10-24,26,DPD60-89,4,4,0
2023-10-24,26,DPD90+,2,2,0
2023-10-24,32,Current,27,27,0
2023-10-24,32,DPD15-29,100,100,0
2023-10-24,32,DPD3-14,190,190,0
2023-10-24,32,DPD30-59,37,37,0
2023-10-24,32,DPD60-89,29,29,0
2023-10-24,32,DPD90+,22,22,0
2023-10-24,34,Current,5,5,0
2023-10-24,34,DPD15-29,52,52,0
2023-10-24,34,DPD3-14,93,93,0
2023-10-24,34,DPD30-59,23,23,0
2023-10-24,34,DPD60-89,8,8,0
2023-10-24,34,DPD90+,7,7,0
2023-10-24,36,Current,9,9,0
2023-10-24,36,DPD15-29,29,29,0
2023-10-24,36,DPD3-14,61,61,0
2023-10-24,36,DPD30-59,10,10,0
2023-10-24,36,DPD60-89,10,10,0
2023-10-24,36,DPD90+,6,6,0
2023-10-24,38,Current,12,12,0
2023-10-24,38,DPD15-29,32,32,0
2023-10-24,38,DPD3-14,60,60,0
2023-10-24,38,DPD30-59,3,3,0
2023-10-24,38,DPD60-89,6,6,0
2023-10-24,38,DPD90+,4,4,0
2023-10-24,40,Current,7,7,0
2023-10-24,40,DPD15-29,9,9,0
2023-10-24,40,DPD3-14,33,33,0
2023-10-24,40,DPD30-59,4,4,0
2023-10-24,40,DPD60-89,5,5,0
2023-10-24,40,DPD90+,4,4,0
2023-10-24,42,Current,6,6,0
2023-10-24,42,DPD15-29,11,11,0
2023-10-24,42,DPD3-14,25,25,0
2023-10-24,42,DPD30-59,8,8,0
2023-10-24,42,DPD60-89,4,4,0
2023-10-24,42,DPD90+,1,1,0
2023-10-24,44,Current,17,17,0
2023-10-24,44,DPD15-29,16,16,0
2023-10-24,44,DPD3-14,60,60,0
2023-10-24,44,DPD30-59,8,8,0
2023-10-24,44,DPD60-89,9,9,0
2023-10-24,44,DPD90+,2,2,0
2023-10-24,46,Current,0,0,0
2023-10-24,46,DPD15-29,1,1,0
2023-10-24,46,DPD3-14,0,0,0
2023-10-24,46,DPD30-59,0,0,0
2023-10-24,48,Current,37,37,0
2023-10-24,48,DPD15-29,13,13,0
2023-10-24,48,DPD3-14,21,21,0
2023-10-24,48,DPD30-59,2,2,0
2023-10-24,48,DPD60-89,0,0,0
2023-10-24,48,DPD90+,2,2,0
2023-10-24,6,Current,0,0,0
2023-10-24,6,DPD30-59,1,1,0
2023-10-24,6,DPD90+,0,0,0
2023-10-23,100,Current,0,0,0
2023-10-23,100,DPD15-29,0,0,0
2023-10-23,100,DPD3-14,0,0,0
2023-10-23,100,DPD60-89,0,0,0
2023-10-23,100,DPD90+,0,0,0
2023-10-23,102,Current,0,0,0
2023-10-23,102,DPD15-29,1,1,0
2023-10-23,102,DPD3-14,0,0,0
2023-10-23,102,DPD30-59,0,0,0
2023-10-23,104,Current,0,0,0
2023-10-23,104,DPD3-14,1,1,0
2023-10-23,104,DPD30-59,1,1,0
2023-10-23,104,DPD60-89,0,0,0
2023-10-23,20,Current,51,51,0
2023-10-23,20,DPD15-29,0,0,0
2023-10-23,20,DPD3-14,1,1,0
2023-10-23,20,DPD30-59,0,0,0
2023-10-23,20,DPD60-89,0,0,0
2023-10-23,20,DPD90+,0,0,0
2023-10-23,22,Current,0,0,0
2023-10-23,22,DPD15-29,1,1,0
2023-10-23,22,DPD3-14,0,0,0
2023-10-23,22,DPD30-59,0,0,0
2023-10-23,22,DPD60-89,0,0,0
2023-10-23,22,DPD90+,0,0,0
2023-10-23,24,Current,48,48,0
2023-10-23,24,DPD15-29,76,76,0
2023-10-23,24,DPD3-14,214,214,0
2023-10-23,24,DPD30-59,28,28,0
2023-10-23,24,DPD60-89,21,21,0
2023-10-23,24,DPD90+,9,9,0
2023-10-23,26,Current,3,3,0
2023-10-23,26,DPD15-29,17,17,0
2023-10-23,26,DPD3-14,29,29,0
2023-10-23,26,DPD30-59,2,2,0
2023-10-23,26,DPD60-89,1,1,0
2023-10-23,26,DPD90+,4,4,0
2023-10-23,32,Current,5,5,0
2023-10-23,32,DPD15-29,88,88,0
2023-10-23,32,DPD3-14,181,181,0
2023-10-23,32,DPD30-59,22,22,0
2023-10-23,32,DPD60-89,12,12,0
2023-10-23,32,DPD90+,18,18,0
2023-10-23,34,Current,0,0,0
2023-10-23,34,DPD15-29,42,42,0
2023-10-23,34,DPD3-14,72,72,0
2023-10-23,34,DPD30-59,15,15,0
2023-10-23,34,DPD60-89,5,5,0
2023-10-23,34,DPD90+,8,8,0
2023-10-23,36,Current,4,4,0
2023-10-23,36,DPD15-29,26,26,0
2023-10-23,36,DPD3-14,61,61,0
2023-10-23,36,DPD30-59,5,5,0
2023-10-23,36,DPD60-89,2,2,0
2023-10-23,36,DPD90+,8,8,0
2023-10-23,38,Current,2,2,0
2023-10-23,38,DPD15-29,24,24,0
2023-10-23,38,DPD3-14,45,45,0
2023-10-23,38,DPD30-59,9,9,0
2023-10-23,38,DPD60-89,4,4,0
2023-10-23,38,DPD90+,5,5,0
2023-10-23,40,Current,7,7,0
2023-10-23,40,DPD15-29,14,14,0
2023-10-23,40,DPD3-14,47,47,0
2023-10-23,40,DPD30-59,3,3,0
2023-10-23,40,DPD60-89,4,4,0
2023-10-23,40,DPD90+,4,4,0
2023-10-23,42,Current,2,2,0
2023-10-23,42,DPD15-29,9,9,0
2023-10-23,42,DPD3-14,19,19,0
2023-10-23,42,DPD30-59,4,4,0
2023-10-23,42,DPD60-89,1,1,0
2023-10-23,42,DPD90+,0,0,0
2023-10-23,44,Current,5,5,0
2023-10-23,44,DPD15-29,16,16,0
2023-10-23,44,DPD3-14,72,72,0
2023-10-23,44,DPD30-59,7,7,0
2023-10-23,44,DPD60-89,3,3,0
2023-10-23,44,DPD90+,3,3,0
2023-10-23,46,Current,0,0,0
2023-10-23,46,DPD15-29,0,0,0
2023-10-23,46,DPD3-14,0,0,0
2023-10-23,46,DPD30-59,0,0,0
2023-10-23,48,Current,23,23,0
2023-10-23,48,DPD15-29,7,7,0
2023-10-23,48,DPD3-14,21,21,0
2023-10-23,48,DPD30-59,0,0,0
2023-10-23,48,DPD60-89,1,1,0
2023-10-23,48,DPD90+,1,1,0
2023-10-23,6,Current,0,0,0
2023-10-23,6,DPD30-59,0,0,0
2023-10-23,6,DPD90+,0,0,0
2023-10-22,100,Current,0,0,0
2023-10-22,100,DPD15-29,2,2,0
2023-10-22,100,DPD3-14,1,1,0
2023-10-22,100,DPD60-89,0,0,0
2023-10-22,100,DPD90+,0,0,0
2023-10-22,102,Current,0,0,0
2023-10-22,102,DPD15-29,0,0,0
2023-10-22,102,DPD3-14,1,1,0
2023-10-22,102,DPD30-59,1,1,0
2023-10-22,104,Current,0,0,0
2023-10-22,104,DPD3-14,0,0,0
2023-10-22,104,DPD30-59,0,0,0
2023-10-22,104,DPD60-89,0,0,0
2023-10-22,20,Current,37,37,0
2023-10-22,20,DPD15-29,0,0,0
2023-10-22,20,DPD3-14,0,0,0
2023-10-22,20,DPD30-59,0,0,0
2023-10-22,20,DPD60-89,0,0,0
2023-10-22,20,DPD90+,0,0,0
2023-10-22,22,Current,0,0,0
2023-10-22,22,DPD15-29,1,1,0
2023-10-22,22,DPD3-14,1,1,0
2023-10-22,22,DPD30-59,1,1,0
2023-10-22,22,DPD60-89,0,0,0
2023-10-22,22,DPD90+,0,0,0
2023-10-22,24,Current,12,12,0
2023-10-22,24,DPD15-29,99,99,0
2023-10-22,24,DPD3-14,227,227,0
2023-10-22,24,DPD30-59,25,25,0
2023-10-22,24,DPD60-89,16,16,0
2023-10-22,24,DPD90+,20,20,0
2023-10-22,26,Current,0,0,0
2023-10-22,26,DPD15-29,17,17,0
2023-10-22,26,DPD3-14,37,37,0
2023-10-22,26,DPD30-59,6,6,0
2023-10-22,26,DPD60-89,4,4,0
2023-10-22,26,DPD90+,2,2,0
2023-10-22,32,Current,1,1,0
2023-10-22,32,DPD15-29,119,119,0
2023-10-22,32,DPD3-14,196,196,0
2023-10-22,32,DPD30-59,31,31,0
2023-10-22,32,DPD60-89,30,30,0
2023-10-22,32,DPD90+,23,23,0
2023-10-22,34,Current,0,0,0
2023-10-22,34,DPD15-29,48,48,0
2023-10-22,34,DPD3-14,101,101,0
2023-10-22,34,DPD30-59,19,19,0
2023-10-22,34,DPD60-89,9,9,0
2023-10-22,34,DPD90+,8,8,0
2023-10-22,36,Current,0,0,0
2023-10-22,36,DPD15-29,32,32,0
2023-10-22,36,DPD3-14,65,65,0
2023-10-22,36,DPD30-59,9,9,0
2023-10-22,36,DPD60-89,9,9,0
2023-10-22,36,DPD90+,6,6,0
2023-10-22,38,Current,0,0,0
2023-10-22,38,DPD15-29,31,31,0
2023-10-22,38,DPD3-14,61,61,0
2023-10-22,38,DPD30-59,5,5,0
2023-10-22,38,DPD60-89,5,5,0
2023-10-22,38,DPD90+,5,5,0
2023-10-22,40,Current,0,0,0
2023-10-22,40,DPD15-29,7,7,0
2023-10-22,40,DPD3-14,35,35,0
2023-10-22,40,DPD30-59,4,4,0
2023-10-22,40,DPD60-89,5,5,0
2023-10-22,40,DPD90+,4,4,0
2023-10-22,42,Current,0,0,0
2023-10-22,42,DPD15-29,11,11,0
2023-10-22,42,DPD3-14,28,28,0
2023-10-22,42,DPD30-59,7,7,0
2023-10-22,42,DPD60-89,4,4,0
2023-10-22,42,DPD90+,1,1,0
2023-10-22,44,Current,0,0,0
2023-10-22,44,DPD15-29,11,11,0
2023-10-22,44,DPD3-14,70,70,0
2023-10-22,44,DPD30-59,6,6,0
2023-10-22,44,DPD60-89,9,9,0
2023-10-22,44,DPD90+,1,1,0
2023-10-22,46,Current,0,0,0
2023-10-22,46,DPD15-29,0,0,0
2023-10-22,46,DPD3-14,1,1,0
2023-10-22,46,DPD30-59,0,0,0
2023-10-22,48,Current,20,20,0
2023-10-22,48,DPD15-29,10,10,0
2023-10-22,48,DPD3-14,28,28,0
2023-10-22,48,DPD30-59,2,2,0
2023-10-22,48,DPD60-89,0,0,0
2023-10-22,48,DPD90+,2,2,0
2023-10-22,6,Current,0,0,0
2023-10-22,6,DPD30-59,1,1,0
2023-10-22,6,DPD60-89,0,0,0
2023-10-21,100,Current,0,0,0
2023-10-21,100,DPD15-29,0,0,0
2023-10-21,100,DPD3-14,0,0,0
2023-10-21,100,DPD60-89,0,0,0
2023-10-21,100,DPD90+,0,0,0
2023-10-21,102,Current,0,0,0
2023-10-21,102,DPD15-29,1,1,0
2023-10-21,102,DPD3-14,0,0,0
2023-10-21,102,DPD30-59,0,0,0
2023-10-21,104,Current,0,0,0
2023-10-21,104,DPD3-14,0,0,0
2023-10-21,104,DPD30-59,1,1,0
2023-10-21,104,DPD60-89,0,0,0
2023-10-21,20,Current,23,23,0
2023-10-21,20,DPD15-29,0,0,0
2023-10-21,20,DPD3-14,0,0,0
2023-10-21,20,DPD30-59,0,0,0
2023-10-21,20,DPD60-89,0,0,0
2023-10-21,20,DPD90+,0,0,0
2023-10-21,22,Current,0,0,0
2023-10-21,22,DPD15-29,0,0,0
2023-10-21,22,DPD3-14,1,1,0
2023-10-21,22,DPD30-59,0,0,0
2023-10-21,22,DPD60-89,0,0,0
2023-10-21,22,DPD90+,0,0,0
2023-10-21,24,Current,52,52,0
2023-10-21,24,DPD15-29,79,79,0
2023-10-21,24,DPD3-14,173,173,0
2023-10-21,24,DPD30-59,25,25,0
2023-10-21,24,DPD60-89,20,20,0
2023-10-21,24,DPD90+,8,8,0
2023-10-21,26,Current,5,5,0
2023-10-21,26,DPD15-29,15,15,0
2023-10-21,26,DPD3-14,30,30,0
2023-10-21,26,DPD30-59,4,4,0
2023-10-21,26,DPD60-89,1,1,0
2023-10-21,26,DPD90+,4,4,0
2023-10-21,32,Current,34,34,0
2023-10-21,32,DPD15-29,82,82,0
2023-10-21,32,DPD3-14,149,149,0
2023-10-21,32,DPD30-59,24,24,0
2023-10-21,32,DPD60-89,12,12,0
2023-10-21,32,DPD90+,22,22,0
2023-10-21,34,Current,16,16,0
2023-10-21,34,DPD15-29,40,40,0
2023-10-21,34,DPD3-14,57,57,0
2023-10-21,34,DPD30-59,15,15,0
2023-10-21,34,DPD60-89,6,6,0
2023-10-21,34,DPD90+,8,8,0
2023-10-21,36,Current,11,11,0
2023-10-21,36,DPD15-29,25,25,0
2023-10-21,36,DPD3-14,59,59,0
2023-10-21,36,DPD30-59,5,5,0
2023-10-21,36,DPD60-89,3,3,0
2023-10-21,36,DPD90+,7,7,0
2023-10-21,38,Current,8,8,0
2023-10-21,38,DPD15-29,21,21,0
2023-10-21,38,DPD3-14,39,39,0
2023-10-21,38,DPD30-59,10,10,0
2023-10-21,38,DPD60-89,6,6,0
2023-10-21,38,DPD90+,4,4,0
2023-10-21,40,Current,9,9,0
2023-10-21,40,DPD15-29,15,15,0
2023-10-21,40,DPD3-14,37,37,0
2023-10-21,40,DPD30-59,5,5,0
2023-10-21,40,DPD60-89,3,3,0
2023-10-21,40,DPD90+,4,4,0
2023-10-21,42,Current,5,5,0
2023-10-21,42,DPD15-29,9,9,0
2023-10-21,42,DPD3-14,14,14,0
2023-10-21,42,DPD30-59,3,3,0
2023-10-21,42,DPD60-89,1,1,0
2023-10-21,42,DPD90+,0,0,0
2023-10-21,44,Current,4,4,0
2023-10-21,44,DPD15-29,14,14,0
2023-10-21,44,DPD3-14,60,60,0
2023-10-21,44,DPD30-59,8,8,0
2023-10-21,44,DPD60-89,3,3,0
2023-10-21,44,DPD90+,3,3,0
2023-10-21,46,Current,0,0,0
2023-10-21,46,DPD3-14,0,0,0
2023-10-21,46,DPD30-59,0,0,0
2023-10-21,48,Current,17,17,0
2023-10-21,48,DPD15-29,7,7,0
2023-10-21,48,DPD3-14,20,20,0
2023-10-21,48,DPD30-59,1,1,0
2023-10-21,48,DPD60-89,1,1,0
2023-10-21,48,DPD90+,1,1,0
2023-10-21,6,Current,0,0,0
2023-10-21,6,DPD30-59,0,0,0
2023-10-21,6,DPD60-89,0,0,0
2023-10-20,100,Current,0,0,0
2023-10-20,100,DPD15-29,1,1,0
2023-10-20,100,DPD3-14,2,2,0
2023-10-20,100,DPD60-89,0,0,0
2023-10-20,100,DPD90+,0,0,0
2023-10-20,102,Current,0,0,0
2023-10-20,102,DPD15-29,0,0,0
2023-10-20,102,DPD3-14,1,1,0
2023-10-20,102,DPD30-59,1,1,0
2023-10-20,104,Current,0,0,0
2023-10-20,104,DPD30-59,0,0,0
2023-10-20,104,DPD60-89,0,0,0
2023-10-20,20,Current,535,535,0
2023-10-20,20,DPD15-29,0,0,0
2023-10-20,20,DPD3-14,4,4,0
2023-10-20,20,DPD30-59,0,0,0
2023-10-20,20,DPD60-89,0,0,0
2023-10-20,20,DPD90+,0,0,0
2023-10-20,22,Current,0,0,0
2023-10-20,22,DPD15-29,0,0,0
2023-10-20,22,DPD3-14,2,2,0
2023-10-20,22,DPD30-59,1,1,0
2023-10-20,22,DPD60-89,0,0,0
2023-10-20,22,DPD90+,0,0,0
2023-10-20,24,Current,399,399,0
2023-10-20,24,DPD15-29,96,96,0
2023-10-20,24,DPD3-14,231,231,0
2023-10-20,24,DPD30-59,26,26,0
2023-10-20,24,DPD60-89,19,19,0
2023-10-20,24,DPD90+,19,19,0
2023-10-20,26,Current,52,52,0
2023-10-20,26,DPD15-29,16,16,0
2023-10-20,26,DPD3-14,36,36,0
2023-10-20,26,DPD30-59,6,6,0
2023-10-20,26,DPD60-89,6,6,0
2023-10-20,26,DPD90+,1,1,0
2023-10-20,32,Current,213,213,0
2023-10-20,32,DPD15-29,131,131,0
2023-10-20,32,DPD3-14,188,188,0
2023-10-20,32,DPD30-59,33,33,0
2023-10-20,32,DPD60-89,26,26,0
2023-10-20,32,DPD90+,23,23,0
2023-10-20,34,Current,89,89,0
2023-10-20,34,DPD15-29,50,50,0
2023-10-20,34,DPD3-14,90,90,0
2023-10-20,34,DPD30-59,22,22,0
2023-10-20,34,DPD60-89,6,6,0
2023-10-20,34,DPD90+,11,11,0
2023-10-20,36,Current,79,79,0
2023-10-20,36,DPD15-29,36,36,0
2023-10-20,36,DPD3-14,69,69,0
2023-10-20,36,DPD30-59,10,10,0
2023-10-20,36,DPD60-89,10,10,0
2023-10-20,36,DPD90+,5,5,0
2023-10-20,38,Current,67,67,0
2023-10-20,38,DPD15-29,31,31,0
2023-10-20,38,DPD3-14,69,69,0
2023-10-20,38,DPD30-59,5,5,0
2023-10-20,38,DPD60-89,7,7,0
2023-10-20,38,DPD90+,5,5,0
2023-10-20,40,Current,55,55,0
2023-10-20,40,DPD15-29,9,9,0
2023-10-20,40,DPD3-14,43,43,0
2023-10-20,40,DPD30-59,6,6,0
2023-10-20,40,DPD60-89,5,5,0
2023-10-20,40,DPD90+,4,4,0
2023-10-20,42,Current,31,31,0
2023-10-20,42,DPD15-29,12,12,0
2023-10-20,42,DPD3-14,30,30,0
2023-10-20,42,DPD30-59,7,7,0
2023-10-20,42,DPD60-89,4,4,0
2023-10-20,42,DPD90+,1,1,0
2023-10-20,44,Current,72,72,0
2023-10-20,44,DPD15-29,14,14,0
2023-10-20,44,DPD3-14,69,69,0
2023-10-20,44,DPD30-59,6,6,0
2023-10-20,44,DPD60-89,9,9,0
2023-10-20,44,DPD90+,1,1,0
2023-10-20,46,Current,0,0,0
2023-10-20,46,DPD3-14,1,1,0
2023-10-20,46,DPD30-59,0,0,0
2023-10-20,48,Current,93,93,0
2023-10-20,48,DPD15-29,7,7,0
2023-10-20,48,DPD3-14,34,34,0
2023-10-20,48,DPD30-59,2,2,0
2023-10-20,48,DPD60-89,0,0,0
2023-10-20,48,DPD90+,2,2,0
2023-10-20,6,Current,0,0,0
2023-10-20,6,DPD30-59,1,1,0
2023-10-20,6,DPD60-89,0,0,0
2023-10-19,100,Current,0,0,0
2023-10-19,100,DPD15-29,0,0,0
2023-10-19,100,DPD3-14,0,0,0
2023-10-19,100,DPD60-89,0,0,0
2023-10-19,100,DPD90+,0,0,0
2023-10-19,102,Current,0,0,0
2023-10-19,102,DPD15-29,1,1,0
2023-10-19,102,DPD3-14,0,0,0
2023-10-19,102,DPD30-59,0,0,0
2023-10-19,104,Current,0,0,0
2023-10-19,104,DPD30-59,0,0,0
2023-10-19,104,DPD60-89,0,0,0
2023-10-19,20,Current,59,59,0
2023-10-19,20,DPD15-29,0,0,0
2023-10-19,20,DPD3-14,0,0,0
2023-10-19,20,DPD30-59,0,0,0
2023-10-19,20,DPD60-89,0,0,0
2023-10-19,20,DPD90+,0,0,0
2023-10-19,22,Current,0,0,0
2023-10-19,22,DPD15-29,0,0,0
2023-10-19,22,DPD3-14,1,1,0
2023-10-19,22,DPD30-59,0,0,0
2023-10-19,22,DPD60-89,0,0,0
2023-10-19,22,DPD90+,0,0,0
2023-10-19,24,Current,59,59,0
2023-10-19,24,DPD15-29,94,94,0
2023-10-19,24,DPD3-14,164,164,0
2023-10-19,24,DPD30-59,31,31,0
2023-10-19,24,DPD60-89,16,16,0
2023-10-19,24,DPD90+,8,8,0
2023-10-19,26,Current,2,2,0
2023-10-19,26,DPD15-29,17,17,0
2023-10-19,26,DPD3-14,24,24,0
2023-10-19,26,DPD30-59,4,4,0
2023-10-19,26,DPD60-89,2,2,0
2023-10-19,26,DPD90+,3,3,0
2023-10-19,32,Current,11,11,0
2023-10-19,32,DPD15-29,102,102,0
2023-10-19,32,DPD3-14,121,121,0
2023-10-19,32,DPD30-59,27,27,0
2023-10-19,32,DPD60-89,16,16,0
2023-10-19,32,DPD90+,19,19,0
2023-10-19,34,Current,7,7,0
2023-10-19,34,DPD15-29,47,47,0
2023-10-19,34,DPD3-14,69,69,0
2023-10-19,34,DPD30-59,14,14,0
2023-10-19,34,DPD60-89,6,6,0
2023-10-19,34,DPD90+,8,8,0
2023-10-19,36,Current,5,5,0
2023-10-19,36,DPD15-29,31,31,0
2023-10-19,36,DPD3-14,43,43,0
2023-10-19,36,DPD30-59,6,6,0
2023-10-19,36,DPD60-89,3,3,0
2023-10-19,36,DPD90+,7,7,0
2023-10-19,38,Current,2,2,0
2023-10-19,38,DPD15-29,26,26,0
2023-10-19,38,DPD3-14,32,32,0
2023-10-19,38,DPD30-59,9,9,0
2023-10-19,38,DPD60-89,5,5,0
2023-10-19,38,DPD90+,4,4,0
2023-10-19,40,Current,2,2,0
2023-10-19,40,DPD15-29,16,16,0
2023-10-19,40,DPD3-14,37,37,0
2023-10-19,40,DPD30-59,5,5,0
2023-10-19,40,DPD60-89,4,4,0
2023-10-19,40,DPD90+,3,3,0
2023-10-19,42,Current,3,3,0
2023-10-19,42,DPD15-29,14,14,0
2023-10-19,42,DPD3-14,12,12,0
2023-10-19,42,DPD30-59,2,2,0
2023-10-19,42,DPD60-89,1,1,0
2023-10-19,42,DPD90+,0,0,0
2023-10-19,44,Current,9,9,0
2023-10-19,44,DPD15-29,18,18,0
2023-10-19,44,DPD3-14,41,41,0
2023-10-19,44,DPD30-59,7,7,0
2023-10-19,44,DPD60-89,3,3,0
2023-10-19,44,DPD90+,3,3,0
2023-10-19,46,Current,0,0,0
2023-10-19,46,DPD3-14,1,1,0
2023-10-19,46,DPD30-59,0,0,0
2023-10-19,48,Current,59,59,0
2023-10-19,48,DPD15-29,7,7,0
2023-10-19,48,DPD3-14,16,16,0
2023-10-19,48,DPD30-59,1,1,0
2023-10-19,48,DPD60-89,1,1,0
2023-10-19,48,DPD90+,1,1,0
2023-10-19,6,Current,0,0,0
2023-10-19,6,DPD30-59,0,0,0
2023-10-19,6,DPD60-89,0,0,0
2023-10-18,100,Current,0,0,0
2023-10-18,100,DPD15-29,0,0,0
2023-10-18,100,DPD3-14,2,2,0
2023-10-18,100,DPD60-89,0,0,0
2023-10-18,100,DPD90+,0,0,0
2023-10-18,102,Current,0,0,0
2023-10-18,102,DPD15-29,0,0,0
2023-10-18,102,DPD3-14,0,0,0
2023-10-18,102,DPD30-59,1,1,0
2023-10-18,104,Current,0,0,0
2023-10-18,104,DPD30-59,0,0,0
2023-10-18,104,DPD60-89,0,0,0
2023-10-18,20,Current,112,112,0
2023-10-18,20,DPD15-29,0,0,0
2023-10-18,20,DPD3-14,0,0,0
2023-10-18,20,DPD30-59,0,0,0
2023-10-18,20,DPD60-89,0,0,0
2023-10-18,20,DPD90+,0,0,0
2023-10-18,22,Current,1,1,0
2023-10-18,22,DPD15-29,0,0,0
2023-10-18,22,DPD3-14,2,2,0
2023-10-18,22,DPD30-59,1,1,0
2023-10-18,22,DPD60-89,0,0,0
2023-10-18,22,DPD90+,0,0,0
2023-10-18,24,Current,109,109,0
2023-10-18,24,DPD15-29,91,91,0
2023-10-18,24,DPD3-14,136,136,0
2023-10-18,24,DPD30-59,26,26,0
2023-10-18,24,DPD60-89,21,21,0
2023-10-18,24,DPD90+,18,18,0
2023-10-18,26,Current,9,9,0
2023-10-18,26,DPD15-29,20,20,0
2023-10-18,26,DPD3-14,18,18,0
2023-10-18,26,DPD30-59,5,5,0
2023-10-18,26,DPD60-89,6,6,0
2023-10-18,26,DPD90+,1,1,0
2023-10-18,32,Current,28,28,0
2023-10-18,32,DPD15-29,148,148,0
2023-10-18,32,DPD3-14,107,107,0
2023-10-18,32,DPD30-59,36,36,0
2023-10-18,32,DPD60-89,26,26,0
2023-10-18,32,DPD90+,23,23,0
2023-10-18,34,Current,10,10,0
2023-10-18,34,DPD15-29,57,57,0
2023-10-18,34,DPD3-14,54,54,0
2023-10-18,34,DPD30-59,17,17,0
2023-10-18,34,DPD60-89,6,6,0
2023-10-18,34,DPD90+,10,10,0
2023-10-18,36,Current,13,13,0
2023-10-18,36,DPD15-29,35,35,0
2023-10-18,36,DPD3-14,53,53,0
2023-10-18,36,DPD30-59,13,13,0
2023-10-18,36,DPD60-89,8,8,0
2023-10-18,36,DPD90+,5,5,0
2023-10-18,38,Current,14,14,0
2023-10-18,38,DPD15-29,36,36,0
2023-10-18,38,DPD3-14,38,38,0
2023-10-18,38,DPD30-59,4,4,0
2023-10-18,38,DPD60-89,8,8,0
2023-10-18,38,DPD90+,5,5,0
2023-10-18,40,Current,22,22,0
2023-10-18,40,DPD15-29,14,14,0
2023-10-18,40,DPD3-14,24,24,0
2023-10-18,40,DPD30-59,7,7,0
2023-10-18,40,DPD60-89,4,4,0
2023-10-18,40,DPD90+,4,4,0
2023-10-18,42,Current,3,3,0
2023-10-18,42,DPD15-29,12,12,0
2023-10-18,42,DPD3-14,16,16,0
2023-10-18,42,DPD30-59,8,8,0
2023-10-18,42,DPD60-89,3,3,0
2023-10-18,42,DPD90+,3,3,0
2023-10-18,44,Current,18,18,0
2023-10-18,44,DPD15-29,22,22,0
2023-10-18,44,DPD3-14,36,36,0
2023-10-18,44,DPD30-59,7,7,0
2023-10-18,44,DPD60-89,7,7,0
2023-10-18,44,DPD90+,2,2,0
2023-10-18,46,Current,0,0,0
2023-10-18,46,DPD3-14,1,1,0
2023-10-18,46,DPD30-59,0,0,0
2023-10-18,48,Current,53,53,0
2023-10-18,48,DPD15-29,4,4,0
2023-10-18,48,DPD3-14,20,20,0
2023-10-18,48,DPD30-59,3,3,0
2023-10-18,48,DPD60-89,0,0,0
2023-10-18,48,DPD90+,2,2,0
2023-10-18,6,Current,0,0,0
2023-10-18,6,DPD30-59,1,1,0
2023-10-18,6,DPD60-89,0,0,0
2023-10-17,100,Current,0,0,0
2023-10-17,100,DPD15-29,0,0,0
2023-10-17,100,DPD3-14,0,0,0
2023-10-17,100,DPD60-89,0,0,0
2023-10-17,100,DPD90+,0,0,0
2023-10-17,102,Current,0,0,0
2023-10-17,102,DPD15-29,0,0,0
2023-10-17,102,DPD3-14,0,0,0
2023-10-17,102,DPD30-59,0,0,0
2023-10-17,104,Current,0,0,0
2023-10-17,104,DPD15-29,1,1,0
2023-10-17,104,DPD30-59,0,0,0
2023-10-17,104,DPD60-89,0,0,0
2023-10-17,20,Current,49,49,0
2023-10-17,20,DPD15-29,0,0,0
2023-10-17,20,DPD3-14,0,0,0
2023-10-17,20,DPD30-59,0,0,0
2023-10-17,20,DPD60-89,0,0,0
2023-10-17,20,DPD90+,0,0,0
2023-10-17,22,Current,2,2,0
2023-10-17,22,DPD15-29,0,0,0
2023-10-17,22,DPD3-14,1,1,0
2023-10-17,22,DPD30-59,0,0,0
2023-10-17,22,DPD60-89,0,0,0
2023-10-17,22,DPD90+,0,0,0
2023-10-17,24,Current,75,75,0
2023-10-17,24,DPD15-29,68,68,0
2023-10-17,24,DPD3-14,153,153,0
2023-10-17,24,DPD30-59,23,23,0
2023-10-17,24,DPD60-89,12,12,0
2023-10-17,24,DPD90+,8,8,0
2023-10-17,26,Current,7,7,0
2023-10-17,26,DPD15-29,9,9,0
2023-10-17,26,DPD3-14,22,22,0
2023-10-17,26,DPD30-59,2,2,0
2023-10-17,26,DPD60-89,2,2,0
2023-10-17,26,DPD90+,2,2,0
2023-10-17,32,Current,26,26,0
2023-10-17,32,DPD15-29,85,85,0
2023-10-17,32,DPD3-14,110,110,0
2023-10-17,32,DPD30-59,23,23,0
2023-10-17,32,DPD60-89,7,7,0
2023-10-17,32,DPD90+,16,16,0
2023-10-17,34,Current,6,6,0
2023-10-17,34,DPD15-29,41,41,0
2023-10-17,34,DPD3-14,51,51,0
2023-10-17,34,DPD30-59,9,9,0
2023-10-17,34,DPD60-89,4,4,0
2023-10-17,34,DPD90+,9,9,0
2023-10-17,36,Current,15,15,0
2023-10-17,36,DPD15-29,18,18,0
2023-10-17,36,DPD3-14,41,41,0
2023-10-17,36,DPD30-59,4,4,0
2023-10-17,36,DPD60-89,4,4,0
2023-10-17,36,DPD90+,6,6,0
2023-10-17,38,Current,15,15,0
2023-10-17,38,DPD15-29,19,19,0
2023-10-17,38,DPD3-14,30,30,0
2023-10-17,38,DPD30-59,6,6,0
2023-10-17,38,DPD60-89,3,3,0
2023-10-17,38,DPD90+,1,1,0
2023-10-17,40,Current,6,6,0
2023-10-17,40,DPD15-29,13,13,0
2023-10-17,40,DPD3-14,20,20,0
2023-10-17,40,DPD30-59,3,3,0
2023-10-17,40,DPD60-89,2,2,0
2023-10-17,40,DPD90+,2,2,0
2023-10-17,42,Current,3,3,0
2023-10-17,42,DPD15-29,13,13,0
2023-10-17,42,DPD3-14,8,8,0
2023-10-17,42,DPD30-59,5,5,0
2023-10-17,42,DPD60-89,1,1,0
2023-10-17,42,DPD90+,0,0,0
2023-10-17,44,Current,9,9,0
2023-10-17,44,DPD15-29,16,16,0
2023-10-17,44,DPD3-14,38,38,0
2023-10-17,44,DPD30-59,5,5,0
2023-10-17,44,DPD60-89,2,2,0
2023-10-17,44,DPD90+,2,2,0
2023-10-17,46,Current,0,0,0
2023-10-17,46,DPD3-14,0,0,0
2023-10-17,46,DPD30-59,0,0,0
2023-10-17,48,Current,29,29,0
2023-10-17,48,DPD15-29,2,2,0
2023-10-17,48,DPD3-14,18,18,0
2023-10-17,48,DPD30-59,2,2,0
2023-10-17,48,DPD60-89,0,0,0
2023-10-17,48,DPD90+,0,0,0
2023-10-17,6,Current,0,0,0
2023-10-17,6,DPD30-59,0,0,0
2023-10-17,6,DPD60-89,0,0,0
2023-10-16,100,Current,0,0,0
2023-10-16,100,DPD15-29,0,0,0
2023-10-16,100,DPD3-14,2,2,0
2023-10-16,100,DPD60-89,0,0,0
2023-10-16,100,DPD90+,0,0,0
2023-10-16,102,Current,0,0,0
2023-10-16,102,DPD15-29,0,0,0
2023-10-16,102,DPD3-14,1,1,0
2023-10-16,102,DPD30-59,1,1,0
2023-10-16,104,Current,0,0,0
2023-10-16,104,DPD15-29,0,0,0
2023-10-16,104,DPD3-14,0,0,0
2023-10-16,104,DPD30-59,0,0,0
2023-10-16,104,DPD60-89,0,0,0
2023-10-16,20,Current,74,74,0
2023-10-16,20,DPD15-29,0,0,0
2023-10-16,20,DPD3-14,0,0,0
2023-10-16,20,DPD30-59,0,0,0
2023-10-16,20,DPD60-89,0,0,0
2023-10-16,20,DPD90+,0,0,0
2023-10-16,22,Current,0,0,0
2023-10-16,22,DPD15-29,2,2,0
2023-10-16,22,DPD3-14,2,2,0
2023-10-16,22,DPD30-59,1,1,0
2023-10-16,22,DPD60-89,0,0,0
2023-10-16,22,DPD90+,0,0,0
2023-10-16,24,Current,54,54,0
2023-10-16,24,DPD15-29,144,144,0
2023-10-16,24,DPD3-14,202,202,0
2023-10-16,24,DPD30-59,30,30,0
2023-10-16,24,DPD60-89,25,25,0
2023-10-16,24,DPD90+,20,20,0
2023-10-16,26,Current,0,0,0
2023-10-16,26,DPD15-29,25,25,0
2023-10-16,26,DPD3-14,29,29,0
2023-10-16,26,DPD30-59,6,6,0
2023-10-16,26,DPD60-89,6,6,0
2023-10-16,26,DPD90+,3,3,0
2023-10-16,32,Current,0,0,0
2023-10-16,32,DPD15-29,175,175,0
2023-10-16,32,DPD3-14,160,160,0
2023-10-16,32,DPD30-59,42,42,0
2023-10-16,32,DPD60-89,30,30,0
2023-10-16,32,DPD90+,25,25,0
2023-10-16,34,Current,0,0,0
2023-10-16,34,DPD15-29,88,88,0
2023-10-16,34,DPD3-14,76,76,0
2023-10-16,34,DPD30-59,19,19,0
2023-10-16,34,DPD60-89,7,7,0
2023-10-16,34,DPD90+,13,13,0
2023-10-16,36,Current,0,0,0
2023-10-16,36,DPD15-29,45,45,0
2023-10-16,36,DPD3-14,68,68,0
2023-10-16,36,DPD30-59,14,14,0
2023-10-16,36,DPD60-89,9,9,0
2023-10-16,36,DPD90+,4,4,0
2023-10-16,38,Current,0,0,0
2023-10-16,38,DPD15-29,53,53,0
2023-10-16,38,DPD3-14,54,54,0
2023-10-16,38,DPD30-59,5,5,0
2023-10-16,38,DPD60-89,9,9,0
2023-10-16,38,DPD90+,10,10,0
2023-10-16,40,Current,0,0,0
2023-10-16,40,DPD15-29,25,25,0
2023-10-16,40,DPD3-14,38,38,0
2023-10-16,40,DPD30-59,9,9,0
2023-10-16,40,DPD60-89,4,4,0
2023-10-16,40,DPD90+,5,5,0
2023-10-16,42,Current,0,0,0
2023-10-16,42,DPD15-29,23,23,0
2023-10-16,42,DPD3-14,22,22,0
2023-10-16,42,DPD30-59,7,7,0
2023-10-16,42,DPD60-89,2,2,0
2023-10-16,42,DPD90+,3,3,0
2023-10-16,44,Current,0,0,0
2023-10-16,44,DPD15-29,25,25,0
2023-10-16,44,DPD3-14,50,50,0
2023-10-16,44,DPD30-59,10,10,0
2023-10-16,44,DPD60-89,10,10,0
2023-10-16,44,DPD90+,3,3,0
2023-10-16,46,Current,0,0,0
2023-10-16,46,DPD3-14,2,2,0
2023-10-16,46,DPD30-59,0,0,0
2023-10-16,48,Current,75,75,0
2023-10-16,48,DPD15-29,5,5,0
2023-10-16,48,DPD3-14,31,31,0
2023-10-16,48,DPD30-59,2,2,0
2023-10-16,48,DPD60-89,0,0,0
2023-10-16,48,DPD90+,3,3,0
2023-10-16,6,Current,0,0,0
2023-10-16,6,DPD30-59,1,1,0
2023-10-16,6,DPD60-89,0,0,0
2023-10-15,100,Current,0,0,0
2023-10-15,100,DPD15-29,0,0,0
2023-10-15,100,DPD3-14,0,0,0
2023-10-15,100,DPD60-89,0,0,0
2023-10-15,100,DPD90+,0,0,0
2023-10-15,102,Current,0,0,0
2023-10-15,102,DPD3-14,0,0,0
2023-10-15,102,DPD30-59,0,0,0
2023-10-15,102,DPD90+,0,0,0
2023-10-15,104,Current,0,0,0
2023-10-15,104,DPD15-29,1,1,0
2023-10-15,104,DPD3-14,1,1,0
2023-10-15,104,DPD30-59,0,0,0
2023-10-15,104,DPD60-89,0,0,0
2023-10-15,20,Current,116,116,0
2023-10-15,20,DPD15-29,0,0,0
2023-10-15,20,DPD3-14,0,0,0
2023-10-15,20,DPD30-59,0,0,0
2023-10-15,20,DPD60-89,0,0,0
2023-10-15,20,DPD90+,0,0,0
2023-10-15,22,Current,0,0,0
2023-10-15,22,DPD15-29,1,1,0
2023-10-15,22,DPD3-14,2,2,0
2023-10-15,22,DPD30-59,0,0,0
2023-10-15,22,DPD60-89,0,0,0
2023-10-15,22,DPD90+,0,0,0
2023-10-15,24,Current,52,52,0
2023-10-15,24,DPD15-29,84,84,0
2023-10-15,24,DPD3-14,140,140,0
2023-10-15,24,DPD30-59,18,18,0
2023-10-15,24,DPD60-89,11,11,0
2023-10-15,24,DPD90+,10,10,0
2023-10-15,26,Current,0,0,0
2023-10-15,26,DPD15-29,10,10,0
2023-10-15,26,DPD3-14,21,21,0
2023-10-15,26,DPD30-59,2,2,0
2023-10-15,26,DPD60-89,2,2,0
2023-10-15,26,DPD90+,2,2,0
2023-10-15,32,Current,0,0,0
2023-10-15,32,DPD15-29,105,105,0
2023-10-15,32,DPD3-14,90,90,0
2023-10-15,32,DPD30-59,17,17,0
2023-10-15,32,DPD60-89,6,6,0
2023-10-15,32,DPD90+,15,15,0
2023-10-15,34,Current,0,0,0
2023-10-15,34,DPD15-29,43,43,0
2023-10-15,34,DPD3-14,47,47,0
2023-10-15,34,DPD30-59,7,7,0
2023-10-15,34,DPD60-89,5,5,0
2023-10-15,34,DPD90+,7,7,0
2023-10-15,36,Current,0,0,0
2023-10-15,36,DPD15-29,25,25,0
2023-10-15,36,DPD3-14,40,40,0
2023-10-15,36,DPD30-59,4,4,0
2023-10-15,36,DPD60-89,3,3,0
2023-10-15,36,DPD90+,7,7,0
2023-10-15,38,Current,0,0,0
2023-10-15,38,DPD15-29,24,24,0
2023-10-15,38,DPD3-14,31,31,0
2023-10-15,38,DPD30-59,4,4,0
2023-10-15,38,DPD60-89,3,3,0
2023-10-15,38,DPD90+,1,1,0
2023-10-15,40,Current,0,0,0
2023-10-15,40,DPD15-29,16,16,0
2023-10-15,40,DPD3-14,18,18,0
2023-10-15,40,DPD30-59,2,2,0
2023-10-15,40,DPD60-89,2,2,0
2023-10-15,40,DPD90+,4,4,0
2023-10-15,42,Current,0,0,0
2023-10-15,42,DPD15-29,14,14,0
2023-10-15,42,DPD3-14,9,9,0
2023-10-15,42,DPD30-59,3,3,0
2023-10-15,42,DPD60-89,1,1,0
2023-10-15,42,DPD90+,1,1,0
2023-10-15,44,Current,0,0,0
2023-10-15,44,DPD15-29,21,21,0
2023-10-15,44,DPD3-14,36,36,0
2023-10-15,44,DPD30-59,5,5,0
2023-10-15,44,DPD60-89,2,2,0
2023-10-15,44,DPD90+,2,2,0
2023-10-15,46,Current,0,0,0
2023-10-15,46,DPD3-14,0,0,0
2023-10-15,46,DPD30-59,0,0,0
2023-10-15,48,Current,58,58,0
2023-10-15,48,DPD15-29,2,2,0
2023-10-15,48,DPD3-14,15,15,0
2023-10-15,48,DPD30-59,1,1,0
2023-10-15,48,DPD60-89,0,0,0
2023-10-15,48,DPD90+,0,0,0
2023-10-15,6,Current,0,0,0
2023-10-15,6,DPD30-59,0,0,0
2023-10-15,6,DPD60-89,0,0,0
2023-10-14,100,Current,0,0,0
2023-10-14,100,DPD15-29,0,0,0
2023-10-14,100,DPD3-14,2,2,0
2023-10-14,100,DPD60-89,0,0,0
2023-10-14,100,DPD90+,0,0,0
2023-10-14,102,Current,0,0,0
2023-10-14,102,DPD3-14,1,1,0
2023-10-14,102,DPD30-59,1,1,0
2023-10-14,102,DPD90+,0,0,0
2023-10-14,104,Current,0,0,0
2023-10-14,104,DPD15-29,0,0,0
2023-10-14,104,DPD3-14,0,0,0
2023-10-14,104,DPD30-59,0,0,0
2023-10-14,104,DPD60-89,0,0,0
2023-10-14,20,Current,79,79,0
2023-10-14,20,DPD15-29,0,0,0
2023-10-14,20,DPD3-14,0,0,0
2023-10-14,20,DPD30-59,0,0,0
2023-10-14,20,DPD60-89,0,0,0
2023-10-14,20,DPD90+,0,0,0
2023-10-14,22,Current,0,0,0
2023-10-14,22,DPD15-29,2,2,0
2023-10-14,22,DPD3-14,3,3,0
2023-10-14,22,DPD30-59,1,1,0
2023-10-14,22,DPD60-89,0,0,0
2023-10-14,22,DPD90+,0,0,0
2023-10-14,24,Current,80,80,0
2023-10-14,24,DPD15-29,147,147,0
2023-10-14,24,DPD3-14,187,187,0
2023-10-14,24,DPD30-59,31,31,0
2023-10-14,24,DPD60-89,22,22,0
2023-10-14,24,DPD90+,21,21,0
2023-10-14,26,Current,12,12,0
2023-10-14,26,DPD15-29,24,24,0
2023-10-14,26,DPD3-14,29,29,0
2023-10-14,26,DPD30-59,8,8,0
2023-10-14,26,DPD60-89,6,6,0
2023-10-14,26,DPD90+,3,3,0
2023-10-14,32,Current,38,38,0
2023-10-14,32,DPD15-29,165,165,0
2023-10-14,32,DPD3-14,180,180,0
2023-10-14,32,DPD30-59,44,44,0
2023-10-14,32,DPD60-89,30,30,0
2023-10-14,32,DPD90+,30,30,0
2023-10-14,34,Current,9,9,0
2023-10-14,34,DPD15-29,87,87,0
2023-10-14,34,DPD3-14,82,82,0
2023-10-14,34,DPD30-59,15,15,0
2023-10-14,34,DPD60-89,7,7,0
2023-10-14,34,DPD90+,16,16,0
2023-10-14,36,Current,8,8,0
2023-10-14,36,DPD15-29,40,40,0
2023-10-14,36,DPD3-14,69,69,0
2023-10-14,36,DPD30-59,16,16,0
2023-10-14,36,DPD60-89,8,8,0
2023-10-14,36,DPD90+,5,5,0
2023-10-14,38,Current,5,5,0
2023-10-14,38,DPD15-29,50,50,0
2023-10-14,38,DPD3-14,50,50,0
2023-10-14,38,DPD30-59,8,8,0
2023-10-14,38,DPD60-89,9,9,0
2023-10-14,38,DPD90+,11,11,0
2023-10-14,40,Current,4,4,0
2023-10-14,40,DPD15-29,25,25,0
2023-10-14,40,DPD3-14,35,35,0
2023-10-14,40,DPD30-59,9,9,0
2023-10-14,40,DPD60-89,4,4,0
2023-10-14,40,DPD90+,7,7,0
2023-10-14,42,Current,4,4,0
2023-10-14,42,DPD15-29,19,19,0
2023-10-14,42,DPD3-14,21,21,0
2023-10-14,42,DPD30-59,8,8,0
2023-10-14,42,DPD60-89,2,2,0
2023-10-14,42,DPD90+,2,2,0
2023-10-14,44,Current,8,8,0
2023-10-14,44,DPD15-29,21,21,0
2023-10-14,44,DPD3-14,50,50,0
2023-10-14,44,DPD30-59,11,11,0
2023-10-14,44,DPD60-89,9,9,0
2023-10-14,44,DPD90+,5,5,0
2023-10-14,46,Current,0,0,0
2023-10-14,46,DPD3-14,2,2,0
2023-10-14,46,DPD30-59,0,0,0
2023-10-14,48,Current,68,68,0
2023-10-14,48,DPD15-29,9,9,0
2023-10-14,48,DPD3-14,25,25,0
2023-10-14,48,DPD30-59,2,2,0
2023-10-14,48,DPD60-89,0,0,0
2023-10-14,48,DPD90+,3,3,0
2023-10-14,6,Current,0,0,0
2023-10-14,6,DPD30-59,1,1,0
2023-10-14,6,DPD60-89,0,0,0
2023-10-13,100,Current,0,0,0
2023-10-13,100,DPD15-29,0,0,0
2023-10-13,100,DPD3-14,0,0,0
2023-10-13,100,DPD60-89,0,0,0
2023-10-13,100,DPD90+,0,0,0
2023-10-13,102,Current,0,0,0
2023-10-13,102,DPD3-14,0,0,0
2023-10-13,102,DPD30-59,0,0,0
2023-10-13,102,DPD90+,0,0,0
2023-10-13,104,Current,0,0,0
2023-10-13,104,DPD15-29,0,0,0
2023-10-13,104,DPD3-14,0,0,0
2023-10-13,104,DPD30-59,0,0,0
2023-10-13,20,Current,609,609,0
2023-10-13,20,DPD15-29,0,0,0
2023-10-13,20,DPD3-14,1,1,0
2023-10-13,20,DPD30-59,0,0,0
2023-10-13,20,DPD60-89,0,0,0
2023-10-13,20,DPD90+,0,0,0
2023-10-13,22,Current,0,0,0
2023-10-13,22,DPD15-29,0,0,0
2023-10-13,22,DPD3-14,4,4,0
2023-10-13,22,DPD30-59,0,0,0
2023-10-13,22,DPD60-89,0,0,0
2023-10-13,22,DPD90+,0,0,0
2023-10-13,24,Current,443,443,0
2023-10-13,24,DPD15-29,63,63,0
2023-10-13,24,DPD3-14,128,128,0
2023-10-13,24,DPD30-59,20,20,0
2023-10-13,24,DPD60-89,8,8,0
2023-10-13,24,DPD90+,10,10,0
2023-10-13,26,Current,45,45,0
2023-10-13,26,DPD15-29,8,8,0
2023-10-13,26,DPD3-14,24,24,0
2023-10-13,26,DPD30-59,1,1,0
2023-10-13,26,DPD60-89,2,2,0
2023-10-13,26,DPD90+,2,2,0
2023-10-13,32,Current,197,197,0
2023-10-13,32,DPD15-29,76,76,0
2023-10-13,32,DPD3-14,103,103,0
2023-10-13,32,DPD30-59,16,16,0
2023-10-13,32,DPD60-89,6,6,0
2023-10-13,32,DPD90+,14,14,0
2023-10-13,34,Current,87,87,0
2023-10-13,34,DPD15-29,26,26,0
2023-10-13,34,DPD3-14,51,51,0
2023-10-13,34,DPD30-59,5,5,0
2023-10-13,34,DPD60-89,6,6,0
2023-10-13,34,DPD90+,6,6,0
2023-10-13,36,Current,78,78,0
2023-10-13,36,DPD15-29,19,19,0
2023-10-13,36,DPD3-14,42,42,0
2023-10-13,36,DPD30-59,3,3,0
2023-10-13,36,DPD60-89,4,4,0
2023-10-13,36,DPD90+,7,7,0
2023-10-13,38,Current,77,77,0
2023-10-13,38,DPD15-29,18,18,0
2023-10-13,38,DPD3-14,38,38,0
2023-10-13,38,DPD30-59,4,4,0
2023-10-13,38,DPD60-89,3,3,0
2023-10-13,38,DPD90+,1,1,0
2023-10-13,40,Current,58,58,0
2023-10-13,40,DPD15-29,13,13,0
2023-10-13,40,DPD3-14,17,17,0
2023-10-13,40,DPD30-59,3,3,0
2023-10-13,40,DPD60-89,2,2,0
2023-10-13,40,DPD90+,5,5,0
2023-10-13,42,Current,25,25,0
2023-10-13,42,DPD15-29,11,11,0
2023-10-13,42,DPD3-14,14,14,0
2023-10-13,42,DPD30-59,2,2,0
2023-10-13,42,DPD60-89,1,1,0
2023-10-13,42,DPD90+,1,1,0
2023-10-13,44,Current,85,85,0
2023-10-13,44,DPD15-29,14,14,0
2023-10-13,44,DPD3-14,30,30,0
2023-10-13,44,DPD30-59,6,6,0
2023-10-13,44,DPD60-89,2,2,0
2023-10-13,44,DPD90+,1,1,0
2023-10-13,46,Current,1,1,0
2023-10-13,46,DPD3-14,0,0,0
2023-10-13,46,DPD30-59,0,0,0
2023-10-13,48,Current,154,154,0
2023-10-13,48,DPD15-29,2,2,0
2023-10-13,48,DPD3-14,10,10,0
2023-10-13,48,DPD30-59,1,1,0
2023-10-13,48,DPD60-89,0,0,0
2023-10-13,48,DPD90+,0,0,0
2023-10-13,6,Current,0,0,0
2023-10-13,6,DPD30-59,0,0,0
2023-10-13,6,DPD60-89,0,0,0
2023-10-12,100,Current,0,0,0
2023-10-12,100,DPD15-29,0,0,0
2023-10-12,100,DPD3-14,1,1,0
2023-10-12,100,DPD60-89,0,0,0
2023-10-12,100,DPD90+,0,0,0
2023-10-12,102,Current,0,0,0
2023-10-12,102,DPD3-14,1,1,0
2023-10-12,102,DPD30-59,0,0,0
2023-10-12,102,DPD90+,0,0,0
2023-10-12,104,Current,0,0,0
2023-10-12,104,DPD30-59,0,0,0
2023-10-12,20,Current,110,110,0
2023-10-12,20,DPD15-29,0,0,0
2023-10-12,20,DPD3-14,0,0,0
2023-10-12,20,DPD30-59,0,0,0
2023-10-12,20,DPD60-89,0,0,0
2023-10-12,20,DPD90+,0,0,0
2023-10-12,22,Current,0,0,0
2023-10-12,22,DPD15-29,1,1,0
2023-10-12,22,DPD3-14,3,3,0
2023-10-12,22,DPD30-59,1,1,0
2023-10-12,22,DPD60-89,0,0,0
2023-10-12,22,DPD90+,0,0,0
2023-10-12,24,Current,137,137,0
2023-10-12,24,DPD15-29,137,137,0
2023-10-12,24,DPD3-14,133,133,0
2023-10-12,24,DPD30-59,31,31,0
2023-10-12,24,DPD60-89,18,18,0
2023-10-12,24,DPD90+,14,14,0
2023-10-12,26,Current,5,5,0
2023-10-12,26,DPD15-29,23,23,0
2023-10-12,26,DPD3-14,26,26,0
2023-10-12,26,DPD30-59,8,8,0
2023-10-12,26,DPD60-89,2,2,0
2023-10-12,26,DPD90+,3,3,0
2023-10-12,32,Current,33,33,0
2023-10-12,32,DPD15-29,140,140,0
2023-10-12,32,DPD3-14,141,141,0
2023-10-12,32,DPD30-59,35,35,0
2023-10-12,32,DPD60-89,32,32,0
2023-10-12,32,DPD90+,26,26,0
2023-10-12,34,Current,12,12,0
2023-10-12,34,DPD15-29,72,72,0
2023-10-12,34,DPD3-14,67,67,0
2023-10-12,34,DPD30-59,14,14,0
2023-10-12,34,DPD60-89,5,5,0
2023-10-12,34,DPD90+,15,15,0
2023-10-12,36,Current,15,15,0
2023-10-12,36,DPD15-29,35,35,0
2023-10-12,36,DPD3-14,35,35,0
2023-10-12,36,DPD30-59,14,14,0
2023-10-12,36,DPD60-89,7,7,0
2023-10-12,36,DPD90+,1,1,0
2023-10-12,38,Current,15,15,0
2023-10-12,38,DPD15-29,41,41,0
2023-10-12,38,DPD3-14,36,36,0
2023-10-12,38,DPD30-59,6,6,0
2023-10-12,38,DPD60-89,9,9,0
2023-10-12,38,DPD90+,9,9,0
2023-10-12,40,Current,15,15,0
2023-10-12,40,DPD15-29,21,21,0
2023-10-12,40,DPD3-14,24,24,0
2023-10-12,40,DPD30-59,7,7,0
2023-10-12,40,DPD60-89,4,4,0
2023-10-12,40,DPD90+,11,11,0
2023-10-12,42,Current,6,6,0
2023-10-12,42,DPD15-29,16,16,0
2023-10-12,42,DPD3-14,17,17,0
2023-10-12,42,DPD30-59,3,3,0
2023-10-12,42,DPD60-89,3,3,0
2023-10-12,42,DPD90+,2,2,0
2023-10-12,44,Current,17,17,0
2023-10-12,44,DPD15-29,20,20,0
2023-10-12,44,DPD3-14,31,31,0
2023-10-12,44,DPD30-59,11,11,0
2023-10-12,44,DPD60-89,7,7,0
2023-10-12,44,DPD90+,3,3,0
2023-10-12,46,Current,0,0,0
2023-10-12,46,DPD3-14,2,2,0
2023-10-12,46,DPD30-59,0,0,0
2023-10-12,48,Current,86,86,0
2023-10-12,48,DPD15-29,7,7,0
2023-10-12,48,DPD3-14,22,22,0
2023-10-12,48,DPD30-59,1,1,0
2023-10-12,48,DPD60-89,1,1,0
2023-10-12,48,DPD90+,1,1,0
2023-10-12,6,Current,0,0,0
2023-10-12,6,DPD30-59,1,1,0
2023-10-12,6,DPD60-89,0,0,0
2023-10-11,100,Current,0,0,0
2023-10-11,100,DPD15-29,0,0,0
2023-10-11,100,DPD3-14,1,1,0
2023-10-11,100,DPD60-89,0,0,0
2023-10-11,100,DPD90+,0,0,0
2023-10-11,102,Current,0,0,0
2023-10-11,102,DPD3-14,2,2,0
2023-10-11,102,DPD30-59,0,0,0
2023-10-11,102,DPD90+,0,0,0
2023-10-11,104,Current,0,0,0
2023-10-11,104,DPD30-59,0,0,0
2023-10-11,20,Current,69,69,0
2023-10-11,20,DPD15-29,0,0,0
2023-10-11,20,DPD3-14,0,0,0
2023-10-11,20,DPD30-59,0,0,0
2023-10-11,20,DPD60-89,0,0,0
2023-10-11,20,DPD90+,0,0,0
2023-10-11,22,Current,0,0,0
2023-10-11,22,DPD15-29,0,0,0
2023-10-11,22,DPD3-14,3,3,0
2023-10-11,22,DPD30-59,0,0,0
2023-10-11,22,DPD60-89,0,0,0
2023-10-11,22,DPD90+,0,0,0
2023-10-11,24,Current,63,63,0
2023-10-11,24,DPD15-29,58,58,0
2023-10-11,24,DPD3-14,127,127,0
2023-10-11,24,DPD30-59,9,9,0
2023-10-11,24,DPD60-89,10,10,0
2023-10-11,24,DPD90+,2,2,0
2023-10-11,26,Current,4,4,0
2023-10-11,26,DPD15-29,6,6,0
2023-10-11,26,DPD3-14,28,28,0
2023-10-11,26,DPD30-59,1,1,0
2023-10-11,26,DPD60-89,1,1,0
2023-10-11,26,DPD90+,0,0,0
2023-10-11,32,Current,13,13,0
2023-10-11,32,DPD15-29,59,59,0
2023-10-11,32,DPD3-14,117,117,0
2023-10-11,32,DPD30-59,7,7,0
2023-10-11,32,DPD60-89,3,3,0
2023-10-11,32,DPD90+,8,8,0
2023-10-11,34,Current,4,4,0
2023-10-11,34,DPD15-29,19,19,0
2023-10-11,34,DPD3-14,53,53,0
2023-10-11,34,DPD30-59,6,6,0
2023-10-11,34,DPD60-89,1,1,0
2023-10-11,34,DPD90+,6,6,0
2023-10-11,36,Current,7,7,0
2023-10-11,36,DPD15-29,14,14,0
2023-10-11,36,DPD3-14,39,39,0
2023-10-11,36,DPD30-59,1,1,0
2023-10-11,36,DPD60-89,4,4,0
2023-10-11,36,DPD90+,2,2,0
2023-10-11,38,Current,6,6,0
2023-10-11,38,DPD15-29,10,10,0
2023-10-11,38,DPD3-14,40,40,0
2023-10-11,38,DPD30-59,1,1,0
2023-10-11,38,DPD60-89,1,1,0
2023-10-11,38,DPD90+,0,0,0
2023-10-11,40,Current,2,2,0
2023-10-11,40,DPD15-29,10,10,0
2023-10-11,40,DPD3-14,22,22,0
2023-10-11,40,DPD30-59,3,3,0
2023-10-11,40,DPD60-89,1,1,0
2023-10-11,40,DPD90+,9,9,0
2023-10-11,42,Current,6,6,0
2023-10-11,42,DPD15-29,4,4,0
2023-10-11,42,DPD3-14,17,17,0
2023-10-11,42,DPD30-59,1,1,0
2023-10-11,42,DPD60-89,1,1,0
2023-10-11,42,DPD90+,0,0,0
2023-10-11,44,Current,6,6,0
2023-10-11,44,DPD15-29,17,17,0
2023-10-11,44,DPD3-14,28,28,0
2023-10-11,44,DPD30-59,4,4,0
2023-10-11,44,DPD60-89,2,2,0
2023-10-11,44,DPD90+,1,1,0
2023-10-11,46,Current,0,0,0
2023-10-11,46,DPD3-14,0,0,0
2023-10-11,46,DPD30-59,0,0,0
2023-10-11,48,Current,51,51,0
2023-10-11,48,DPD15-29,3,3,0
2023-10-11,48,DPD3-14,12,12,0
2023-10-11,48,DPD30-59,1,1,0
2023-10-11,48,DPD60-89,0,0,0
2023-10-11,48,DPD90+,1,1,0
2023-10-11,6,Current,0,0,0
2023-10-11,6,DPD30-59,0,0,0
2023-10-11,6,DPD60-89,0,0,0
2023-10-10,100,Current,0,0,0
2023-10-10,100,DPD15-29,0,0,0
2023-10-10,100,DPD3-14,1,1,0
2023-10-10,100,DPD60-89,0,0,0
2023-10-10,100,DPD90+,0,0,0
2023-10-10,102,Current,0,0,0
2023-10-10,102,DPD3-14,1,1,0
2023-10-10,102,DPD30-59,0,0,0
2023-10-10,102,DPD90+,0,0,0
2023-10-10,104,Current,0,0,0
2023-10-10,104,DPD15-29,1,1,0
2023-10-10,104,DPD30-59,0,0,0
2023-10-10,20,Current,123,123,0
2023-10-10,20,DPD15-29,0,0,0
2023-10-10,20,DPD3-14,0,0,0
2023-10-10,20,DPD30-59,0,0,0
2023-10-10,20,DPD60-89,0,0,0
2023-10-10,20,DPD90+,0,0,0
2023-10-10,22,Current,0,0,0
2023-10-10,22,DPD15-29,1,1,0
2023-10-10,22,DPD3-14,3,3,0
2023-10-10,22,DPD30-59,1,1,0
2023-10-10,22,DPD60-89,0,0,0
2023-10-10,22,DPD90+,0,0,0
2023-10-10,24,Current,86,86,0
2023-10-10,24,DPD15-29,197,197,0
2023-10-10,24,DPD3-14,255,255,0
2023-10-10,24,DPD30-59,33,33,0
2023-10-10,24,DPD60-89,27,27,0
2023-10-10,24,DPD90+,23,23,0
2023-10-10,26,Current,0,0,0
2023-10-10,26,DPD15-29,31,31,0
2023-10-10,26,DPD3-14,50,50,0
2023-10-10,26,DPD30-59,3,3,0
2023-10-10,26,DPD60-89,6,6,0
2023-10-10,26,DPD90+,6,6,0
2023-10-10,32,Current,4,4,0
2023-10-10,32,DPD15-29,195,195,0
2023-10-10,32,DPD3-14,213,213,0
2023-10-10,32,DPD30-59,55,55,0
2023-10-10,32,DPD60-89,33,33,0
2023-10-10,32,DPD90+,37,37,0
2023-10-10,34,Current,0,0,0
2023-10-10,34,DPD15-29,100,100,0
2023-10-10,34,DPD3-14,107,107,0
2023-10-10,34,DPD30-59,21,21,0
2023-10-10,34,DPD60-89,10,10,0
2023-10-10,34,DPD90+,18,18,0
2023-10-10,36,Current,0,0,0
2023-10-10,36,DPD15-29,56,56,0
2023-10-10,36,DPD3-14,74,74,0
2023-10-10,36,DPD30-59,17,17,0
2023-10-10,36,DPD60-89,12,12,0
2023-10-10,36,DPD90+,5,5,0
2023-10-10,38,Current,0,0,0
2023-10-10,38,DPD15-29,65,65,0
2023-10-10,38,DPD3-14,68,68,0
2023-10-10,38,DPD30-59,6,6,0
2023-10-10,38,DPD60-89,13,13,0
2023-10-10,38,DPD90+,11,11,0
2023-10-10,40,Current,1,1,0
2023-10-10,40,DPD15-29,28,28,0
2023-10-10,40,DPD3-14,39,39,0
2023-10-10,40,DPD30-59,10,10,0
2023-10-10,40,DPD60-89,5,5,0
2023-10-10,40,DPD90+,5,5,0
2023-10-10,42,Current,0,0,0
2023-10-10,42,DPD15-29,28,28,0
2023-10-10,42,DPD3-14,29,29,0
2023-10-10,42,DPD30-59,7,7,0
2023-10-10,42,DPD60-89,4,4,0
2023-10-10,42,DPD90+,4,4,0
2023-10-10,44,Current,2,2,0
2023-10-10,44,DPD15-29,33,33,0
2023-10-10,44,DPD3-14,46,46,0
2023-10-10,44,DPD30-59,16,16,0
2023-10-10,44,DPD60-89,7,7,0
2023-10-10,44,DPD90+,5,5,0
2023-10-10,46,Current,0,0,0
2023-10-10,46,DPD3-14,1,1,0
2023-10-10,46,DPD30-59,0,0,0
2023-10-10,48,Current,81,81,0
2023-10-10,48,DPD15-29,7,7,0
2023-10-10,48,DPD3-14,37,37,0
2023-10-10,48,DPD30-59,2,2,0
2023-10-10,48,DPD60-89,1,1,0
2023-10-10,48,DPD90+,1,1,0
2023-10-10,6,Current,0,0,0
2023-10-10,6,DPD3-14,1,1,0
2023-10-10,6,DPD30-59,1,1,0
2023-10-10,6,DPD60-89,0,0,0
2023-10-09,100,Current,0,0,0
2023-10-09,100,DPD15-29,0,0,0
2023-10-09,100,DPD3-14,0,0,0
2023-10-09,100,DPD60-89,0,0,0
2023-10-09,100,DPD90+,0,0,0
2023-10-09,102,Current,0,0,0
2023-10-09,102,DPD3-14,0,0,0
2023-10-09,102,DPD30-59,0,0,0
2023-10-09,102,DPD90+,0,0,0
2023-10-09,104,Current,0,0,0
2023-10-09,104,DPD15-29,0,0,0
2023-10-09,104,DPD30-59,0,0,0
2023-10-09,20,Current,108,108,0
2023-10-09,20,DPD15-29,0,0,0
2023-10-09,20,DPD3-14,0,0,0
2023-10-09,20,DPD30-59,0,0,0
2023-10-09,20,DPD60-89,0,0,0
2023-10-09,20,DPD90+,0,0,0
2023-10-09,22,Current,0,0,0
2023-10-09,22,DPD15-29,0,0,0
2023-10-09,22,DPD3-14,2,2,0
2023-10-09,22,DPD30-59,0,0,0
2023-10-09,22,DPD60-89,0,0,0
2023-10-09,22,DPD90+,0,0,0
2023-10-09,24,Current,66,66,0
2023-10-09,24,DPD15-29,53,53,0
2023-10-09,24,DPD3-14,115,115,0
2023-10-09,24,DPD30-59,10,10,0
2023-10-09,24,DPD60-89,8,8,0
2023-10-09,24,DPD90+,3,3,0
2023-10-09,26,Current,0,0,0
2023-10-09,26,DPD15-29,5,5,0
2023-10-09,26,DPD3-14,21,21,0
2023-10-09,26,DPD30-59,1,1,0
2023-10-09,26,DPD60-89,1,1,0
2023-10-09,26,DPD90+,0,0,0
2023-10-09,32,Current,0,0,0
2023-10-09,32,DPD15-29,58,58,0
2023-10-09,32,DPD3-14,113,113,0
2023-10-09,32,DPD30-59,7,7,0
2023-10-09,32,DPD60-89,4,4,0
2023-10-09,32,DPD90+,8,8,0
2023-10-09,34,Current,0,0,0
2023-10-09,34,DPD15-29,19,19,0
2023-10-09,34,DPD3-14,48,48,0
2023-10-09,34,DPD30-59,5,5,0
2023-10-09,34,DPD60-89,1,1,0
2023-10-09,34,DPD90+,6,6,0
2023-10-09,36,Current,0,0,0
2023-10-09,36,DPD15-29,14,14,0
2023-10-09,36,DPD3-14,34,34,0
2023-10-09,36,DPD30-59,1,1,0
2023-10-09,36,DPD60-89,3,3,0
2023-10-09,36,DPD90+,3,3,0
2023-10-09,38,Current,0,0,0
2023-10-09,38,DPD15-29,10,10,0
2023-10-09,38,DPD3-14,30,30,0
2023-10-09,38,DPD30-59,1,1,0
2023-10-09,38,DPD60-89,1,1,0
2023-10-09,38,DPD90+,0,0,0
2023-10-09,40,Current,0,0,0
2023-10-09,40,DPD15-29,10,10,0
2023-10-09,40,DPD3-14,19,19,0
2023-10-09,40,DPD30-59,2,2,0
2023-10-09,40,DPD60-89,1,1,0
2023-10-09,40,DPD90+,4,4,0
2023-10-09,42,Current,0,0,0
2023-10-09,42,DPD15-29,3,3,0
2023-10-09,42,DPD3-14,16,16,0
2023-10-09,42,DPD30-59,1,1,0
2023-10-09,42,DPD60-89,1,1,0
2023-10-09,42,DPD90+,0,0,0
2023-10-09,44,Current,0,0,0
2023-10-09,44,DPD15-29,16,16,0
2023-10-09,44,DPD3-14,27,27,0
2023-10-09,44,DPD30-59,3,3,0
2023-10-09,44,DPD60-89,2,2,0
2023-10-09,44,DPD90+,1,1,0
2023-10-09,46,Current,0,0,0
2023-10-09,46,DPD3-14,0,0,0
2023-10-09,46,DPD30-59,0,0,0
2023-10-09,48,Current,71,71,0
2023-10-09,48,DPD15-29,4,4,0
2023-10-09,48,DPD3-14,11,11,0
2023-10-09,48,DPD30-59,1,1,0
2023-10-09,48,DPD60-89,0,0,0
2023-10-09,48,DPD90+,1,1,0
2023-10-09,6,Current,0,0,0
2023-10-09,6,DPD3-14,0,0,0
2023-10-09,6,DPD30-59,0,0,0
2023-10-09,6,DPD60-89,0,0,0
2023-10-08,100,Current,0,0,0
2023-10-08,100,DPD15-29,0,0,0
2023-10-08,100,DPD3-14,1,1,0
2023-10-08,100,DPD60-89,0,0,0
2023-10-08,102,Current,0,0,0
2023-10-08,102,DPD3-14,1,1,0
2023-10-08,102,DPD30-59,0,0,0
2023-10-08,102,DPD90+,0,0,0
2023-10-08,104,Current,0,0,0
2023-10-08,104,DPD15-29,1,1,0
2023-10-08,104,DPD30-59,0,0,0
2023-10-08,20,Current,141,141,0
2023-10-08,20,DPD15-29,0,0,0
2023-10-08,20,DPD3-14,0,0,0
2023-10-08,20,DPD30-59,0,0,0
2023-10-08,20,DPD60-89,0,0,0
2023-10-08,20,DPD90+,0,0,0
2023-10-08,22,Current,0,0,0
2023-10-08,22,DPD15-29,0,0,0
2023-10-08,22,DPD3-14,1,1,0
2023-10-08,22,DPD30-59,1,1,0
2023-10-08,22,DPD60-89,0,0,0
2023-10-08,22,DPD90+,0,0,0
2023-10-08,24,Current,66,66,0
2023-10-08,24,DPD15-29,168,168,0
2023-10-08,24,DPD3-14,234,234,0
2023-10-08,24,DPD30-59,31,31,0
2023-10-08,24,DPD60-89,24,24,0
2023-10-08,24,DPD90+,24,24,0
2023-10-08,26,Current,0,0,0
2023-10-08,26,DPD15-29,28,28,0
2023-10-08,26,DPD3-14,42,42,0
2023-10-08,26,DPD30-59,4,4,0
2023-10-08,26,DPD60-89,4,4,0
2023-10-08,26,DPD90+,7,7,0
2023-10-08,32,Current,1,1,0
2023-10-08,32,DPD15-29,171,171,0
2023-10-08,32,DPD3-14,218,218,0
2023-10-08,32,DPD30-59,47,47,0
2023-10-08,32,DPD60-89,33,33,0
2023-10-08,32,DPD90+,37,37,0
2023-10-08,34,Current,1,1,0
2023-10-08,34,DPD15-29,93,93,0
2023-10-08,34,DPD3-14,99,99,0
2023-10-08,34,DPD30-59,16,16,0
2023-10-08,34,DPD60-89,10,10,0
2023-10-08,34,DPD90+,15,15,0
2023-10-08,36,Current,0,0,0
2023-10-08,36,DPD15-29,53,53,0
2023-10-08,36,DPD3-14,67,67,0
2023-10-08,36,DPD30-59,16,16,0
2023-10-08,36,DPD60-89,13,13,0
2023-10-08,36,DPD90+,4,4,0
2023-10-08,38,Current,0,0,0
2023-10-08,38,DPD15-29,59,59,0
2023-10-08,38,DPD3-14,64,64,0
2023-10-08,38,DPD30-59,6,6,0
2023-10-08,38,DPD60-89,12,12,0
2023-10-08,38,DPD90+,11,11,0
2023-10-08,40,Current,0,0,0
2023-10-08,40,DPD15-29,29,29,0
2023-10-08,40,DPD3-14,32,32,0
2023-10-08,40,DPD30-59,9,9,0
2023-10-08,40,DPD60-89,5,5,0
2023-10-08,40,DPD90+,5,5,0
2023-10-08,42,Current,0,0,0
2023-10-08,42,DPD15-29,24,24,0
2023-10-08,42,DPD3-14,27,27,0
2023-10-08,42,DPD30-59,8,8,0
2023-10-08,42,DPD60-89,3,3,0
2023-10-08,42,DPD90+,4,4,0
2023-10-08,44,Current,0,0,0
2023-10-08,44,DPD15-29,31,31,0
2023-10-08,44,DPD3-14,42,42,0
2023-10-08,44,DPD30-59,17,17,0
2023-10-08,44,DPD60-89,7,7,0
2023-10-08,44,DPD90+,3,3,0
2023-10-08,46,Current,0,0,0
2023-10-08,46,DPD3-14,1,1,0
2023-10-08,46,DPD30-59,0,0,0
2023-10-08,48,Current,83,83,0
2023-10-08,48,DPD15-29,8,8,0
2023-10-08,48,DPD3-14,26,26,0
2023-10-08,48,DPD30-59,2,2,0
2023-10-08,48,DPD60-89,1,1,0
2023-10-08,48,DPD90+,1,1,0
2023-10-08,6,Current,0,0,0
2023-10-08,6,DPD3-14,1,1,0
2023-10-08,6,DPD30-59,1,1,0
2023-10-08,6,DPD60-89,0,0,0
2023-10-07,100,Current,0,0,0
2023-10-07,100,DPD15-29,0,0,0
2023-10-07,100,DPD3-14,0,0,0
2023-10-07,100,DPD60-89,0,0,0
2023-10-07,102,Current,0,0,0
2023-10-07,102,DPD3-14,0,0,0
2023-10-07,102,DPD30-59,0,0,0
2023-10-07,102,DPD90+,0,0,0
2023-10-07,104,Current,0,0,0
2023-10-07,104,DPD15-29,0,0,0
2023-10-07,104,DPD30-59,0,0,0
2023-10-07,20,Current,116,116,0
2023-10-07,20,DPD15-29,0,0,0
2023-10-07,20,DPD3-14,0,0,0
2023-10-07,20,DPD30-59,0,0,0
2023-10-07,20,DPD60-89,0,0,0
2023-10-07,20,DPD90+,0,0,0
2023-10-07,22,Current,0,0,0
2023-10-07,22,DPD15-29,0,0,0
2023-10-07,22,DPD3-14,2,2,0
2023-10-07,22,DPD30-59,0,0,0
2023-10-07,22,DPD60-89,0,0,0
2023-10-07,22,DPD90+,0,0,0
2023-10-07,24,Current,80,80,0
2023-10-07,24,DPD15-29,47,47,0
2023-10-07,24,DPD3-14,103,103,0
2023-10-07,24,DPD30-59,13,13,0
2023-10-07,24,DPD60-89,8,8,0
2023-10-07,24,DPD90+,3,3,0
2023-10-07,26,Current,5,5,0
2023-10-07,26,DPD15-29,6,6,0
2023-10-07,26,DPD3-14,22,22,0
2023-10-07,26,DPD30-59,1,1,0
2023-10-07,26,DPD60-89,1,1,0
2023-10-07,26,DPD90+,1,1,0
2023-10-07,32,Current,17,17,0
2023-10-07,32,DPD15-29,53,53,0
2023-10-07,32,DPD3-14,130,130,0
2023-10-07,32,DPD30-59,10,10,0
2023-10-07,32,DPD60-89,5,5,0
2023-10-07,32,DPD90+,9,9,0
2023-10-07,34,Current,4,4,0
2023-10-07,34,DPD15-29,25,25,0
2023-10-07,34,DPD3-14,49,49,0
2023-10-07,34,DPD30-59,6,6,0
2023-10-07,34,DPD60-89,0,0,0
2023-10-07,34,DPD90+,6,6,0
2023-10-07,36,Current,3,3,0
2023-10-07,36,DPD15-29,13,13,0
2023-10-07,36,DPD3-14,40,40,0
2023-10-07,36,DPD30-59,2,2,0
2023-10-07,36,DPD60-89,4,4,0
2023-10-07,36,DPD90+,3,3,0
2023-10-07,38,Current,10,10,0
2023-10-07,38,DPD15-29,11,11,0
2023-10-07,38,DPD3-14,33,33,0
2023-10-07,38,DPD30-59,2,2,0
2023-10-07,38,DPD60-89,1,1,0
2023-10-07,38,DPD90+,0,0,0
2023-10-07,40,Current,2,2,0
2023-10-07,40,DPD15-29,9,9,0
2023-10-07,40,DPD3-14,19,19,0
2023-10-07,40,DPD30-59,1,1,0
2023-10-07,40,DPD60-89,2,2,0
2023-10-07,40,DPD90+,3,3,0
2023-10-07,42,Current,1,1,0
2023-10-07,42,DPD15-29,4,4,0
2023-10-07,42,DPD3-14,16,16,0
2023-10-07,42,DPD30-59,1,1,0
2023-10-07,42,DPD60-89,0,0,0
2023-10-07,42,DPD90+,0,0,0
2023-10-07,44,Current,0,0,0
2023-10-07,44,DPD15-29,17,17,0
2023-10-07,44,DPD3-14,34,34,0
2023-10-07,44,DPD30-59,3,3,0
2023-10-07,44,DPD60-89,2,2,0
2023-10-07,44,DPD90+,2,2,0
2023-10-07,46,Current,0,0,0
2023-10-07,46,DPD3-14,0,0,0
2023-10-07,46,DPD30-59,0,0,0
2023-10-07,48,Current,79,79,0
2023-10-07,48,DPD15-29,4,4,0
2023-10-07,48,DPD3-14,10,10,0
2023-10-07,48,DPD30-59,1,1,0
2023-10-07,48,DPD60-89,0,0,0
2023-10-07,48,DPD90+,1,1,0
2023-10-07,6,Current,0,0,0
2023-10-07,6,DPD3-14,0,0,0
2023-10-07,6,DPD30-59,0,0,0
2023-10-07,6,DPD60-89,0,0,0
2023-10-06,100,Current,0,0,0
2023-10-06,100,DPD3-14,0,0,0
2023-10-06,100,DPD60-89,0,0,0
2023-10-06,102,Current,0,0,0
2023-10-06,102,DPD3-14,1,1,0
2023-10-06,102,DPD30-59,0,0,0
2023-10-06,102,DPD90+,0,0,0
2023-10-06,104,Current,0,0,0
2023-10-06,104,DPD15-29,1,1,0
2023-10-06,104,DPD30-59,0,0,0
2023-10-06,20,Current,597,597,0
2023-10-06,20,DPD15-29,1,1,0
2023-10-06,20,DPD3-14,0,0,0
2023-10-06,20,DPD30-59,0,0,0
2023-10-06,20,DPD60-89,0,0,0
2023-10-06,20,DPD90+,0,0,0
2023-10-06,22,Current,0,0,0
2023-10-06,22,DPD3-14,1,1,0
2023-10-06,22,DPD30-59,1,1,0
2023-10-06,22,DPD60-89,0,0,0
2023-10-06,22,DPD90+,0,0,0
2023-10-06,24,Current,417,417,0
2023-10-06,24,DPD15-29,163,163,0
2023-10-06,24,DPD3-14,260,260,0
2023-10-06,24,DPD30-59,31,31,0
2023-10-06,24,DPD60-89,28,28,0
2023-10-06,24,DPD90+,22,22,0
2023-10-06,26,Current,59,59,0
2023-10-06,26,DPD15-29,28,28,0
2023-10-06,26,DPD3-14,56,56,0
2023-10-06,26,DPD30-59,5,5,0
2023-10-06,26,DPD60-89,3,3,0
2023-10-06,26,DPD90+,7,7,0
2023-10-06,32,Current,210,210,0
2023-10-06,32,DPD15-29,150,150,0
2023-10-06,32,DPD3-14,262,262,0
2023-10-06,32,DPD30-59,48,48,0
2023-10-06,32,DPD60-89,34,34,0
2023-10-06,32,DPD90+,37,37,0
2023-10-06,34,Current,73,73,0
2023-10-06,34,DPD15-29,90,90,0
2023-10-06,34,DPD3-14,119,119,0
2023-10-06,34,DPD30-59,17,17,0
2023-10-06,34,DPD60-89,9,9,0
2023-10-06,34,DPD90+,17,17,0
2023-10-06,36,Current,94,94,0
2023-10-06,36,DPD15-29,51,51,0
2023-10-06,36,DPD3-14,79,79,0
2023-10-06,36,DPD30-59,17,17,0
2023-10-06,36,DPD60-89,11,11,0
2023-10-06,36,DPD90+,7,7,0
2023-10-06,38,Current,86,86,0
2023-10-06,38,DPD15-29,59,59,0
2023-10-06,38,DPD3-14,86,86,0
2023-10-06,38,DPD30-59,6,6,0
2023-10-06,38,DPD60-89,11,11,0
2023-10-06,38,DPD90+,11,11,0
2023-10-06,40,Current,61,61,0
2023-10-06,40,DPD15-29,29,29,0
2023-10-06,40,DPD3-14,38,38,0
2023-10-06,40,DPD30-59,8,8,0
2023-10-06,40,DPD60-89,4,4,0
2023-10-06,40,DPD90+,6,6,0
2023-10-06,42,Current,32,32,0
2023-10-06,42,DPD15-29,26,26,0
2023-10-06,42,DPD3-14,38,38,0
2023-10-06,42,DPD30-59,6,6,0
2023-10-06,42,DPD60-89,4,4,0
2023-10-06,42,DPD90+,4,4,0
2023-10-06,44,Current,72,72,0
2023-10-06,44,DPD15-29,32,32,0
2023-10-06,44,DPD3-14,62,62,0
2023-10-06,44,DPD30-59,18,18,0
2023-10-06,44,DPD60-89,5,5,0
2023-10-06,44,DPD90+,3,3,0
2023-10-06,46,Current,2,2,0
2023-10-06,46,DPD3-14,1,1,0
2023-10-06,46,DPD30-59,0,0,0
2023-10-06,48,Current,174,174,0
2023-10-06,48,DPD15-29,9,9,0
2023-10-06,48,DPD3-14,18,18,0
2023-10-06,48,DPD30-59,2,2,0
2023-10-06,48,DPD60-89,2,2,0
2023-10-06,48,DPD90+,0,0,0
2023-10-06,6,Current,0,0,0
2023-10-06,6,DPD3-14,1,1,0
2023-10-06,6,DPD30-59,1,1,0
2023-10-06,6,DPD60-89,0,0,0
2023-10-05,100,Current,0,0,0
2023-10-05,100,DPD3-14,0,0,0
2023-10-05,100,DPD60-89,0,0,0
2023-10-05,102,Current,0,0,0
2023-10-05,102,DPD15-29,0,0,0
2023-10-05,102,DPD3-14,0,0,0
2023-10-05,102,DPD30-59,0,0,0
2023-10-05,102,DPD90+,0,0,0
2023-10-05,104,Current,0,0,0
2023-10-05,104,DPD15-29,0,0,0
2023-10-05,104,DPD30-59,0,0,0
2023-10-05,20,Current,186,186,0
2023-10-05,20,DPD15-29,0,0,0
2023-10-05,20,DPD3-14,0,0,0
2023-10-05,20,DPD30-59,0,0,0
2023-10-05,20,DPD60-89,0,0,0
2023-10-05,20,DPD90+,0,0,0
2023-10-05,22,Current,0,0,0
2023-10-05,22,DPD15-29,0,0,0
2023-10-05,22,DPD3-14,2,2,0
2023-10-05,22,DPD30-59,0,0,0
2023-10-05,22,DPD60-89,0,0,0
2023-10-05,22,DPD90+,0,0,0
2023-10-05,24,Current,152,152,0
2023-10-05,24,DPD15-29,45,45,0
2023-10-05,24,DPD3-14,112,112,0
2023-10-05,24,DPD30-59,14,14,0
2023-10-05,24,DPD60-89,8,8,0
2023-10-05,24,DPD90+,3,3,0
2023-10-05,26,Current,3,3,0
2023-10-05,26,DPD15-29,8,8,0
2023-10-05,26,DPD3-14,27,27,0
2023-10-05,26,DPD30-59,1,1,0
2023-10-05,26,DPD60-89,1,1,0
2023-10-05,26,DPD90+,1,1,0
2023-10-05,32,Current,11,11,0
2023-10-05,32,DPD15-29,49,49,0
2023-10-05,32,DPD3-14,134,134,0
2023-10-05,32,DPD30-59,11,11,0
2023-10-05,32,DPD60-89,5,5,0
2023-10-05,32,DPD90+,9,9,0
2023-10-05,34,Current,2,2,0
2023-10-05,34,DPD15-29,22,22,0
2023-10-05,34,DPD3-14,53,53,0
2023-10-05,34,DPD30-59,5,5,0
2023-10-05,34,DPD60-89,0,0,0
2023-10-05,34,DPD90+,6,6,0
2023-10-05,36,Current,7,7,0
2023-10-05,36,DPD15-29,10,10,0
2023-10-05,36,DPD3-14,44,44,0
2023-10-05,36,DPD30-59,2,2,0
2023-10-05,36,DPD60-89,4,4,0
2023-10-05,36,DPD90+,3,3,0
2023-10-05,38,Current,3,3,0
2023-10-05,38,DPD15-29,10,10,0
2023-10-05,38,DPD3-14,44,44,0
2023-10-05,38,DPD30-59,2,2,0
2023-10-05,38,DPD60-89,1,1,0
2023-10-05,38,DPD90+,0,0,0
2023-10-05,40,Current,2,2,0
2023-10-05,40,DPD15-29,9,9,0
2023-10-05,40,DPD3-14,20,20,0
2023-10-05,40,DPD30-59,3,3,0
2023-10-05,40,DPD60-89,2,2,0
2023-10-05,40,DPD90+,5,5,0
2023-10-05,42,Current,1,1,0
2023-10-05,42,DPD15-29,2,2,0
2023-10-05,42,DPD3-14,17,17,0
2023-10-05,42,DPD30-59,1,1,0
2023-10-05,42,DPD60-89,0,0,0
2023-10-05,42,DPD90+,0,0,0
2023-10-05,44,Current,3,3,0
2023-10-05,44,DPD15-29,15,15,0
2023-10-05,44,DPD3-14,28,28,0
2023-10-05,44,DPD30-59,2,2,0
2023-10-05,44,DPD60-89,2,2,0
2023-10-05,44,DPD90+,1,1,0
2023-10-05,46,Current,0,0,0
2023-10-05,46,DPD3-14,0,0,0
2023-10-05,46,DPD30-59,0,0,0
2023-10-05,48,Current,159,159,0
2023-10-05,48,DPD15-29,3,3,0
2023-10-05,48,DPD3-14,10,10,0
2023-10-05,48,DPD30-59,1,1,0
2023-10-05,48,DPD60-89,1,1,0
2023-10-05,48,DPD90+,0,0,0
2023-10-05,6,Current,0,0,0
2023-10-05,6,DPD3-14,0,0,0
2023-10-05,6,DPD30-59,0,0,0
2023-10-05,6,DPD60-89,0,0,0
2023-10-04,100,Current,1,1,0
2023-10-04,100,DPD3-14,0,0,0
2023-10-04,100,DPD60-89,0,0,0
2023-10-04,102,Current,0,0,0
2023-10-04,102,DPD15-29,1,1,0
2023-10-04,102,DPD3-14,0,0,0
2023-10-04,102,DPD30-59,0,0,0
2023-10-04,102,DPD90+,0,0,0
2023-10-04,104,Current,0,0,0
2023-10-04,104,DPD15-29,0,0,0
2023-10-04,104,DPD30-59,0,0,0
2023-10-04,20,Current,85,85,0
2023-10-04,20,DPD15-29,0,0,0
2023-10-04,20,DPD3-14,0,0,0
2023-10-04,20,DPD30-59,0,0,0
2023-10-04,20,DPD60-89,0,0,0
2023-10-04,20,DPD90+,0,0,0
2023-10-04,22,Current,0,0,0
2023-10-04,22,DPD15-29,0,0,0
2023-10-04,22,DPD3-14,2,2,0
2023-10-04,22,DPD30-59,1,1,0
2023-10-04,22,DPD60-89,0,0,0
2023-10-04,22,DPD90+,1,1,0
2023-10-04,24,Current,111,111,0
2023-10-04,24,DPD15-29,152,152,0
2023-10-04,24,DPD3-14,226,226,0
2023-10-04,24,DPD30-59,29,29,0
2023-10-04,24,DPD60-89,29,29,0
2023-10-04,24,DPD90+,21,21,0
2023-10-04,26,Current,8,8,0
2023-10-04,26,DPD15-29,28,28,0
2023-10-04,26,DPD3-14,35,35,0
2023-10-04,26,DPD30-59,5,5,0
2023-10-04,26,DPD60-89,6,6,0
2023-10-04,26,DPD90+,6,6,0
2023-10-04,32,Current,37,37,0
2023-10-04,32,DPD15-29,145,145,0
2023-10-04,32,DPD3-14,231,231,0
2023-10-04,32,DPD30-59,49,49,0
2023-10-04,32,DPD60-89,34,34,0
2023-10-04,32,DPD90+,36,36,0
2023-10-04,34,Current,11,11,0
2023-10-04,34,DPD15-29,90,90,0
2023-10-04,34,DPD3-14,100,100,0
2023-10-04,34,DPD30-59,15,15,0
2023-10-04,34,DPD60-89,11,11,0
2023-10-04,34,DPD90+,17,17,0
2023-10-04,36,Current,20,20,0
2023-10-04,36,DPD15-29,48,48,0
2023-10-04,36,DPD3-14,72,72,0
2023-10-04,36,DPD30-59,15,15,0
2023-10-04,36,DPD60-89,10,10,0
2023-10-04,36,DPD90+,7,7,0
2023-10-04,38,Current,14,14,0
2023-10-04,38,DPD15-29,52,52,0
2023-10-04,38,DPD3-14,68,68,0
2023-10-04,38,DPD30-59,8,8,0
2023-10-04,38,DPD60-89,12,12,0
2023-10-04,38,DPD90+,9,9,0
2023-10-04,40,Current,9,9,0
2023-10-04,40,DPD15-29,29,29,0
2023-10-04,40,DPD3-14,37,37,0
2023-10-04,40,DPD30-59,8,8,0
2023-10-04,40,DPD60-89,6,6,0
2023-10-04,40,DPD90+,11,11,0
2023-10-04,42,Current,7,7,0
2023-10-04,42,DPD15-29,29,29,0
2023-10-04,42,DPD3-14,30,30,0
2023-10-04,42,DPD30-59,5,5,0
2023-10-04,42,DPD60-89,4,4,0
2023-10-04,42,DPD90+,4,4,0
2023-10-04,44,Current,9,9,0
2023-10-04,44,DPD15-29,32,32,0
2023-10-04,44,DPD3-14,38,38,0
2023-10-04,44,DPD30-59,16,16,0
2023-10-04,44,DPD60-89,5,5,0
2023-10-04,44,DPD90+,4,4,0
2023-10-04,46,Current,0,0,0
2023-10-04,46,DPD3-14,0,0,0
2023-10-04,46,DPD30-59,0,0,0
2023-10-04,48,Current,52,52,0
2023-10-04,48,DPD15-29,12,12,0
2023-10-04,48,DPD3-14,10,10,0
2023-10-04,48,DPD30-59,2,2,0
2023-10-04,48,DPD60-89,2,2,0
2023-10-04,48,DPD90+,0,0,0
2023-10-04,6,Current,0,0,0
2023-10-04,6,DPD3-14,1,1,0
2023-10-04,6,DPD30-59,1,1,0
2023-10-04,6,DPD60-89,0,0,0
2023-10-03,100,Current,0,0,0
2023-10-03,100,DPD3-14,0,0,0
2023-10-03,100,DPD60-89,0,0,0
2023-10-03,102,Current,0,0,0
2023-10-03,102,DPD15-29,0,0,0
2023-10-03,102,DPD30-59,0,0,0
2023-10-03,102,DPD90+,0,0,0
2023-10-03,104,Current,0,0,0
2023-10-03,104,DPD15-29,0,0,0
2023-10-03,104,DPD30-59,0,0,0
2023-10-03,20,Current,73,0,73
2023-10-03,20,DPD15-29,0,0,0
2023-10-03,20,DPD3-14,0,0,0
2023-10-03,20,DPD30-59,0,0,0
2023-10-03,20,DPD60-89,0,0,0
2023-10-03,20,DPD90+,0,0,0
2023-10-03,22,Current,1,0,1
2023-10-03,22,DPD3-14,2,0,2
2023-10-03,22,DPD30-59,0,0,0
2023-10-03,22,DPD60-89,0,0,0
2023-10-03,22,DPD90+,0,0,0
2023-10-03,24,Current,92,0,92
2023-10-03,24,DPD15-29,43,0,43
2023-10-03,24,DPD3-14,176,0,176
2023-10-03,24,DPD30-59,16,0,16
2023-10-03,24,DPD60-89,7,0,7
2023-10-03,24,DPD90+,2,0,2
2023-10-03,26,Current,19,0,19
2023-10-03,26,DPD15-29,6,0,6
2023-10-03,26,DPD3-14,42,0,42
2023-10-03,26,DPD30-59,1,0,1
2023-10-03,26,DPD60-89,1,0,1
2023-10-03,26,DPD90+,1,0,1
2023-10-03,32,Current,30,0,30
2023-10-03,32,DPD15-29,45,0,45
2023-10-03,32,DPD3-14,173,0,173
2023-10-03,32,DPD30-59,16,0,16
2023-10-03,32,DPD60-89,6,0,6
2023-10-03,32,DPD90+,8,0,8
2023-10-03,34,Current,18,0,18
2023-10-03,34,DPD15-29,11,0,11
2023-10-03,34,DPD3-14,75,0,75
2023-10-03,34,DPD30-59,5,0,5
2023-10-03,34,DPD60-89,1,0,1
2023-10-03,34,DPD90+,5,0,5
2023-10-03,36,Current,17,0,17
2023-10-03,36,DPD15-29,8,0,8
2023-10-03,36,DPD3-14,69,0,69
2023-10-03,36,DPD30-59,2,0,2
2023-10-03,36,DPD60-89,4,0,4
2023-10-03,36,DPD90+,3,0,3
2023-10-03,38,Current,14,0,14
2023-10-03,38,DPD15-29,7,0,7
2023-10-03,38,DPD3-14,59,0,59
2023-10-03,38,DPD30-59,3,0,3
2023-10-03,38,DPD60-89,0,0,0
2023-10-03,38,DPD90+,0,0,0
2023-10-03,40,Current,6,0,6
2023-10-03,40,DPD15-29,6,0,6
2023-10-03,40,DPD3-14,29,0,29
2023-10-03,40,DPD30-59,1,0,1
2023-10-03,40,DPD60-89,2,0,2
2023-10-03,40,DPD90+,3,0,3
2023-10-03,42,Current,5,0,5
2023-10-03,42,DPD15-29,3,0,3
2023-10-03,42,DPD3-14,17,0,17
2023-10-03,42,DPD30-59,1,0,1
2023-10-03,42,DPD60-89,0,0,0
2023-10-03,42,DPD90+,0,0,0
2023-10-03,44,Current,9,0,9
2023-10-03,44,DPD15-29,10,0,10
2023-10-03,44,DPD3-14,44,0,44
2023-10-03,44,DPD30-59,2,0,2
2023-10-03,44,DPD60-89,2,0,2
2023-10-03,44,DPD90+,1,0,1
2023-10-03,46,Current,0,0,0
2023-10-03,46,DPD30-59,0,0,0
2023-10-03,48,Current,41,0,41
2023-10-03,48,DPD15-29,3,0,3
2023-10-03,48,DPD3-14,13,0,13
2023-10-03,48,DPD30-59,2,0,2
2023-10-03,48,DPD60-89,1,0,1
2023-10-03,48,DPD90+,0,0,0
2023-10-03,6,Current,0,0,0
2023-10-03,6,DPD3-14,0,0,0
2023-10-03,6,DPD30-59,0,0,0
2023-10-03,6,DPD60-89,0,0,0
